year,Season_type,PLAYER_ID,RANK,PLAYER,TEAM_ID,TEAM,GP,MIN,FGM,FGA,FG_PCT,FG3M,FG3A,FG3_PCT,FTM,FTA,FT_PCT,OREB,DREB,REB,AST,STL,BLK,TOV,PF,PTS,EFF,AST_TOV,STL_TOV,START_YEAR,END_YEAR,PPG,AST_TOV_Ration,Missed_FGs,Missed_FTs,Total_Rebounds_Available,REB_EFF
2012-13,RegularSeason,201142,1,Kevin Durant,1610612760,OKC,81,3119,731,1433,0.51,139,334,0.416,679,750,0.905,46,594,640,374,116,105,280,143,2280,2462,1.34,0.41,2012,13,28.14814814814815,1.3357142857142856,702,71,773,0.8279430789133247
2012-13,RegularSeason,977,2,Kobe Bryant,1610612747,LAL,78,3013,738,1595,0.463,132,407,0.324,525,626,0.839,66,367,433,469,106,25,287,173,2133,1921,1.63,0.37,2012,13,27.346153846153847,1.6341463414634145,857,101,958,0.4519832985386221
2012-13,RegularSeason,2544,3,LeBron James,1610612748,MIA,76,2877,765,1354,0.565,103,254,0.406,403,535,0.753,97,513,610,551,129,67,226,110,2036,2446,2.44,0.57,2012,13,26.789473684210527,2.438053097345133,589,132,721,0.8460471567267683
2012-13,RegularSeason,201935,4,James Harden,1610612745,HOU,78,2985,585,1337,0.438,179,486,0.368,674,792,0.851,62,317,379,455,142,38,295,178,2023,1872,1.54,0.48,2012,13,25.935897435897434,1.5423728813559323,752,118,870,0.435632183908046
2012-13,RegularSeason,2546,5,Carmelo Anthony,1610612752,NYK,67,2482,669,1489,0.449,157,414,0.379,425,512,0.83,134,326,460,171,52,32,175,205,1920,1553,0.98,0.3,2012,13,28.65671641791045,0.9771428571428571,820,87,907,0.5071664829106945
2012-13,RegularSeason,201566,6,Russell Westbrook,1610612760,OKC,82,2861,673,1535,0.438,97,300,0.323,460,575,0.8,111,317,428,607,145,24,273,189,1903,1857,2.22,0.53,2012,13,23.20731707317073,2.2234432234432235,862,115,977,0.43807574206755373
2012-13,RegularSeason,201939,7,Stephen Curry,1610612744,GSW,78,2983,626,1388,0.451,272,600,0.453,262,291,0.9,59,255,314,539,126,12,240,198,1786,1746,2.25,0.53,2012,13,22.897435897435898,2.245833333333333,762,29,791,0.3969658659924147
2012-13,RegularSeason,101145,8,Monta Ellis,1610612749,MIL,82,3076,597,1436,0.416,94,328,0.287,289,374,0.773,45,271,316,496,169,36,254,164,1577,1416,1.95,0.67,2012,13,19.23170731707317,1.952755905511811,839,85,924,0.341991341991342
2012-13,RegularSeason,203081,9,Damian Lillard,1610612757,POR,82,3167,553,1288,0.429,185,503,0.368,271,321,0.844,42,215,257,531,74,19,243,172,1562,1415,2.19,0.3,2012,13,19.048780487804876,2.185185185185185,735,50,785,0.3273885350318471
2012-13,RegularSeason,200746,10,LaMarcus Aldridge,1610612757,POR,74,2790,638,1318,0.484,2,14,0.143,282,348,0.81,175,495,670,192,62,91,143,187,1560,1686,1.34,0.43,2012,13,21.08108108108108,1.3426573426573427,680,66,746,0.8981233243967829
2012-13,RegularSeason,201942,11,DeMar DeRozan,1610612761,TOR,82,3013,548,1231,0.445,34,120,0.283,355,427,0.831,48,272,320,204,76,24,151,173,1485,1203,1.35,0.5,2012,13,18.109756097560975,1.3509933774834437,683,72,755,0.423841059602649
2012-13,RegularSeason,101114,12,Deron Williams,1610612751,BKN,78,2842,495,1124,0.44,169,447,0.378,317,369,0.859,29,203,232,604,75,30,218,194,1476,1518,2.77,0.34,2012,13,18.923076923076923,2.770642201834862,629,52,681,0.3406754772393539
2012-13,RegularSeason,2548,13,Dwyane Wade,1610612748,MIA,69,2391,569,1093,0.521,17,66,0.258,308,425,0.725,86,258,344,352,128,56,194,140,1463,1508,1.81,0.66,2012,13,21.202898550724637,1.8144329896907216,524,117,641,0.5366614664586583
2012-13,RegularSeason,101135,14,David Lee,1610612744,GSW,79,2907,602,1160,0.519,0,4,0.0,255,320,0.797,218,668,886,279,67,22,207,246,1459,1883,1.35,0.32,2012,13,18.468354430379748,1.3478260869565217,558,65,623,1.4221508828250402
2012-13,RegularSeason,202689,15,Kemba Walker,1610612766,CHA,82,2859,526,1244,0.423,107,332,0.322,296,371,0.798,60,223,283,471,160,31,200,153,1455,1407,2.35,0.8,2012,13,17.74390243902439,2.355,718,75,793,0.35687263556116017
2012-13,RegularSeason,2747,16,JR Smith,1610612752,NYK,80,2678,527,1249,0.422,155,436,0.356,237,311,0.762,64,361,425,218,100,24,134,226,1446,1283,1.63,0.75,2012,13,18.075,1.626865671641791,722,74,796,0.5339195979899497
2012-13,RegularSeason,201933,17,Blake Griffin,1610612746,LAC,80,2598,577,1072,0.538,5,28,0.179,281,426,0.66,186,476,662,299,97,50,185,231,1440,1723,1.62,0.52,2012,13,18.0,1.6162162162162161,495,145,640,1.034375
2012-13,RegularSeason,201572,18,Brook Lopez,1610612751,BKN,74,2253,570,1094,0.521,0,1,0.0,297,392,0.758,208,304,512,70,33,154,131,152,1437,1456,0.53,0.25,2012,13,19.41891891891892,0.5343511450381679,524,95,619,0.827140549273021
2012-13,RegularSeason,1718,19,Paul Pierce,1610612738,BOS,77,2575,476,1092,0.436,145,382,0.38,333,423,0.787,45,442,487,370,84,30,214,210,1430,1481,1.73,0.39,2012,13,18.571428571428573,1.7289719626168225,616,90,706,0.6898016997167139
2012-13,RegularSeason,201943,20,Brandon Jennings,1610612749,MIL,80,2897,497,1247,0.399,173,461,0.375,230,281,0.819,59,187,246,521,125,10,203,155,1397,1295,2.57,0.62,2012,13,17.4625,2.5665024630541873,750,51,801,0.30711610486891383
2012-13,RegularSeason,2744,21,Al Jefferson,1610612762,UTA,78,2578,611,1236,0.494,2,17,0.118,167,217,0.77,156,564,720,164,80,89,105,170,1391,1664,1.56,0.76,2012,13,17.833333333333332,1.561904761904762,625,50,675,1.0666666666666667
2012-13,RegularSeason,201950,22,Jrue Holiday,1610612755,PHI,78,2926,555,1288,0.431,91,247,0.368,182,242,0.752,89,240,329,625,123,32,292,170,1383,1407,2.14,0.42,2012,13,17.73076923076923,2.1404109589041096,733,60,793,0.41488020176544765
2012-13,RegularSeason,202331,23,Paul George,1610612754,IND,79,2972,493,1176,0.419,170,469,0.362,221,274,0.807,88,515,603,327,143,51,233,227,1377,1532,1.4,0.61,2012,13,17.430379746835442,1.4034334763948497,683,53,736,0.8192934782608695
2012-13,RegularSeason,200752,24,Rudy Gay,1610612761,TOR,75,2687,521,1253,0.416,84,260,0.323,240,295,0.814,99,362,461,202,113,53,198,182,1366,1210,1.02,0.57,2012,13,18.213333333333335,1.02020202020202,732,55,787,0.5857687420584498
2012-13,RegularSeason,202691,25,Klay Thompson,1610612744,GSW,82,2936,508,1205,0.422,211,526,0.401,132,157,0.841,32,274,306,183,86,45,157,237,1359,1100,1.17,0.55,2012,13,16.573170731707318,1.1656050955414012,697,25,722,0.42382271468144045
2012-13,RegularSeason,2225,26,Tony Parker,1610612759,SAS,66,2174,519,995,0.522,24,68,0.353,279,330,0.845,18,180,198,499,54,6,170,92,1341,1401,2.94,0.32,2012,13,20.318181818181817,2.9352941176470586,476,51,527,0.3757115749525617
2012-13,RegularSeason,2746,27,Josh Smith,1610612737,ATL,76,2683,550,1182,0.465,61,201,0.303,166,321,0.517,133,506,639,321,94,136,226,175,1327,1504,1.42,0.42,2012,13,17.460526315789473,1.420353982300885,632,155,787,0.8119440914866582
2012-13,RegularSeason,202681,28,Kyrie Irving,1610612739,CLE,59,2048,484,1070,0.452,109,279,0.391,248,290,0.855,34,182,216,350,89,21,191,146,1325,1182,1.83,0.47,2012,13,22.45762711864407,1.8324607329842932,586,42,628,0.34394904458598724
2012-13,RegularSeason,201583,29,Ryan Anderson,1610612740,NOH,81,2503,472,1115,0.423,213,557,0.382,152,180,0.844,191,328,519,97,42,31,97,179,1309,1230,1.0,0.43,2012,13,16.160493827160494,1.0,643,28,671,0.7734724292101341
2012-13,RegularSeason,202328,30,Greg Monroe,1610612765,DET,81,2687,514,1058,0.486,0,4,0.0,270,392,0.689,236,541,777,281,105,55,234,190,1298,1616,1.2,0.45,2012,13,16.02469135802469,1.2008547008547008,544,122,666,1.1666666666666667
2012-13,RegularSeason,2730,31,Dwight Howard,1610612747,LAL,76,2722,470,813,0.578,1,6,0.167,355,721,0.492,251,694,945,108,84,186,225,291,1296,1685,0.48,0.37,2012,13,17.05263157894737,0.48,343,366,709,1.3328631875881523
2012-13,RegularSeason,201143,32,Al Horford,1610612737,ATL,74,2756,576,1060,0.543,3,6,0.5,134,208,0.644,195,562,757,240,78,78,147,163,1289,1737,1.63,0.53,2012,13,17.41891891891892,1.6326530612244898,484,74,558,1.3566308243727598
2012-13,RegularSeason,2430,33,Carlos Boozer,1610612741,CHI,79,2546,544,1140,0.477,0,2,0.0,193,264,0.731,175,596,771,179,66,28,176,239,1281,1482,1.02,0.38,2012,13,16.21518987341772,1.0170454545454546,596,71,667,1.1559220389805098
2012-13,RegularSeason,202326,34,DeMarcus Cousins,1610612758,SAC,75,2289,482,1036,0.465,4,22,0.182,312,423,0.738,222,524,746,199,108,55,225,269,1280,1498,0.88,0.48,2012,13,17.066666666666666,0.8844444444444445,554,111,665,1.1218045112781956
2012-13,RegularSeason,2037,35,Jamal Crawford,1610612746,LAC,76,2230,445,1016,0.438,149,396,0.376,216,248,0.871,22,106,128,193,79,13,146,71,1255,919,1.32,0.54,2012,13,16.513157894736842,1.321917808219178,571,32,603,0.21227197346600332
2012-13,RegularSeason,201564,35,O.J. Mayo,1610612742,DAL,82,2913,461,1026,0.449,142,349,0.407,191,233,0.82,36,255,291,361,93,23,210,195,1255,1206,1.72,0.44,2012,13,15.304878048780488,1.7190476190476192,565,42,607,0.4794069192751236
2012-13,RegularSeason,2561,37,David West,1610612754,IND,73,2435,502,1009,0.498,4,19,0.211,242,315,0.768,145,418,563,213,74,69,157,149,1250,1432,1.36,0.47,2012,13,17.123287671232877,1.356687898089172,507,73,580,0.9706896551724138
2012-13,RegularSeason,2736,38,Luol Deng,1610612741,CHI,75,2903,466,1093,0.426,75,233,0.322,230,282,0.816,162,314,476,222,81,32,144,105,1237,1225,1.54,0.56,2012,13,16.493333333333332,1.5416666666666667,627,52,679,0.7010309278350515
2012-13,RegularSeason,2547,39,Chris Bosh,1610612748,MIA,74,2454,485,907,0.535,21,74,0.284,241,302,0.798,131,370,501,123,66,101,128,168,1232,1412,0.96,0.52,2012,13,16.64864864864865,0.9609375,422,61,483,1.0372670807453417
2012-13,RegularSeason,1495,40,Tim Duncan,1610612759,SAS,69,2078,490,976,0.502,2,7,0.286,245,300,0.817,124,562,686,184,50,183,147,117,1227,1642,1.25,0.34,2012,13,17.782608695652176,1.251700680272109,486,55,541,1.268022181146026
2012-13,RegularSeason,201951,41,Ty Lawson,1610612743,DEN,73,2513,448,971,0.461,85,232,0.366,235,311,0.756,36,162,198,501,107,8,182,135,1216,1249,2.75,0.59,2012,13,16.65753424657534,2.7527472527472527,523,76,599,0.330550918196995
2012-13,RegularSeason,101108,42,Chris Paul,1610612746,LAC,70,2335,412,856,0.481,76,232,0.328,286,323,0.885,53,209,262,678,169,10,159,143,1186,1665,4.26,1.06,2012,13,16.942857142857143,4.264150943396227,444,37,481,0.5446985446985447
2012-13,RegularSeason,202718,43,Chandler Parsons,1610612745,HOU,76,2758,456,939,0.486,152,395,0.385,113,155,0.729,79,325,404,269,75,32,147,148,1177,1285,1.83,0.51,2012,13,15.486842105263158,1.8299319727891157,483,42,525,0.7695238095238095
2012-13,RegularSeason,2207,44,Joe Johnson,1610612751,BKN,72,2642,445,1052,0.423,148,395,0.375,132,161,0.82,53,165,218,253,49,14,123,99,1170,945,2.06,0.4,2012,13,16.25,2.0569105691056913,607,29,636,0.34276729559748426
2012-13,RegularSeason,2216,45,Zach Randolph,1610612763,MEM,76,2607,471,1024,0.46,2,23,0.087,225,300,0.75,310,544,854,108,61,31,150,180,1169,1445,0.72,0.41,2012,13,15.381578947368421,0.72,553,75,628,1.3598726114649682
2012-13,RegularSeason,201144,46,Mike Conley,1610612763,MEM,80,2757,414,940,0.44,106,293,0.362,234,282,0.83,43,182,225,487,174,24,189,171,1168,1315,2.58,0.92,2012,13,14.6,2.5767195767195767,526,48,574,0.39198606271777003
2012-13,RegularSeason,201952,47,Jeff Teague,1610612737,ATL,80,2628,439,974,0.451,89,248,0.359,199,226,0.881,25,155,180,579,117,28,230,181,1166,1278,2.52,0.51,2012,13,14.575,2.517391304347826,535,27,562,0.3202846975088968
2012-13,RegularSeason,201568,48,Danilo Gallinari,1610612743,DEN,71,2309,364,871,0.418,135,362,0.373,286,348,0.822,65,302,367,176,64,36,111,130,1149,1112,1.59,0.58,2012,13,16.183098591549296,1.5855855855855856,507,62,569,0.6449912126537786
2012-13,RegularSeason,200794,49,Paul Millsap,1610612762,UTA,78,2375,429,875,0.49,13,39,0.333,264,356,0.742,177,377,554,201,102,80,138,232,1135,1396,1.46,0.74,2012,13,14.551282051282051,1.4565217391304348,446,92,538,1.029739776951673
2012-13,RegularSeason,201609,50,Goran Dragic,1610612756,PHX,77,2581,401,906,0.443,88,276,0.319,244,326,0.748,60,178,238,569,124,26,212,214,1134,1292,2.68,0.58,2012,13,14.727272727272727,2.6839622641509435,505,82,587,0.40545144804088584
2012-13,RegularSeason,201188,51,Marc Gasol,1610612763,MEM,80,2796,429,869,0.494,1,14,0.071,268,316,0.848,184,438,622,318,80,139,157,255,1127,1641,2.02,0.51,2012,13,14.0875,2.0254777070063694,440,48,488,1.2745901639344261
2012-13,RegularSeason,201152,51,Thaddeus Young,1610612755,PHI,76,2629,509,958,0.531,1,8,0.125,108,188,0.574,182,389,571,125,133,55,90,191,1127,1392,1.39,1.48,2012,13,14.828947368421053,1.3888888888888888,449,80,529,1.0793950850661627
2012-13,RegularSeason,202738,53,Isaiah Thomas,1610612758,SAC,79,2122,366,832,0.44,115,321,0.358,253,287,0.882,29,132,161,316,67,3,140,167,1100,1007,2.26,0.48,2012,13,13.924050632911392,2.257142857142857,466,34,500,0.322
2012-13,RegularSeason,200755,53,JJ Redick,1610612749,MIL,78,2379,382,880,0.434,165,451,0.366,171,190,0.9,17,154,171,296,38,9,138,117,1100,959,2.15,0.28,2012,13,14.102564102564102,2.1449275362318843,498,19,517,0.3307543520309478
2012-13,RegularSeason,202391,55,Jeremy Lin,1610612745,HOU,82,2640,396,897,0.441,87,257,0.339,216,275,0.785,32,215,247,497,134,29,236,205,1095,1206,2.11,0.57,2012,13,13.353658536585366,2.1059322033898304,501,59,560,0.44107142857142856
2012-13,RegularSeason,202323,56,Evan Turner,1610612755,PHI,82,2892,441,1053,0.419,58,159,0.365,154,208,0.74,56,461,517,354,71,17,187,197,1094,1200,1.89,0.38,2012,13,13.341463414634147,1.893048128342246,612,54,666,0.7762762762762763
2012-13,RegularSeason,1713,57,Vince Carter,1610612742,DAL,81,2093,372,855,0.435,162,399,0.406,182,223,0.816,58,276,334,194,74,44,106,226,1088,1104,1.83,0.7,2012,13,13.432098765432098,1.830188679245283,483,41,524,0.6374045801526718
2012-13,RegularSeason,202349,58,Greivis Vasquez,1610612740,NOH,78,2685,438,1012,0.433,83,243,0.342,124,154,0.805,43,294,337,704,66,6,247,190,1083,1345,2.85,0.27,2012,13,13.884615384615385,2.8502024291497974,574,30,604,0.5579470198675497
2012-13,RegularSeason,2755,59,Kevin Martin,1610612760,OKC,77,2136,350,778,0.45,158,371,0.426,219,246,0.89,31,147,178,106,72,8,101,138,1077,885,1.05,0.71,2012,13,13.987012987012987,1.0495049504950495,428,27,455,0.3912087912087912
2012-13,RegularSeason,201588,60,George Hill,1610612754,IND,76,2620,386,871,0.443,130,353,0.368,174,213,0.817,47,237,284,355,81,26,116,134,1076,1182,3.06,0.7,2012,13,14.157894736842104,3.060344827586207,485,39,524,0.5419847328244275
2012-13,RegularSeason,101126,61,Nate Robinson,1610612741,CHI,82,2086,399,921,0.433,141,348,0.405,135,169,0.799,29,155,184,358,85,10,144,207,1074,1011,2.49,0.59,2012,13,13.097560975609756,2.486111111111111,522,34,556,0.33093525179856115
2012-13,RegularSeason,201167,62,Arron Afflalo,1610612753,ORL,64,2307,397,905,0.439,72,240,0.3,191,223,0.857,29,210,239,206,40,11,138,137,1057,875,1.49,0.29,2012,13,16.515625,1.4927536231884058,508,32,540,0.4425925925925926
2012-13,RegularSeason,201945,63,Gerald Henderson,1610612766,CHA,68,2133,382,855,0.447,33,100,0.33,258,313,0.824,55,195,250,177,68,34,108,149,1055,948,1.64,0.63,2012,13,15.514705882352942,1.6388888888888888,473,55,528,0.4734848484848485
2012-13,RegularSeason,201586,63,Serge Ibaka,1610612760,OKC,80,2486,446,778,0.573,20,57,0.351,143,191,0.749,222,395,617,43,28,242,125,213,1055,1480,0.34,0.22,2012,13,13.1875,0.344,332,48,380,1.6236842105263158
2012-13,RegularSeason,2449,65,Luis Scola,1610612756,PHX,82,2184,432,915,0.472,3,16,0.188,181,230,0.787,158,383,541,182,67,35,126,257,1048,1215,1.44,0.53,2012,13,12.78048780487805,1.4444444444444444,483,49,532,1.0169172932330828
2012-13,RegularSeason,201587,66,Nicolas Batum,1610612757,POR,73,2807,352,833,0.423,165,444,0.372,178,210,0.848,97,315,412,360,91,83,190,139,1047,1290,1.9,0.48,2012,13,14.342465753424657,1.894736842105263,481,32,513,0.8031189083820662
2012-13,RegularSeason,2738,67,Andre Iguodala,1610612743,DEN,80,2779,396,879,0.451,91,287,0.317,155,270,0.574,82,341,423,433,139,52,206,127,1038,1281,2.1,0.68,2012,13,12.975,2.1019417475728157,483,115,598,0.7073578595317725
2012-13,RegularSeason,201145,68,Jeff Green,1610612738,BOS,81,2252,376,806,0.467,70,182,0.385,214,265,0.808,55,263,318,128,56,68,132,175,1036,993,0.97,0.42,2012,13,12.790123456790123,0.9696969696969697,430,51,481,0.6611226611226612
2012-13,RegularSeason,101127,69,Jarrett Jack,1610612744,GSW,79,2349,387,857,0.452,82,203,0.404,167,198,0.843,21,222,243,439,60,11,157,134,1023,1118,2.8,0.38,2012,13,12.949367088607595,2.7961783439490446,470,31,501,0.48502994011976047
2012-13,RegularSeason,202083,70,Wesley Matthews,1610612757,POR,69,2403,352,808,0.436,169,425,0.398,149,187,0.797,35,156,191,174,90,18,109,172,1022,892,1.6,0.83,2012,13,14.81159420289855,1.5963302752293578,456,38,494,0.3866396761133603
2012-13,RegularSeason,201581,71,JJ Hickson,1610612757,POR,80,2323,418,744,0.562,0,2,0.0,182,268,0.679,266,562,828,88,48,51,145,160,1018,1476,0.61,0.33,2012,13,12.725,0.6068965517241379,326,86,412,2.0097087378640777
2012-13,RegularSeason,202330,72,Gordon Hayward,1610612762,UTA,72,2104,336,773,0.435,102,246,0.415,243,294,0.827,51,174,225,213,58,38,120,125,1017,943,1.77,0.48,2012,13,14.125,1.775,437,51,488,0.4610655737704918
2012-13,RegularSeason,201593,73,Nikola Pekovic,1610612750,MIN,62,1959,385,741,0.52,0,0,0.0,241,324,0.744,230,315,545,53,43,50,101,143,1011,1162,0.53,0.43,2012,13,16.306451612903224,0.5247524752475248,356,83,439,1.2414578587699316
2012-13,RegularSeason,202696,74,Nikola Vucevic,1610612753,ORL,77,2559,461,889,0.519,0,3,0.0,86,126,0.683,273,644,917,143,61,79,141,218,1008,1599,1.01,0.43,2012,13,13.090909090909092,1.0141843971631206,428,40,468,1.9594017094017093
2012-13,RegularSeason,708,75,Kevin Garnett,1610612738,BOS,68,2022,422,850,0.496,2,16,0.125,158,201,0.786,75,455,530,159,78,62,110,154,1004,1252,1.45,0.71,2012,13,14.764705882352942,1.4454545454545455,428,43,471,1.1252653927813163
2012-13,RegularSeason,202688,76,Brandon Knight,1610612765,DET,75,2365,357,878,0.407,120,327,0.367,165,225,0.733,54,193,247,303,58,8,205,157,999,829,1.48,0.28,2012,13,13.32,1.4780487804878049,521,60,581,0.42512908777969016
2012-13,RegularSeason,201147,77,Corey Brewer,1610612743,DEN,82,2003,375,883,0.425,91,307,0.296,149,216,0.69,55,180,235,124,118,23,102,154,990,813,1.22,1.16,2012,13,12.073170731707316,1.2156862745098038,508,67,575,0.40869565217391307
2012-13,RegularSeason,201936,78,Tyreke Evans,1610612758,SAC,65,2016,366,765,0.478,45,133,0.338,210,271,0.775,56,231,287,229,90,27,128,133,987,1032,1.79,0.7,2012,13,15.184615384615384,1.7890625,399,61,460,0.6239130434782608
2012-13,RegularSeason,201954,79,Darren Collison,1610612742,DAL,81,2372,341,724,0.471,48,136,0.353,242,275,0.88,31,188,219,415,100,8,173,139,972,1125,2.4,0.58,2012,13,12.0,2.398843930635838,383,33,416,0.5264423076923077
2012-13,RegularSeason,101141,80,Ersan Ilyasova,1610612749,MIL,73,2012,371,803,0.462,95,214,0.444,125,157,0.796,154,366,520,117,68,36,75,185,962,1164,1.56,0.91,2012,13,13.178082191780822,1.56,432,32,464,1.1206896551724137
2012-13,RegularSeason,202684,81,Tristan Thompson,1610612739,CLE,82,2564,390,799,0.488,0,3,0.0,177,291,0.608,306,467,773,108,60,71,123,234,957,1323,0.88,0.49,2012,13,11.670731707317072,0.8780487804878049,409,114,523,1.4780114722753346
2012-13,RegularSeason,101109,82,Raymond Felton,1610612752,NYK,68,2313,377,882,0.427,93,258,0.36,101,128,0.789,51,143,194,372,94,14,155,130,948,935,2.4,0.61,2012,13,13.941176470588236,2.4,505,27,532,0.36466165413533835
2012-13,RegularSeason,2557,83,Luke Ridnour,1610612750,MIN,82,2474,367,811,0.453,66,212,0.311,139,164,0.848,41,165,206,311,82,15,130,187,939,954,2.39,0.63,2012,13,11.451219512195122,2.3923076923076922,444,25,469,0.43923240938166314
2012-13,RegularSeason,201579,84,Roy Hibbert,1610612754,IND,79,2269,385,859,0.448,1,4,0.25,166,224,0.741,296,360,656,113,39,206,162,279,937,1257,0.7,0.24,2012,13,11.860759493670885,0.6975308641975309,474,58,532,1.2330827067669172
2012-13,RegularSeason,202682,85,Derrick Williams,1610612750,MIN,78,1916,338,786,0.43,65,196,0.332,192,272,0.706,96,334,430,46,44,37,101,127,933,861,0.46,0.44,2012,13,11.961538461538462,0.45544554455445546,448,80,528,0.8143939393939394
2012-13,RegularSeason,1897,86,Metta World Peace,1610612747,LAL,75,2530,332,824,0.403,141,412,0.342,124,169,0.734,101,271,372,112,122,42,98,198,929,942,1.14,1.25,2012,13,12.386666666666667,1.1428571428571428,492,45,537,0.6927374301675978
2012-13,RegularSeason,201577,86,Robin Lopez,1610612740,NOH,82,2136,384,719,0.534,0,0,0.0,161,207,0.778,226,236,462,64,32,128,110,167,929,1124,0.58,0.29,2012,13,11.329268292682928,0.5818181818181818,335,46,381,1.2125984251968505
2012-13,RegularSeason,202702,88,Kenneth Faried,1610612743,DEN,80,2248,380,689,0.552,0,0,0.0,163,266,0.613,260,474,734,77,81,83,113,234,923,1373,0.68,0.72,2012,13,11.5375,0.6814159292035398,309,103,412,1.7815533980582525
2012-13,RegularSeason,1717,89,Dirk Nowitzki,1610612742,DAL,53,1661,343,728,0.471,65,157,0.414,166,193,0.86,37,326,363,132,38,37,70,93,917,1005,1.89,0.54,2012,13,17.30188679245283,1.8857142857142857,385,27,412,0.8810679611650486
2012-13,RegularSeason,201977,90,Marcus Thornton,1610612758,SAC,72,1726,332,774,0.429,141,379,0.372,111,126,0.881,50,131,181,91,61,4,68,105,916,728,1.34,0.9,2012,13,12.722222222222221,1.338235294117647,442,15,457,0.39606126914660833
2012-13,RegularSeason,202322,91,John Wall,1610612764,WAS,49,1602,324,735,0.441,12,45,0.267,246,306,0.804,35,161,196,373,65,37,157,117,906,949,2.38,0.41,2012,13,18.489795918367346,2.375796178343949,411,60,471,0.416135881104034
2012-13,RegularSeason,201150,92,Spencer Hawes,1610612755,PHI,82,2233,376,811,0.464,31,87,0.356,122,157,0.777,173,417,590,183,24,113,131,233,905,1214,1.4,0.18,2012,13,11.036585365853659,1.3969465648854962,435,35,470,1.2553191489361701
2012-13,RegularSeason,203079,93,Dion Waiters,1610612739,CLE,61,1756,336,815,0.412,63,203,0.31,159,213,0.746,22,127,149,183,59,16,121,113,894,647,1.51,0.49,2012,13,14.655737704918034,1.512396694214876,479,54,533,0.2795497185741088
2012-13,RegularSeason,201574,94,Jason Thompson,1610612758,SAC,82,2285,374,745,0.502,0,3,0.0,143,206,0.694,172,377,549,84,48,61,101,227,891,1098,0.83,0.47,2012,13,10.865853658536585,0.8316831683168316,371,63,434,1.2649769585253456
2012-13,RegularSeason,200751,95,Randy Foye,1610612762,UTA,82,2249,293,738,0.397,178,434,0.41,118,144,0.819,17,110,127,167,66,27,92,190,882,706,1.81,0.72,2012,13,10.75609756097561,1.815217391304348,445,26,471,0.26963906581740976
2012-13,RegularSeason,201196,96,Ramon Sessions,1610612766,CHA,61,1652,276,676,0.408,33,107,0.308,291,347,0.839,27,142,169,230,48,7,104,91,876,770,2.21,0.46,2012,13,14.360655737704919,2.2115384615384617,400,56,456,0.3706140350877193
2012-13,RegularSeason,201155,96,Rodney Stuckey,1610612765,DET,76,2171,304,748,0.406,55,182,0.302,213,272,0.783,43,169,212,270,51,17,134,127,876,789,2.02,0.38,2012,13,11.526315789473685,2.014925373134328,444,59,503,0.42147117296222664
2012-13,RegularSeason,201171,98,Carl Landry,1610612744,GSW,81,1876,325,602,0.54,1,3,0.333,223,273,0.817,180,303,483,65,35,31,115,190,874,1046,0.56,0.3,2012,13,10.790123456790123,0.5652173913043478,277,50,327,1.4770642201834863
2012-13,RegularSeason,101110,99,Martell Webster,1610612764,WAS,76,2200,281,636,0.442,139,329,0.422,168,198,0.848,53,241,294,143,49,17,90,166,869,897,1.59,0.54,2012,13,11.43421052631579,1.5888888888888888,355,30,385,0.7636363636363637
2012-13,RegularSeason,203076,100,Anthony Davis,1610612740,NOH,64,1846,349,676,0.516,0,6,0.0,169,225,0.751,165,357,522,63,75,112,89,158,867,1167,0.71,0.84,2012,13,13.546875,0.7078651685393258,327,56,383,1.3629242819843341
2012-13,RegularSeason,951,101,Ray Allen,1610612748,MIA,79,2035,292,651,0.449,139,332,0.419,140,158,0.886,40,177,217,135,67,15,103,129,863,817,1.31,0.65,2012,13,10.924050632911392,1.3106796116504855,359,18,377,0.5755968169761273
2012-13,RegularSeason,201162,102,Jared Dudley,1610612756,PHX,79,2170,313,669,0.468,106,271,0.391,129,162,0.796,79,166,245,203,75,8,101,128,861,902,2.01,0.74,2012,13,10.89873417721519,2.00990099009901,356,33,389,0.6298200514138818
2012-13,RegularSeason,2419,103,Tayshaun Prince,1610612763,MEM,82,2632,359,820,0.438,38,94,0.404,96,130,0.738,72,292,364,196,48,25,89,86,852,901,2.2,0.54,2012,13,10.390243902439025,2.202247191011236,461,34,495,0.7353535353535353
2012-13,RegularSeason,101154,104,Andray Blatche,1610612751,BKN,82,1555,346,676,0.512,3,22,0.136,148,216,0.685,161,256,417,85,86,54,123,163,843,964,0.69,0.7,2012,13,10.28048780487805,0.6910569105691057,330,68,398,1.0477386934673367
2012-13,RegularSeason,202087,105,Alonzo Gee,1610612739,CLE,82,2541,305,744,0.41,69,219,0.315,163,205,0.795,75,245,320,133,107,29,132,199,842,818,1.01,0.81,2012,13,10.268292682926829,1.0075757575757576,439,42,481,0.6652806652806653
2012-13,RegularSeason,2732,106,Ben Gordon,1610612766,CHA,75,1560,310,760,0.408,113,292,0.387,107,127,0.843,18,112,130,141,35,16,136,134,840,556,1.04,0.26,2012,13,11.2,1.036764705882353,450,20,470,0.2765957446808511
2012-13,RegularSeason,201980,107,Danny Green,1610612759,SAS,80,2201,297,663,0.448,177,413,0.429,67,79,0.848,36,208,244,141,92,54,94,124,838,897,1.5,0.98,2012,13,10.475,1.5,366,12,378,0.6455026455026455
2012-13,RegularSeason,201168,107,Tiago Splitter,1610612759,SAS,81,1997,315,563,0.56,0,2,0.0,208,285,0.73,144,371,515,130,63,64,100,161,838,1185,1.3,0.63,2012,13,10.345679012345679,1.3,248,77,325,1.5846153846153845
2012-13,RegularSeason,200826,109,J.J. Barea,1610612750,MIN,74,1713,316,758,0.417,97,280,0.346,105,134,0.784,34,173,207,294,32,0,145,131,834,751,2.03,0.22,2012,13,11.27027027027027,2.027586206896552,442,29,471,0.4394904458598726
2012-13,RegularSeason,201600,110,Ömer Aşik,1610612745,HOU,82,2464,332,614,0.541,0,1,0.0,168,299,0.562,275,681,956,75,46,87,173,223,832,1410,0.43,0.27,2012,13,10.146341463414634,0.43352601156069365,282,131,413,2.314769975786925
2012-13,RegularSeason,101181,111,Jose Calderon,1610612765,DET,73,2159,312,635,0.491,130,282,0.461,72,80,0.9,20,156,176,518,58,8,126,99,826,1129,4.11,0.46,2012,13,11.315068493150685,4.111111111111111,323,8,331,0.5317220543806647
2012-13,RegularSeason,2749,112,Jameer Nelson,1610612753,ORL,56,1977,306,780,0.392,121,355,0.341,89,102,0.873,23,186,209,413,71,6,154,161,822,880,2.68,0.46,2012,13,14.678571428571429,2.6818181818181817,474,13,487,0.42915811088295686
2012-13,RegularSeason,2440,112,Matt Barnes,1610612746,LAC,80,2058,312,675,0.462,111,325,0.342,87,117,0.744,111,255,366,123,82,63,90,233,822,973,1.37,0.91,2012,13,10.275,1.3666666666666667,363,30,393,0.9312977099236641
2012-13,RegularSeason,202348,114,Jordan Crawford,1610612738,BOS,70,1709,301,725,0.415,83,246,0.337,129,159,0.811,44,165,209,225,39,7,141,106,814,699,1.6,0.28,2012,13,11.628571428571428,1.5957446808510638,424,30,454,0.460352422907489
2012-13,RegularSeason,101161,115,Amir Johnson,1610612761,TOR,81,2325,336,606,0.554,5,13,0.385,136,187,0.727,227,384,611,122,81,110,117,301,813,1299,1.04,0.69,2012,13,10.037037037037036,1.0427350427350428,270,51,321,1.9034267912772587
2012-13,RegularSeason,2406,115,Caron Butler,1610612746,LAC,78,1879,305,720,0.424,128,330,0.388,75,90,0.833,41,182,223,78,51,11,72,139,813,674,1.08,0.71,2012,13,10.423076923076923,1.0833333333333333,415,15,430,0.5186046511627908
2012-13,RegularSeason,1890,117,Shawn Marion,1610612742,DAL,67,2010,355,690,0.514,23,73,0.315,79,101,0.782,146,379,525,163,75,47,103,111,812,1162,1.58,0.73,2012,13,12.119402985074627,1.5825242718446602,335,22,357,1.4705882352941178
2012-13,RegularSeason,2594,118,Kyle Korver,1610612737,ATL,74,2259,277,601,0.461,189,414,0.457,67,78,0.859,23,270,293,146,70,37,70,170,810,951,2.09,1.0,2012,13,10.945945945945946,2.085714285714286,324,11,335,0.8746268656716418
2012-13,RegularSeason,1891,119,Jason Terry,1610612738,BOS,79,2124,281,648,0.434,123,331,0.372,114,131,0.87,19,140,159,198,66,11,102,110,799,747,1.94,0.65,2012,13,10.113924050632912,1.9411764705882353,367,17,384,0.4140625
2012-13,RegularSeason,1905,120,Andrei Kirilenko,1610612750,MIN,64,2034,284,560,0.507,35,120,0.292,188,250,0.752,102,260,362,177,96,62,119,82,791,1031,1.49,0.81,2012,13,12.359375,1.4873949579831933,276,62,338,1.0710059171597632
2012-13,RegularSeason,200768,120,Kyle Lowry,1610612761,TOR,68,2020,250,623,0.401,101,279,0.362,190,239,0.795,56,265,321,435,94,24,157,218,791,1086,2.77,0.6,2012,13,11.632352941176471,2.770700636942675,373,49,422,0.7606635071090048
2012-13,RegularSeason,1889,122,Andre Miller,1610612743,DEN,82,2151,303,632,0.479,17,64,0.266,163,194,0.84,60,178,238,484,73,11,172,159,786,1060,2.81,0.42,2012,13,9.585365853658537,2.813953488372093,329,31,360,0.6611111111111111
2012-13,RegularSeason,2399,123,Mike Dunleavy,1610612749,MIL,75,1943,276,624,0.442,128,299,0.428,105,128,0.82,31,260,291,145,39,35,90,135,785,834,1.61,0.43,2012,13,10.466666666666667,1.6111111111111112,348,23,371,0.784366576819407
2012-13,RegularSeason,201149,124,Joakim Noah,1610612741,CHI,66,2426,303,630,0.481,0,5,0.0,178,237,0.751,260,473,733,262,78,141,176,185,784,1436,1.49,0.44,2012,13,11.878787878787879,1.4886363636363635,327,59,386,1.8989637305699483
2012-13,RegularSeason,203078,125,Bradley Beal,1610612764,WAS,56,1745,282,687,0.41,91,236,0.386,125,159,0.786,43,168,211,137,50,29,90,113,780,678,1.52,0.56,2012,13,13.928571428571429,1.5222222222222221,405,34,439,0.4806378132118451
2012-13,RegularSeason,2403,126,Nene,1610612764,WAS,61,1659,285,594,0.48,0,1,0.0,196,269,0.729,101,306,407,177,55,37,139,171,766,921,1.27,0.4,2012,13,12.557377049180328,1.2733812949640289,309,73,382,1.0654450261780104
2012-13,RegularSeason,2731,127,Emeka Okafor,1610612764,WAS,79,2052,328,687,0.477,0,0,0.0,109,191,0.571,199,493,692,93,45,77,107,145,765,1124,0.87,0.42,2012,13,9.683544303797468,0.8691588785046729,359,82,441,1.5691609977324263
2012-13,RegularSeason,201563,128,Michael Beasley,1610612756,PHX,75,1554,310,766,0.405,45,144,0.313,94,126,0.746,52,230,282,111,31,34,144,107,759,585,0.77,0.21,2012,13,10.12,0.7708333333333334,456,32,488,0.5778688524590164
2012-13,RegularSeason,203084,129,Harrison Barnes,1610612744,GSW,81,2058,276,628,0.439,52,145,0.359,144,190,0.758,53,280,333,98,52,14,101,140,748,746,0.97,0.52,2012,13,9.234567901234568,0.9702970297029703,352,46,398,0.8366834170854272
2012-13,RegularSeason,202335,130,Patrick Patterson,1610612758,SAC,71,1775,319,623,0.512,51,132,0.386,48,63,0.762,113,224,337,81,31,40,61,138,737,846,1.33,0.51,2012,13,10.380281690140846,1.3278688524590163,304,15,319,1.0564263322884013
2012-13,RegularSeason,101139,131,CJ Miles,1610612739,CLE,65,1364,255,614,0.415,126,328,0.384,93,107,0.869,24,150,174,63,49,17,69,138,729,590,0.91,0.71,2012,13,11.215384615384615,0.9130434782608695,359,14,373,0.46648793565683644
2012-13,RegularSeason,2748,131,Dorell Wright,1610612755,PHI,79,1783,237,599,0.396,135,361,0.374,120,141,0.851,42,260,302,150,62,35,64,98,729,831,2.34,0.97,2012,13,9.227848101265822,2.34375,362,21,383,0.7885117493472585
2012-13,RegularSeason,202324,133,Derrick Favors,1610612762,UTA,77,1787,274,568,0.482,0,5,0.0,179,260,0.688,184,362,546,75,67,130,129,247,727,1041,0.58,0.52,2012,13,9.441558441558442,0.5813953488372093,294,81,375,1.456
2012-13,RegularSeason,201599,134,DeAndre Jordan,1610612746,LAC,82,2010,314,488,0.643,0,0,0.0,96,249,0.386,210,384,594,28,48,112,100,192,724,1079,0.28,0.48,2012,13,8.829268292682928,0.28,174,153,327,1.81651376146789
2012-13,RegularSeason,202338,135,Kevin Seraphin,1610612764,WAS,79,1721,330,716,0.461,0,0,0.0,61,88,0.693,107,239,346,57,24,59,130,211,721,664,0.44,0.18,2012,13,9.126582278481013,0.43846153846153846,386,27,413,0.837772397094431
2012-13,RegularSeason,202713,136,Kyle Singler,1610612765,DET,82,2293,275,642,0.428,70,200,0.35,100,124,0.806,109,221,330,77,57,37,98,217,720,732,0.79,0.58,2012,13,8.78048780487805,0.7857142857142857,367,24,391,0.8439897698209718
2012-13,RegularSeason,201580,137,JaVale McGee,1610612743,DEN,79,1433,303,527,0.575,1,1,1.0,110,186,0.591,158,223,381,24,30,157,90,184,717,919,0.27,0.33,2012,13,9.075949367088608,0.26666666666666666,224,76,300,1.27
2012-13,RegularSeason,201569,138,Eric Gordon,1610612740,NOH,42,1264,235,584,0.402,56,173,0.324,187,222,0.842,10,67,77,137,45,8,117,75,713,479,1.17,0.39,2012,13,16.976190476190474,1.170940170940171,349,35,384,0.20052083333333334
2012-13,RegularSeason,1712,139,Antawn Jamison,1610612747,LAL,76,1636,267,575,0.464,84,233,0.361,94,136,0.691,109,253,362,50,30,22,53,124,712,773,0.94,0.57,2012,13,9.368421052631579,0.9433962264150944,308,42,350,1.0342857142857143
2012-13,RegularSeason,2568,140,Carlos Delfino,1610612745,HOU,67,1689,251,620,0.405,158,421,0.375,48,56,0.857,18,202,220,135,68,9,72,114,708,691,1.88,0.94,2012,13,10.567164179104477,1.875,369,8,377,0.583554376657825
2012-13,RegularSeason,202710,141,Jimmy Butler,1610612741,CHI,82,2134,239,512,0.467,40,105,0.381,187,233,0.803,136,192,328,115,78,31,62,97,705,876,1.85,1.26,2012,13,8.597560975609756,1.8548387096774193,273,46,319,1.0282131661442007
2012-13,RegularSeason,1938,141,Manu Ginobili,1610612759,SAS,60,1393,229,539,0.425,83,235,0.353,164,206,0.796,30,171,201,274,80,13,132,114,705,789,2.08,0.61,2012,13,11.75,2.0757575757575757,310,42,352,0.5710227272727273
2012-13,RegularSeason,2754,141,Tony Allen,1610612763,MEM,79,2109,284,638,0.445,3,24,0.125,134,187,0.717,121,242,363,98,119,44,94,211,705,828,1.04,1.27,2012,13,8.924050632911392,1.0425531914893618,354,53,407,0.8918918918918919
2012-13,RegularSeason,203077,144,Michael Kidd-Gilchrist,1610612766,CHA,78,2025,281,613,0.458,2,9,0.222,140,187,0.749,131,324,455,117,54,70,101,164,704,920,1.16,0.54,2012,13,9.025641025641026,1.1584158415841583,332,47,379,1.200527704485488
2012-13,RegularSeason,201158,145,Marco Belinelli,1610612741,CHI,73,1882,241,610,0.395,79,221,0.357,141,168,0.839,13,127,140,148,44,6,82,140,702,562,1.8,0.54,2012,13,9.616438356164384,1.8048780487804879,369,27,396,0.35353535353535354
2012-13,RegularSeason,101138,146,Brandon Bass,1610612738,BOS,81,2239,286,589,0.486,0,2,0.0,129,150,0.86,129,296,425,84,44,64,80,188,701,914,1.05,0.55,2012,13,8.654320987654321,1.05,303,21,324,1.3117283950617284
2012-13,RegularSeason,202336,147,Larry Sanders,1610612749,MIL,71,1937,306,605,0.506,0,2,0.0,84,136,0.618,224,448,672,83,53,201,87,233,696,1267,0.95,0.61,2012,13,9.80281690140845,0.9540229885057471,299,52,351,1.9145299145299146
2012-13,RegularSeason,201967,148,Dante Cunningham,1610612750,MIN,80,2010,314,671,0.468,0,6,0.0,67,103,0.65,142,266,408,67,84,38,56,153,695,843,1.2,1.5,2012,13,8.6875,1.1964285714285714,357,36,393,1.0381679389312977
2012-13,RegularSeason,101187,149,Alan Anderson,1610612761,TOR,65,1495,236,616,0.383,95,285,0.333,126,147,0.857,34,114,148,103,48,7,80,131,693,518,1.29,0.6,2012,13,10.661538461538461,1.2875,380,21,401,0.3690773067331671
2012-13,RegularSeason,2549,149,Chris Kaman,1610612742,DAL,66,1363,313,617,0.507,0,1,0.0,67,85,0.788,97,275,372,51,29,52,103,141,693,772,0.49,0.28,2012,13,10.5,0.49514563106796117,304,18,322,1.15527950310559
2012-13,RegularSeason,201573,149,Jerryd Bayless,1610612763,MEM,80,1765,260,621,0.419,71,201,0.353,102,122,0.836,22,154,176,264,59,17,120,168,693,708,2.2,0.49,2012,13,8.6625,2.2,361,20,381,0.46194225721784776
2012-13,RegularSeason,202695,152,Kawhi Leonard,1610612759,SAS,58,1810,260,526,0.494,65,174,0.374,104,126,0.825,63,283,346,93,97,32,62,99,689,907,1.5,1.56,2012,13,11.879310344827585,1.5,266,22,288,1.2013888888888888
2012-13,RegularSeason,2199,152,Tyson Chandler,1610612752,NYK,66,2164,255,400,0.638,0,0,0.0,179,258,0.694,269,434,703,62,42,75,87,188,689,1260,0.71,0.48,2012,13,10.43939393939394,0.7126436781609196,145,79,224,3.138392857142857
2012-13,RegularSeason,202362,154,Lance Stephenson,1610612754,IND,78,2278,275,598,0.46,62,188,0.33,75,115,0.652,47,257,304,223,81,16,109,162,687,839,2.05,0.74,2012,13,8.807692307692308,2.0458715596330275,323,40,363,0.837465564738292
2012-13,RegularSeason,101162,155,Marcin Gortat,1610612756,PHX,61,1876,295,566,0.521,0,3,0.0,90,138,0.652,128,388,516,75,40,98,99,127,680,991,0.76,0.4,2012,13,11.147540983606557,0.7575757575757576,271,48,319,1.6175548589341693
2012-13,RegularSeason,2200,156,Pau Gasol,1610612747,LAL,49,1655,270,579,0.466,8,28,0.286,125,178,0.702,111,310,421,200,24,61,104,93,673,913,1.92,0.23,2012,13,13.73469387755102,1.9230769230769231,309,53,362,1.1629834254143647
2012-13,RegularSeason,2422,157,John Salmons,1610612758,SAC,76,2278,244,612,0.399,99,267,0.371,85,110,0.773,33,174,207,226,51,25,85,143,672,703,2.66,0.6,2012,13,8.842105263157896,2.6588235294117646,368,25,393,0.5267175572519084
2012-13,RegularSeason,202693,158,Markieff Morris,1610612756,PHX,82,1837,266,653,0.407,45,134,0.336,93,127,0.732,131,265,396,108,77,64,104,209,670,790,1.04,0.74,2012,13,8.170731707317072,1.0384615384615385,387,34,421,0.9406175771971497
2012-13,RegularSeason,201596,159,Mario Chalmers,1610612748,MIA,77,2068,227,529,0.429,123,301,0.409,89,112,0.795,19,152,171,273,118,12,119,196,666,796,2.29,0.99,2012,13,8.64935064935065,2.2941176470588234,302,23,325,0.5261538461538462
2012-13,RegularSeason,203144,160,Alexey Shved,1610612750,MIN,77,1840,236,635,0.372,85,288,0.295,108,150,0.72,41,134,175,286,54,27,147,117,665,619,1.95,0.37,2012,13,8.636363636363637,1.945578231292517,399,42,441,0.3968253968253968
2012-13,RegularSeason,201578,161,Marreese Speights,1610612739,CLE,79,1300,260,584,0.445,3,10,0.3,135,175,0.771,146,240,386,47,24,53,80,175,658,724,0.59,0.3,2012,13,8.329113924050633,0.5875,324,40,364,1.0604395604395604
2012-13,RegularSeason,201585,162,Kosta Koufos,1610612743,DEN,81,1817,295,508,0.581,0,1,0.0,58,104,0.558,211,351,562,32,44,103,53,246,648,1077,0.6,0.83,2012,13,8.0,0.6037735849056604,213,46,259,2.16988416988417
2012-13,RegularSeason,202390,163,Gary Neal,1610612759,SAS,68,1484,246,597,0.412,89,251,0.355,64,74,0.865,13,130,143,129,30,2,69,93,645,519,1.87,0.43,2012,13,9.485294117647058,1.8695652173913044,351,10,361,0.3961218836565097
2012-13,RegularSeason,202339,164,Eric Bledsoe,1610612746,LAC,76,1553,253,568,0.445,31,78,0.397,106,134,0.791,78,147,225,233,109,55,137,112,643,785,1.7,0.8,2012,13,8.460526315789474,1.7007299270072993,315,28,343,0.6559766763848397
2012-13,RegularSeason,959,165,Steve Nash,1610612747,LAL,50,1627,236,475,0.497,57,130,0.438,107,116,0.922,26,116,142,333,30,5,126,70,636,772,2.64,0.24,2012,13,12.72,2.642857142857143,239,9,248,0.5725806451612904
2012-13,RegularSeason,101198,165,Will Bynum,1610612765,DET,65,1219,253,540,0.469,24,76,0.316,106,131,0.809,28,69,97,231,45,5,125,128,636,577,1.85,0.36,2012,13,9.784615384615385,1.848,287,25,312,0.3108974358974359
2012-13,RegularSeason,201156,167,Nick Young,1610612755,PHI,59,1411,224,542,0.413,75,210,0.357,105,128,0.82,24,106,130,84,36,14,50,84,628,501,1.68,0.72,2012,13,10.64406779661017,1.68,318,23,341,0.3812316715542522
2012-13,RegularSeason,203090,168,Maurice Harkless,1610612753,ORL,76,1974,260,564,0.461,32,117,0.274,73,128,0.57,122,213,335,50,88,62,69,144,625,732,0.72,1.27,2012,13,8.223684210526315,0.7246376811594203,304,55,359,0.9331476323119777
2012-13,RegularSeason,202334,169,Ed Davis,1610612763,MEM,81,1631,260,482,0.539,0,0,0.0,103,167,0.617,152,308,460,63,38,85,63,191,623,920,1.0,0.6,2012,13,7.691358024691358,1.0,222,64,286,1.6083916083916083
2012-13,RegularSeason,201975,170,Jodie Meeks,1610612747,LAL,78,1663,205,530,0.387,122,342,0.357,86,96,0.896,37,134,171,69,58,5,52,103,618,534,1.33,1.11,2012,13,7.923076923076923,1.3269230769230769,325,10,335,0.5104477611940299
2012-13,RegularSeason,200769,171,Shannon Brown,1610612756,PHX,59,1402,240,571,0.42,39,141,0.277,98,125,0.784,44,105,149,108,59,15,74,92,617,516,1.46,0.8,2012,13,10.457627118644067,1.4594594594594594,331,27,358,0.41620111731843573
2012-13,RegularSeason,201961,172,Wayne Ellington,1610612739,CLE,78,1661,226,529,0.427,94,240,0.392,68,75,0.907,25,141,166,104,45,3,57,81,614,565,1.82,0.79,2012,13,7.871794871794871,1.8245614035087718,303,7,310,0.535483870967742
2012-13,RegularSeason,200757,173,Thabo Sefolosha,1610612760,OKC,81,2229,224,466,0.481,108,258,0.419,57,69,0.826,58,259,317,125,103,44,64,177,613,884,1.95,1.61,2012,13,7.567901234567901,1.953125,242,12,254,1.2480314960629921
2012-13,RegularSeason,201584,174,Courtney Lee,1610612738,BOS,78,1941,246,530,0.464,58,156,0.372,62,72,0.861,31,159,190,143,89,21,84,139,612,677,1.7,1.06,2012,13,7.846153846153846,1.7023809523809523,284,10,294,0.6462585034013606
2012-13,RegularSeason,203092,175,Tyler Zeller,1610612739,CLE,77,2033,245,559,0.438,0,4,0.0,120,157,0.764,159,279,438,96,35,70,95,251,610,803,1.01,0.37,2012,13,7.922077922077922,1.0105263157894737,314,37,351,1.2478632478632479
2012-13,RegularSeason,201937,176,Ricky Rubio,1610612750,MIN,57,1691,185,514,0.36,27,92,0.293,211,264,0.799,44,185,229,418,137,5,172,143,608,843,2.43,0.8,2012,13,10.666666666666666,2.4302325581395348,329,53,382,0.599476439790576
2012-13,RegularSeason,202699,177,Tobias Harris,1610612753,ORL,55,1299,233,512,0.455,34,108,0.315,103,137,0.752,73,214,287,69,32,44,66,120,603,656,1.04,0.48,2012,13,10.963636363636363,1.0454545454545454,279,34,313,0.9169329073482428
2012-13,RegularSeason,202694,178,Marcus Morris Sr.,1610612756,PHX,77,1524,222,526,0.422,86,233,0.369,66,117,0.564,80,197,277,62,45,20,77,160,596,568,0.81,0.58,2012,13,7.740259740259741,0.8051948051948052,304,51,355,0.780281690140845
2012-13,RegularSeason,2590,179,Mo Williams,1610612762,UTA,46,1418,229,533,0.43,59,154,0.383,75,85,0.882,24,86,110,285,46,9,125,105,592,603,2.28,0.37,2012,13,12.869565217391305,2.28,304,10,314,0.3503184713375796
2012-13,RegularSeason,202734,180,E'Twaun Moore,1610612753,ORL,75,1682,237,598,0.396,67,197,0.34,47,59,0.797,48,119,167,206,51,23,105,122,588,557,1.96,0.49,2012,13,7.84,1.9619047619047618,361,12,373,0.4477211796246649
2012-13,RegularSeason,203094,181,Andrew Nicholson,1610612753,ORL,75,1249,256,486,0.527,0,0,0.0,75,94,0.798,69,189,258,44,24,32,79,133,587,617,0.56,0.3,2012,13,7.826666666666667,0.5569620253164557,230,19,249,1.036144578313253
2012-13,RegularSeason,2734,182,Devin Harris,1610612737,ATL,58,1421,194,443,0.438,77,230,0.335,112,154,0.727,6,110,116,197,64,13,88,103,577,588,2.24,0.73,2012,13,9.948275862068966,2.2386363636363638,249,42,291,0.39862542955326463
2012-13,RegularSeason,201946,183,Tyler Hansbrough,1610612754,IND,81,1366,176,407,0.432,0,3,0.0,216,300,0.72,161,212,373,36,29,18,78,152,568,631,0.46,0.37,2012,13,7.012345679012346,0.46153846153846156,231,84,315,1.1841269841269841
2012-13,RegularSeason,201957,184,Byron Mullens,1610612766,CHA,53,1428,217,563,0.385,66,208,0.317,64,99,0.646,71,266,337,81,34,32,74,110,564,593,1.09,0.46,2012,13,10.641509433962264,1.0945945945945945,346,35,381,0.884514435695538
2012-13,RegularSeason,201163,185,Wilson Chandler,1610612743,DEN,43,1079,210,455,0.462,52,126,0.413,88,111,0.793,45,173,218,58,45,12,60,119,560,565,0.97,0.75,2012,13,13.023255813953488,0.9666666666666667,245,23,268,0.8134328358208955
2012-13,RegularSeason,202329,186,Al-Farouq Aminu,1610612740,NOH,76,2066,225,474,0.475,4,19,0.211,101,137,0.737,139,446,585,103,92,51,116,153,555,985,0.89,0.79,2012,13,7.302631578947368,0.8879310344827587,249,36,285,2.0526315789473686
2012-13,RegularSeason,203148,186,Brian Roberts,1610612740,NOH,78,1324,213,511,0.417,59,153,0.386,70,77,0.909,17,80,97,219,37,3,71,108,555,535,3.08,0.52,2012,13,7.115384615384615,3.084507042253521,298,7,305,0.3180327868852459
2012-13,RegularSeason,202685,188,Jonas Valanciunas,1610612761,TOR,62,1482,204,366,0.557,0,0,0.0,146,185,0.789,121,251,372,45,17,78,94,188,554,771,0.48,0.18,2012,13,8.935483870967742,0.4787234042553192,162,39,201,1.8507462686567164
2012-13,RegularSeason,101150,189,Lou Williams,1610612737,ATL,39,1119,187,443,0.422,72,196,0.367,105,121,0.868,8,72,80,139,44,10,74,55,551,478,1.88,0.59,2012,13,14.128205128205128,1.8783783783783783,256,16,272,0.29411764705882354
2012-13,RegularSeason,201228,190,C.J. Watson,1610612751,BKN,80,1521,192,459,0.418,88,214,0.411,71,91,0.78,38,107,145,161,66,12,69,123,543,571,2.33,0.96,2012,13,6.7875,2.3333333333333335,267,20,287,0.5052264808362369
2012-13,RegularSeason,201148,191,Brandan Wright,1610612742,DAL,64,1149,241,404,0.597,0,3,0.0,59,96,0.615,85,175,260,38,26,76,34,78,541,707,1.12,0.77,2012,13,8.453125,1.1176470588235294,163,37,200,1.3
2012-13,RegularSeason,2757,192,Beno Udrih,1610612753,ORL,66,1457,210,476,0.441,34,102,0.333,84,103,0.816,34,107,141,302,41,3,108,90,538,632,2.8,0.38,2012,13,8.151515151515152,2.7962962962962963,266,19,285,0.49473684210526314
2012-13,RegularSeason,200779,193,Steve Novak,1610612752,NYK,81,1641,178,430,0.414,149,351,0.425,30,33,0.909,17,135,152,35,28,8,12,97,535,491,2.92,2.33,2012,13,6.604938271604938,2.9166666666666665,252,3,255,0.596078431372549
2012-13,RegularSeason,201962,194,Toney Douglas,1610612758,SAC,71,1288,188,466,0.403,82,216,0.38,76,84,0.905,34,104,138,151,71,3,81,145,534,530,1.86,0.88,2012,13,7.52112676056338,1.8641975308641976,278,8,286,0.4825174825174825
2012-13,RegularSeason,2222,195,Gerald Wallace,1610612751,BKN,69,2076,182,458,0.397,46,163,0.282,121,190,0.637,69,250,319,181,97,46,110,118,531,719,1.65,0.88,2012,13,7.695652173913044,1.6454545454545455,276,69,345,0.9246376811594202
2012-13,RegularSeason,2772,196,Trevor Ariza,1610612764,WAS,56,1471,188,451,0.417,76,209,0.364,78,95,0.821,44,222,266,113,72,20,84,72,530,637,1.34,0.86,2012,13,9.464285714285714,1.3452380952380953,263,17,280,0.95
2012-13,RegularSeason,101107,197,Marvin Williams,1610612762,UTA,73,1727,199,470,0.423,54,166,0.325,77,99,0.778,55,208,263,77,37,38,60,98,529,591,1.28,0.62,2012,13,7.2465753424657535,1.2833333333333334,271,22,293,0.8976109215017065
2012-13,RegularSeason,200765,198,Rajon Rondo,1610612738,BOS,38,1423,225,465,0.484,12,50,0.24,60,93,0.645,43,169,212,420,70,9,148,96,522,812,2.84,0.47,2012,13,13.736842105263158,2.8378378378378377,240,33,273,0.7765567765567766
2012-13,RegularSeason,1882,199,Elton Brand,1610612742,DAL,72,1527,226,478,0.473,0,1,0.0,66,93,0.71,130,300,430,70,50,90,57,192,518,822,1.23,0.88,2012,13,7.194444444444445,1.2280701754385965,252,27,279,1.5412186379928314
2012-13,RegularSeason,201959,200,Taj Gibson,1610612741,CHI,65,1459,214,441,0.485,0,4,0.0,89,131,0.679,125,220,345,61,27,90,76,166,517,695,0.8,0.35,2012,13,7.953846153846154,0.8026315789473685,227,42,269,1.2825278810408922
2012-13,RegularSeason,201175,201,Glen Davis,1610612753,ORL,34,1064,214,478,0.448,0,2,0.0,84,117,0.718,55,191,246,70,32,21,64,88,512,520,1.09,0.5,2012,13,15.058823529411764,1.09375,264,33,297,0.8282828282828283
2012-13,RegularSeason,202683,202,Enes Freedom,1610612762,UTA,70,1078,206,379,0.544,1,1,1.0,93,117,0.795,135,169,304,31,28,32,101,116,506,603,0.31,0.28,2012,13,7.228571428571429,0.3069306930693069,173,24,197,1.5431472081218274
2012-13,RegularSeason,200782,202,P.J. Tucker,1610612756,PHX,79,1910,210,444,0.473,22,70,0.314,64,86,0.744,132,218,350,109,62,19,67,145,506,723,1.63,0.93,2012,13,6.405063291139241,1.626865671641791,234,22,256,1.3671875
2012-13,RegularSeason,101131,204,Jason Maxiell,1610612765,DET,72,1789,204,457,0.446,0,0,0.0,90,145,0.621,135,274,409,54,32,95,81,172,498,699,0.67,0.4,2012,13,6.916666666666667,0.6666666666666666,253,55,308,1.327922077922078
2012-13,RegularSeason,202690,205,Jimmer Fredette,1610612758,SAC,69,967,172,409,0.421,65,156,0.417,85,99,0.859,19,52,71,92,31,3,68,64,494,372,1.35,0.46,2012,13,7.159420289855072,1.3529411764705883,237,14,251,0.28286852589641437
2012-13,RegularSeason,1888,206,Richard Hamilton,1610612741,CHI,50,1088,204,475,0.429,16,52,0.308,66,77,0.857,16,67,83,119,24,5,84,93,490,355,1.42,0.29,2012,13,9.8,1.4166666666666667,271,11,282,0.29432624113475175
2012-13,RegularSeason,203142,207,Chris Copeland,1610612752,NYK,56,862,182,380,0.479,59,140,0.421,63,83,0.759,34,85,119,27,16,12,50,104,486,392,0.54,0.32,2012,13,8.678571428571429,0.54,198,20,218,0.5458715596330275
2012-13,RegularSeason,203083,208,Andre Drummond,1610612765,DET,60,1243,208,342,0.608,1,2,0.5,59,159,0.371,169,288,457,30,59,95,57,144,476,826,0.53,1.03,2012,13,7.933333333333334,0.5263157894736842,134,100,234,1.952991452991453
2012-13,RegularSeason,203106,209,Jeffery Taylor,1610612766,CHA,77,1507,172,399,0.431,53,154,0.344,75,103,0.728,51,99,150,63,47,15,48,136,472,444,1.31,0.98,2012,13,6.12987012987013,1.3125,227,28,255,0.5882352941176471
2012-13,RegularSeason,2203,209,Shane Battier,1610612748,MIA,72,1786,152,362,0.42,136,316,0.43,32,38,0.842,37,128,165,72,41,55,34,149,472,555,2.12,1.21,2012,13,6.555555555555555,2.1176470588235294,210,6,216,0.7638888888888888
2012-13,RegularSeason,101111,211,Charlie Villanueva,1610612765,DET,69,1092,175,464,0.377,90,259,0.347,27,49,0.551,49,192,241,54,31,39,39,96,467,482,1.39,0.8,2012,13,6.768115942028985,1.3846153846153846,289,22,311,0.77491961414791
2012-13,RegularSeason,203082,211,Terrence Ross,1610612761,TOR,73,1239,186,457,0.407,65,196,0.332,30,42,0.714,35,109,144,53,43,14,48,122,467,390,1.1,0.9,2012,13,6.397260273972603,1.1041666666666667,271,12,283,0.508833922261484
2012-13,RegularSeason,202340,213,Avery Bradley,1610612738,BOS,50,1435,192,478,0.402,40,126,0.317,37,49,0.755,30,81,111,104,64,19,72,129,461,389,1.44,0.89,2012,13,9.22,1.4444444444444444,286,12,298,0.3724832214765101
2012-13,RegularSeason,2550,214,Kirk Hinrich,1610612741,CHI,60,1764,159,422,0.377,71,182,0.39,70,98,0.714,16,142,158,314,63,25,99,192,459,629,3.17,0.64,2012,13,7.65,3.1717171717171717,263,28,291,0.5429553264604811
2012-13,RegularSeason,467,215,Jason Kidd,1610612752,NYK,76,2043,152,409,0.372,114,325,0.351,40,48,0.833,50,273,323,249,125,25,76,125,458,839,3.28,1.65,2012,13,6.026315789473684,3.276315789473684,257,8,265,1.2188679245283018
2012-13,RegularSeason,202730,216,Lavoy Allen,1610612755,PHI,79,1669,206,454,0.454,0,1,0.0,43,60,0.717,159,236,395,73,24,55,55,180,455,682,1.33,0.44,2012,13,5.7594936708860756,1.3272727272727274,248,17,265,1.490566037735849
2012-13,RegularSeason,979,217,Jermaine O'Neal,1610612756,PHX,55,1029,179,371,0.482,0,0,0.0,96,115,0.835,82,211,293,42,19,78,73,126,454,602,0.57,0.26,2012,13,8.254545454545454,0.5753424657534246,192,19,211,1.3886255924170616
2012-13,RegularSeason,201274,218,Ivan Johnson,1610612737,ATL,69,1035,185,356,0.52,1,13,0.077,81,131,0.618,76,190,266,46,56,14,71,131,452,542,0.65,0.79,2012,13,6.550724637681159,0.647887323943662,171,50,221,1.2036199095022624
2012-13,RegularSeason,202692,219,Alec Burks,1610612762,UTA,64,1137,163,388,0.42,33,92,0.359,92,129,0.713,37,108,145,92,35,13,74,114,451,400,1.24,0.47,2012,13,7.046875,1.2432432432432432,225,37,262,0.5534351145038168
2012-13,RegularSeason,2584,220,Willie Green,1610612746,LAC,72,1188,178,386,0.461,71,166,0.428,23,32,0.719,17,80,97,55,29,12,31,96,450,395,1.77,0.94,2012,13,6.25,1.7741935483870968,208,9,217,0.4470046082949309
2012-13,RegularSeason,202708,221,Norris Cole,1610612748,MIA,80,1590,179,425,0.421,35,98,0.357,52,80,0.65,18,112,130,164,57,7,104,155,445,425,1.58,0.55,2012,13,5.5625,1.5769230769230769,246,28,274,0.4744525547445255
2012-13,RegularSeason,200745,222,Andrea Bargnani,1610612761,TOR,35,1003,170,426,0.399,38,123,0.309,65,77,0.844,26,102,128,38,21,23,54,64,443,331,0.7,0.39,2012,13,12.657142857142857,0.7037037037037037,256,12,268,0.47761194029850745
2012-13,RegularSeason,201985,223,AJ Price,1610612764,WAS,57,1278,161,413,0.39,70,200,0.35,49,62,0.79,20,94,114,205,33,3,64,73,441,467,3.2,0.52,2012,13,7.7368421052631575,3.203125,252,13,265,0.43018867924528303
2012-13,RegularSeason,2564,224,Boris Diaw,1610612759,SAS,75,1709,179,332,0.539,30,78,0.385,47,65,0.723,66,188,254,180,52,27,84,143,435,693,2.14,0.62,2012,13,5.8,2.142857142857143,153,18,171,1.4853801169590644
2012-13,RegularSeason,201947,225,Earl Clark,1610612747,LAL,59,1363,170,386,0.44,35,104,0.337,53,76,0.697,82,243,325,65,36,44,62,102,428,597,1.05,0.58,2012,13,7.254237288135593,1.0483870967741935,216,23,239,1.3598326359832635
2012-13,RegularSeason,101123,226,Gerald Green,1610612754,IND,60,1080,155,424,0.366,59,188,0.314,52,65,0.8,31,110,141,50,19,23,53,64,421,319,0.94,0.36,2012,13,7.016666666666667,0.9433962264150944,269,13,282,0.5
2012-13,RegularSeason,202962,226,Greg Smith,1610612745,HOU,70,1110,170,274,0.62,0,1,0.0,81,130,0.623,111,210,321,25,18,40,41,175,421,631,0.61,0.44,2012,13,6.014285714285714,0.6097560975609756,104,49,153,2.0980392156862746
2012-13,RegularSeason,201160,228,Jason Smith,1610612740,NOH,51,876,167,341,0.49,0,4,0.0,86,102,0.843,64,122,186,34,15,45,55,123,420,455,0.62,0.27,2012,13,8.235294117647058,0.6181818181818182,174,16,190,0.9789473684210527
2012-13,RegularSeason,2733,229,Shaun Livingston,1610612739,CLE,66,1455,166,346,0.48,0,4,0.0,85,98,0.867,31,127,158,215,48,31,76,127,417,600,2.83,0.63,2012,13,6.318181818181818,2.8289473684210527,180,13,193,0.8186528497409327
2012-13,RegularSeason,2405,230,Amar'e Stoudemire,1610612752,NYK,29,682,154,267,0.577,0,0,0.0,105,130,0.808,60,85,145,13,10,21,50,89,413,414,0.26,0.2,2012,13,14.241379310344827,0.26,113,25,138,1.0507246376811594
2012-13,RegularSeason,2555,231,Nick Collison,1610612760,OKC,81,1583,176,296,0.595,0,4,0.0,60,78,0.769,123,210,333,121,51,30,69,197,412,740,1.75,0.74,2012,13,5.08641975308642,1.7536231884057971,120,18,138,2.4130434782608696
2012-13,RegularSeason,101133,232,Ian Mahinmi,1610612754,IND,80,1322,149,329,0.453,0,2,0.0,104,171,0.608,115,196,311,27,39,66,92,201,402,506,0.29,0.42,2012,13,5.025,0.29347826086956524,180,67,247,1.2591093117408907
2012-13,RegularSeason,201177,233,Josh McRoberts,1610612766,CHA,67,1487,156,343,0.455,24,84,0.286,65,85,0.765,93,232,325,141,32,27,66,131,401,653,2.14,0.48,2012,13,5.985074626865671,2.1363636363636362,187,20,207,1.570048309178744
2012-13,RegularSeason,202325,234,Wesley Johnson,1610612756,PHX,50,953,161,396,0.407,50,155,0.323,27,35,0.771,21,102,123,34,22,18,48,56,399,305,0.71,0.46,2012,13,7.98,0.7083333333333334,235,8,243,0.5061728395061729
2012-13,RegularSeason,202705,235,MarShon Brooks,1610612751,BKN,73,912,155,335,0.463,15,55,0.273,69,94,0.734,32,72,104,76,34,16,69,93,394,350,1.1,0.49,2012,13,5.397260273972603,1.1014492753623188,180,25,205,0.5073170731707317
2012-13,RegularSeason,201960,236,DeMarre Carroll,1610612762,UTA,66,1111,149,324,0.46,20,70,0.286,75,98,0.765,87,101,188,61,58,24,34,119,393,492,1.79,1.71,2012,13,5.954545454545454,1.7941176470588236,175,23,198,0.9494949494949495
2012-13,RegularSeason,203109,237,Jae Crowder,1610612742,DAL,78,1353,141,367,0.384,63,192,0.328,47,73,0.644,35,152,187,94,63,17,49,128,392,452,1.92,1.29,2012,13,5.0256410256410255,1.9183673469387754,226,26,252,0.7420634920634921
2012-13,RegularSeason,2863,238,Damien Wilkins,1610612755,PHI,61,1095,145,316,0.459,17,51,0.333,81,109,0.743,32,73,105,91,37,18,49,98,388,391,1.86,0.76,2012,13,6.360655737704918,1.8571428571428572,171,28,199,0.5276381909547738
2012-13,RegularSeason,201601,239,Luc Mbah a Moute,1610612749,MIL,58,1326,151,377,0.401,13,37,0.351,72,126,0.571,89,167,256,55,42,14,70,82,387,404,0.79,0.6,2012,13,6.672413793103448,0.7857142857142857,226,54,280,0.9142857142857143
2012-13,RegularSeason,202687,240,Bismack Biyombo,1610612766,CHA,80,2186,156,346,0.451,0,0,0.0,74,142,0.521,194,388,582,35,28,143,82,195,386,834,0.43,0.34,2012,13,4.825,0.4268292682926829,190,68,258,2.255813953488372
2012-13,RegularSeason,203089,241,John Henson,1610612749,MIL,63,827,162,336,0.482,0,3,0.0,56,105,0.533,116,181,297,31,19,42,47,83,380,499,0.66,0.4,2012,13,6.031746031746032,0.6595744680851063,174,49,223,1.3318385650224216
2012-13,RegularSeason,203085,242,Austin Rivers,1610612740,NOH,61,1418,145,390,0.372,28,86,0.326,59,108,0.546,16,93,109,127,26,9,74,122,377,280,1.72,0.35,2012,13,6.180327868852459,1.7162162162162162,245,49,294,0.3707482993197279
2012-13,RegularSeason,201973,242,Jonas Jerebko,1610612765,DET,49,892,142,316,0.449,25,83,0.301,68,88,0.773,68,117,185,43,38,8,42,90,377,415,1.02,0.91,2012,13,7.6938775510204085,1.0238095238095237,174,20,194,0.9536082474226805
2012-13,RegularSeason,203086,242,Meyers Leonard,1610612757,POR,69,1206,151,277,0.545,3,7,0.429,72,89,0.809,80,175,255,33,11,38,49,168,377,522,0.67,0.22,2012,13,5.463768115942029,0.673469387755102,126,17,143,1.7832167832167831
2012-13,RegularSeason,201166,245,Aaron Brooks,1610612745,HOU,53,997,143,316,0.453,50,134,0.373,40,52,0.769,13,67,80,114,30,10,67,94,376,358,1.7,0.45,2012,13,7.09433962264151,1.7014925373134329,173,12,185,0.43243243243243246
2012-13,RegularSeason,2743,246,Kris Humphries,1610612751,BKN,65,1191,139,310,0.448,0,2,0.0,97,123,0.789,126,239,365,32,16,33,57,127,375,567,0.56,0.28,2012,13,5.769230769230769,0.5614035087719298,171,26,197,1.8527918781725887
2012-13,RegularSeason,202347,246,Quincy Pondexter,1610612763,MEM,59,1243,128,299,0.428,60,152,0.395,59,75,0.787,43,89,132,61,35,6,42,95,375,380,1.45,0.83,2012,13,6.3559322033898304,1.4523809523809523,171,16,187,0.7058823529411765
2012-13,RegularSeason,203098,248,John Jenkins,1610612737,ATL,61,902,131,294,0.446,53,138,0.384,59,70,0.843,17,77,94,56,12,10,40,37,374,332,1.4,0.3,2012,13,6.131147540983607,1.4,163,11,174,0.5402298850574713
2012-13,RegularSeason,202704,248,Reggie Jackson,1610612760,OKC,70,993,149,325,0.458,24,104,0.231,52,62,0.839,21,145,166,122,29,13,53,84,374,465,2.3,0.55,2012,13,5.3428571428571425,2.30188679245283,176,10,186,0.8924731182795699
2012-13,RegularSeason,2427,250,Roger Mason Jr.,1610612740,NOH,69,1219,132,305,0.433,66,159,0.415,39,43,0.907,11,121,132,74,26,11,51,104,369,384,1.45,0.51,2012,13,5.3478260869565215,1.4509803921568627,173,4,177,0.7457627118644068
2012-13,RegularSeason,2501,251,Reggie Evans,1610612751,BKN,80,1967,125,261,0.479,0,0,0.0,113,222,0.509,260,628,888,43,74,13,111,199,363,1025,0.39,0.67,2012,13,4.5375,0.38738738738738737,136,109,245,3.6244897959183673
2012-13,RegularSeason,201589,252,Darrell Arthur,1610612763,MEM,59,970,162,359,0.451,5,18,0.278,33,46,0.717,68,101,169,33,24,33,43,126,362,368,0.77,0.56,2012,13,6.135593220338983,0.7674418604651163,197,13,210,0.8047619047619048
2012-13,RegularSeason,201571,253,D.J. Augustin,1610612754,IND,76,1226,103,294,0.35,67,190,0.353,83,99,0.838,20,71,91,170,34,3,68,64,356,379,2.5,0.5,2012,13,4.684210526315789,2.5,191,16,207,0.4396135265700483
2012-13,RegularSeason,2760,254,Anderson Varejao,1610612739,CLE,25,901,138,289,0.478,0,5,0.0,77,102,0.755,138,223,361,84,37,14,44,68,353,629,1.91,0.84,2012,13,14.12,1.9090909090909092,151,25,176,2.0511363636363638
2012-13,RegularSeason,2202,255,Jason Richardson,1610612755,PHI,33,936,135,336,0.402,57,167,0.341,20,33,0.606,19,108,127,51,40,15,26,57,347,340,1.96,1.54,2012,13,10.515151515151516,1.9615384615384615,201,13,214,0.5934579439252337
2012-13,RegularSeason,1536,256,Stephen Jackson,1610612759,SAS,55,1075,123,330,0.373,46,170,0.271,49,70,0.7,22,133,155,80,37,14,77,89,341,322,1.04,0.48,2012,13,6.2,1.0389610389610389,207,21,228,0.6798245614035088
2012-13,RegularSeason,101249,257,John Lucas III,1610612761,TOR,63,827,129,334,0.386,57,151,0.377,18,25,0.72,8,57,65,105,23,1,26,50,333,289,4.04,0.89,2012,13,5.285714285714286,4.038461538461538,205,7,212,0.30660377358490565
2012-13,RegularSeason,203080,257,Thomas Robinson,1610612745,HOU,70,1056,138,321,0.43,0,1,0.0,57,109,0.523,122,193,315,46,41,26,88,124,333,438,0.52,0.47,2012,13,4.757142857142857,0.5227272727272727,183,52,235,1.3404255319148937
2012-13,RegularSeason,2742,259,Sebastian Telfair,1610612761,TOR,59,980,112,309,0.362,53,150,0.353,54,69,0.783,13,71,84,153,37,11,64,104,331,340,2.39,0.58,2012,13,5.610169491525424,2.390625,197,15,212,0.39622641509433965
2012-13,RegularSeason,2570,260,Kendrick Perkins,1610612760,OKC,78,1954,143,313,0.457,0,1,0.0,44,72,0.611,110,356,466,111,43,83,109,227,330,726,1.02,0.39,2012,13,4.230769230769231,1.018348623853211,170,28,198,2.3535353535353534
2012-13,RegularSeason,201567,260,Kevin Love,1610612750,MIN,18,618,105,298,0.352,20,92,0.217,100,142,0.704,64,188,252,42,13,9,39,34,330,372,1.08,0.33,2012,13,18.333333333333332,1.0769230769230769,193,42,235,1.0723404255319149
2012-13,RegularSeason,1885,260,Lamar Odom,1610612746,LAC,82,1616,146,366,0.399,18,90,0.2,20,42,0.476,117,363,480,142,69,58,86,214,330,751,1.65,0.8,2012,13,4.024390243902439,1.6511627906976745,220,22,242,1.9834710743801653
2012-13,RegularSeason,201971,263,DeJuan Blair,1610612759,SAS,61,851,142,271,0.524,0,1,0.0,44,70,0.629,66,164,230,45,37,10,49,112,328,446,0.92,0.76,2012,13,5.377049180327869,0.9183673469387755,129,26,155,1.4838709677419355
2012-13,RegularSeason,2581,264,Steve Blake,1610612747,LAL,45,1175,114,270,0.422,72,171,0.421,27,35,0.771,21,111,132,173,34,6,62,83,327,446,2.79,0.55,2012,13,7.266666666666667,2.7903225806451615,156,8,164,0.8048780487804879
2012-13,RegularSeason,2605,265,Marquis Daniels,1610612749,MIL,59,1085,132,351,0.376,20,72,0.278,40,54,0.741,48,102,150,65,51,10,45,77,324,322,1.44,1.13,2012,13,5.491525423728813,1.4444444444444444,219,14,233,0.6437768240343348
2012-13,RegularSeason,202327,266,Ekpe Udoh,1610612749,MIL,76,1312,117,269,0.435,0,1,0.0,89,119,0.748,113,138,251,43,39,85,43,139,323,516,1.0,0.91,2012,13,4.25,1.0,152,30,182,1.379120879120879
2012-13,RegularSeason,101128,267,Francisco Garcia,1610612745,HOU,58,1029,118,300,0.393,67,179,0.374,18,21,0.857,8,83,91,63,46,38,32,88,321,342,1.97,1.44,2012,13,5.5344827586206895,1.96875,182,3,185,0.4918918918918919
2012-13,RegularSeason,2223,268,Samuel Dalembert,1610612749,MIL,47,765,137,253,0.542,1,1,1.0,38,55,0.691,105,171,276,21,17,53,51,90,313,496,0.41,0.33,2012,13,6.659574468085107,0.4117647058823529,116,17,133,2.075187969924812
2012-13,RegularSeason,2586,269,Keith Bogans,1610612751,BKN,74,1408,108,284,0.38,84,245,0.343,11,17,0.647,16,104,120,76,28,4,49,108,311,308,1.55,0.57,2012,13,4.202702702702703,1.5510204081632653,176,6,182,0.6593406593406593
2012-13,RegularSeason,201880,270,Greg Stiemsma,1610612750,MIN,76,1209,127,278,0.457,0,0,0.0,53,69,0.768,61,200,261,30,44,90,59,184,307,506,0.51,0.75,2012,13,4.0394736842105265,0.5084745762711864,151,16,167,1.562874251497006
2012-13,RegularSeason,2585,271,Zaza Pachulia,1610612737,ATL,52,1134,114,241,0.473,0,3,0.0,78,103,0.757,132,204,336,79,35,12,70,128,306,546,1.13,0.5,2012,13,5.884615384615385,1.1285714285714286,127,25,152,2.210526315789474
2012-13,RegularSeason,202697,272,Iman Shumpert,1610612752,NYK,45,996,109,275,0.396,51,127,0.402,36,47,0.766,31,105,136,75,43,7,37,99,305,352,2.03,1.16,2012,13,6.777777777777778,2.027027027027027,166,11,177,0.768361581920904
2012-13,RegularSeason,203115,273,Will Barton,1610612757,POR,73,894,118,309,0.382,9,65,0.138,50,65,0.769,36,109,145,58,34,9,60,56,295,275,0.97,0.57,2012,13,4.041095890410959,0.9666666666666667,191,15,206,0.7038834951456311
2012-13,RegularSeason,201988,274,Patty Mills,1610612759,SAS,58,656,113,241,0.469,52,130,0.4,16,19,0.842,9,41,50,62,26,4,39,55,294,266,1.59,0.67,2012,13,5.068965517241379,1.5897435897435896,128,3,131,0.3816793893129771
2012-13,RegularSeason,201953,275,Eric Maynor,1610612757,POR,64,963,106,281,0.377,34,96,0.354,45,62,0.726,9,37,46,182,22,1,79,55,291,271,2.3,0.28,2012,13,4.546875,2.3037974683544302,175,17,192,0.23958333333333334
2012-13,RegularSeason,2617,276,Udonis Haslem,1610612748,MIA,75,1414,129,251,0.514,0,0,0.0,32,45,0.711,97,307,404,38,30,15,45,173,290,597,0.84,0.67,2012,13,3.8666666666666667,0.8444444444444444,122,13,135,2.9925925925925925
2012-13,RegularSeason,2588,277,Matt Bonner,1610612759,SAS,68,909,112,230,0.487,53,120,0.442,11,15,0.733,25,104,129,36,17,19,16,86,288,351,2.25,1.06,2012,13,4.235294117647059,2.25,118,4,122,1.0573770491803278
2012-13,RegularSeason,1740,278,Rashard Lewis,1610612748,MIA,55,792,103,249,0.414,51,131,0.389,28,45,0.622,19,102,121,30,21,14,33,67,285,275,0.91,0.64,2012,13,5.181818181818182,0.9090909090909091,146,17,163,0.7423312883435583
2012-13,RegularSeason,2052,279,DeShawn Stevenson,1610612737,ATL,56,1158,98,262,0.374,76,209,0.364,12,23,0.522,18,104,122,52,29,6,23,69,284,295,2.26,1.26,2012,13,5.071428571428571,2.260869565217391,164,11,175,0.6971428571428572
2012-13,RegularSeason,2034,280,Mike Miller,1610612748,MIA,59,900,100,231,0.433,73,175,0.417,8,11,0.727,18,139,157,99,21,4,35,63,281,393,2.83,0.6,2012,13,4.762711864406779,2.8285714285714287,131,3,134,1.171641791044776
2012-13,RegularSeason,201949,281,James Johnson,1610612758,SAC,54,878,117,283,0.413,2,21,0.095,40,67,0.597,49,96,145,58,41,50,68,99,276,309,0.85,0.6,2012,13,5.111111111111111,0.8529411764705882,166,27,193,0.7512953367875648
2012-13,RegularSeason,201986,281,Nando De Colo,1610612759,SAS,72,920,105,241,0.436,31,82,0.378,35,44,0.795,23,115,138,138,41,6,81,87,276,373,1.7,0.51,2012,13,3.8333333333333335,1.7037037037037037,136,9,145,0.9517241379310345
2012-13,RegularSeason,203143,283,Pablo Prigioni,1610612752,NYK,78,1263,100,220,0.455,53,134,0.396,22,25,0.88,41,102,143,236,69,2,86,127,275,516,2.74,0.8,2012,13,3.5256410256410255,2.744186046511628,120,3,123,1.1626016260162602
2012-13,RegularSeason,2229,284,Mike James,1610612742,DAL,45,862,101,271,0.373,48,125,0.384,23,29,0.793,9,63,72,139,26,3,55,95,273,282,2.53,0.47,2012,13,6.066666666666666,2.5272727272727273,170,6,176,0.4090909090909091
2012-13,RegularSeason,201858,285,Cartier Martin,1610612764,WAS,41,694,96,252,0.381,58,146,0.397,20,28,0.714,11,89,100,20,19,6,32,58,270,219,0.63,0.59,2012,13,6.585365853658536,0.625,156,8,164,0.6097560975609756
2012-13,RegularSeason,203096,285,Jared Sullinger,1610612738,BOS,45,892,111,225,0.493,1,5,0.2,47,63,0.746,92,172,264,35,22,22,29,154,270,454,1.21,0.76,2012,13,6.0,1.206896551724138,114,16,130,2.0307692307692307
2012-13,RegularSeason,202951,287,Jeremy Pargo,1610612755,PHI,39,655,99,250,0.396,25,74,0.338,42,62,0.677,8,41,49,92,13,2,50,46,265,200,1.84,0.26,2012,13,6.794871794871795,1.84,151,20,171,0.28654970760233917
2012-13,RegularSeason,2563,288,Dahntay Jones,1610612737,ATL,78,1017,82,222,0.369,11,49,0.224,87,113,0.77,24,77,101,48,22,6,38,119,262,235,1.26,0.58,2012,13,3.358974358974359,1.263157894736842,140,26,166,0.608433734939759
2012-13,RegularSeason,202066,288,Garrett Temple,1610612764,WAS,51,1156,105,258,0.407,26,80,0.325,26,37,0.703,29,94,123,115,50,17,61,94,262,342,1.89,0.82,2012,13,5.137254901960785,1.8852459016393444,153,11,164,0.75
2012-13,RegularSeason,2404,290,Chris Wilcox,1610612738,BOS,61,830,110,153,0.719,0,1,0.0,39,58,0.672,55,125,180,22,32,28,34,125,259,425,0.65,0.94,2012,13,4.245901639344262,0.6470588235294118,43,19,62,2.903225806451613
2012-13,RegularSeason,202344,291,Trevor Booker,1610612764,WAS,48,887,108,220,0.491,0,5,0.0,40,72,0.556,98,141,239,40,32,16,31,95,256,408,1.29,1.03,2012,13,5.333333333333333,1.2903225806451613,112,32,144,1.6597222222222223
2012-13,RegularSeason,201229,292,Anthony Tolliver,1610612737,ATL,62,963,82,216,0.38,45,133,0.338,44,51,0.863,31,124,155,32,15,12,36,66,253,290,0.89,0.42,2012,13,4.080645161290323,0.8888888888888888,134,7,141,1.099290780141844
2012-13,RegularSeason,200789,293,Daniel Gibson,1610612739,CLE,46,919,84,247,0.34,56,163,0.344,26,37,0.703,5,55,60,82,30,4,31,89,250,221,2.65,0.97,2012,13,5.434782608695652,2.6451612903225805,163,11,174,0.3448275862068966
2012-13,RegularSeason,202700,293,Donatas Motiejunas,1610612745,HOU,44,538,97,213,0.455,24,83,0.289,32,51,0.627,36,57,93,31,7,10,37,73,250,219,0.84,0.19,2012,13,5.681818181818182,0.8378378378378378,116,19,135,0.6888888888888889
2012-13,RegularSeason,201948,295,Austin Daye,1610612763,MEM,55,676,90,208,0.433,41,98,0.418,26,34,0.765,16,107,123,42,14,22,29,82,247,293,1.45,0.48,2012,13,4.490909090909091,1.4482758620689655,118,8,126,0.9761904761904762
2012-13,RegularSeason,202337,296,Luke Babbitt,1610612757,POR,62,730,86,234,0.368,62,178,0.348,10,13,0.769,15,122,137,29,14,5,22,82,244,256,1.32,0.64,2012,13,3.935483870967742,1.3181818181818181,148,3,151,0.9072847682119205
2012-13,RegularSeason,202361,297,Landry Fields,1610612761,TOR,51,1037,102,223,0.457,2,14,0.143,34,53,0.642,59,149,208,60,32,8,42,63,240,366,1.43,0.76,2012,13,4.705882352941177,1.4285714285714286,121,19,140,1.4857142857142858
2012-13,RegularSeason,203199,298,DeQuan Jones,1610612753,ORL,63,803,95,218,0.436,9,35,0.257,34,51,0.667,17,88,105,16,19,22,30,55,233,225,0.53,0.63,2012,13,3.6984126984126986,0.5333333333333333,123,17,140,0.75
2012-13,RegularSeason,203124,299,Kyle O'Quinn,1610612753,ORL,57,638,101,197,0.513,0,1,0.0,30,45,0.667,65,144,209,52,11,26,37,107,232,382,1.41,0.3,2012,13,4.0701754385964914,1.4054054054054055,96,15,111,1.882882882882883
2012-13,RegularSeason,202698,300,Chris Singleton,1610612764,WAS,57,924,92,241,0.382,7,36,0.194,40,70,0.571,51,133,184,37,38,24,45,124,231,290,0.82,0.84,2012,13,4.052631578947368,0.8222222222222222,149,30,179,1.0279329608938548
2012-13,RegularSeason,2224,301,Jamaal Tinsley,1610612762,UTA,66,1221,86,234,0.368,39,127,0.307,18,26,0.692,17,98,115,290,64,14,106,106,229,450,2.74,0.6,2012,13,3.4696969696969697,2.7358490566037736,148,8,156,0.7371794871794872
2012-13,RegularSeason,201976,302,Patrick Beverley,1610612745,HOU,41,713,79,189,0.418,36,96,0.375,34,41,0.829,45,64,109,117,37,21,44,83,228,351,2.66,0.84,2012,13,5.560975609756097,2.659090909090909,110,7,117,0.9316239316239316
2012-13,RegularSeason,203110,303,Draymond Green,1610612744,GSW,79,1061,84,257,0.327,14,67,0.209,45,55,0.818,58,202,260,53,42,25,51,159,227,373,1.04,0.82,2012,13,2.8734177215189876,1.0392156862745099,173,10,183,1.4207650273224044
2012-13,RegularSeason,2217,304,Brendan Haywood,1610612766,CHA,61,1162,93,216,0.431,0,1,0.0,30,66,0.455,125,165,290,29,16,49,50,125,216,391,0.58,0.32,2012,13,3.540983606557377,0.58,123,36,159,1.8238993710691824
2012-13,RegularSeason,201978,304,Chase Budinger,1610612750,MIN,23,508,79,191,0.414,26,81,0.321,32,42,0.762,15,56,71,25,14,7,23,29,216,188,1.09,0.61,2012,13,9.391304347826088,1.0869565217391304,112,10,122,0.5819672131147541
2012-13,RegularSeason,2571,306,Leandro Barbosa,1610612738,BOS,41,513,83,193,0.43,18,47,0.383,31,41,0.756,8,38,46,58,17,6,21,51,215,201,2.76,0.81,2012,13,5.2439024390243905,2.761904761904762,110,10,120,0.38333333333333336
2012-13,RegularSeason,202399,307,Jeff Adrien,1610612766,CHA,52,713,72,168,0.429,0,2,0.0,65,100,0.65,68,128,196,36,18,27,32,80,209,323,1.13,0.56,2012,13,4.019230769230769,1.125,96,35,131,1.4961832061068703
2012-13,RegularSeason,202706,308,Jordan Hamilton,1610612743,DEN,40,397,84,201,0.418,27,73,0.37,13,26,0.5,32,63,95,23,15,8,19,24,208,200,1.21,0.79,2012,13,5.2,1.2105263157894737,117,13,130,0.7307692307692307
2012-13,RegularSeason,2365,309,Chris Andersen,1610612748,MIA,42,624,71,123,0.577,2,3,0.667,63,93,0.677,57,115,172,17,16,44,24,89,207,350,0.71,0.67,2012,13,4.928571428571429,0.7083333333333334,52,30,82,2.097560975609756
2012-13,RegularSeason,2457,309,Jannero Pargo,1610612766,CHA,32,507,78,212,0.368,39,116,0.336,12,13,0.923,10,25,35,67,18,3,41,42,207,154,1.63,0.44,2012,13,6.46875,1.6341463414634145,134,1,135,0.25925925925925924
2012-13,RegularSeason,200797,311,Ryan Hollins,1610612746,LAC,60,663,70,114,0.614,0,0,0.0,66,88,0.75,50,89,139,11,6,34,44,133,206,286,0.25,0.14,2012,13,3.433333333333333,0.25,44,22,66,2.106060606060606
2012-13,RegularSeason,202970,312,Gustavo Ayon,1610612749,MIL,55,735,92,167,0.551,0,0,0.0,20,50,0.4,60,139,199,71,22,17,47,107,204,361,1.51,0.47,2012,13,3.709090909090909,1.5106382978723405,75,30,105,1.8952380952380952
2012-13,RegularSeason,203111,313,Orlando Johnson,1610612754,IND,51,619,72,180,0.4,36,94,0.383,23,32,0.719,20,90,110,47,11,9,29,51,203,234,1.62,0.38,2012,13,3.980392156862745,1.6206896551724137,108,9,117,0.9401709401709402
2012-13,RegularSeason,203095,314,Evan Fournier,1610612743,DEN,38,428,75,152,0.493,22,54,0.407,30,39,0.769,6,29,35,44,19,1,32,65,202,183,1.38,0.59,2012,13,5.315789473684211,1.375,77,9,86,0.4069767441860465
2012-13,RegularSeason,2566,315,Travis Outlaw,1610612758,SAC,38,444,74,177,0.418,14,50,0.28,38,52,0.731,17,44,61,21,11,8,19,35,200,165,1.1,0.58,2012,13,5.2631578947368425,1.105263157894737,103,14,117,0.5213675213675214
2012-13,RegularSeason,101236,316,Chuck Hayes,1610612758,SAC,74,1209,84,190,0.442,0,1,0.0,30,48,0.625,113,186,299,112,31,18,44,114,198,490,2.54,0.7,2012,13,2.675675675675676,2.5454545454545454,106,18,124,2.411290322580645
2012-13,RegularSeason,202721,317,Darius Morris,1610612747,LAL,48,683,73,188,0.388,24,66,0.364,24,37,0.649,24,33,57,76,21,2,45,58,194,177,1.69,0.47,2012,13,4.041666666666667,1.6888888888888889,115,13,128,0.4453125
2012-13,RegularSeason,101124,317,Hakim Warrick,1610612766,CHA,28,489,67,165,0.406,0,3,0.0,60,88,0.682,21,68,89,25,13,6,29,37,194,172,0.86,0.45,2012,13,6.928571428571429,0.8620689655172413,98,28,126,0.7063492063492064
2012-13,RegularSeason,201941,317,Jordan Hill,1610612747,LAL,29,458,77,155,0.497,0,2,0.0,40,61,0.656,82,84,166,13,8,19,26,55,194,275,0.5,0.31,2012,13,6.689655172413793,0.5,78,21,99,1.6767676767676767
2012-13,RegularSeason,202333,317,Xavier Henry,1610612740,NOH,50,625,66,161,0.41,4,11,0.364,58,92,0.63,21,69,90,13,16,5,31,72,194,158,0.42,0.52,2012,13,3.88,0.41935483870967744,95,34,129,0.6976744186046512
2012-13,RegularSeason,203105,321,Festus Ezeli,1610612744,GSW,78,1120,74,169,0.438,0,0,0.0,43,81,0.531,141,172,313,22,23,74,63,157,191,427,0.35,0.36,2012,13,2.448717948717949,0.3492063492063492,95,38,133,2.3533834586466167
2012-13,RegularSeason,203141,322,Mirza Teletovic,1610612751,BKN,53,499,71,185,0.384,37,108,0.343,9,11,0.818,33,62,95,23,13,8,20,53,188,191,1.15,0.65,2012,13,3.547169811320755,1.15,114,2,116,0.8189655172413793
2012-13,RegularSeason,201964,323,Victor Claver,1610612757,POR,49,812,74,189,0.392,25,87,0.287,14,30,0.467,31,88,119,43,26,12,43,75,187,213,1.0,0.6,2012,13,3.816326530612245,1.0,115,16,131,0.9083969465648855
2012-13,RegularSeason,101106,324,Andrew Bogut,1610612744,GSW,32,786,83,184,0.451,1,1,1.0,19,38,0.5,68,177,245,67,20,55,35,85,186,418,1.91,0.57,2012,13,5.8125,1.9142857142857144,101,19,120,2.0416666666666665
2012-13,RegularSeason,1497,325,Chauncey Billups,1610612746,LAC,22,418,53,132,0.402,33,90,0.367,45,48,0.938,2,30,32,49,12,1,26,25,184,170,1.89,0.46,2012,13,8.363636363636363,1.8846153846153846,79,3,82,0.3902439024390244
2012-13,RegularSeason,203118,326,Mike Scott,1610612737,ATL,40,376,70,147,0.476,0,1,0.0,43,56,0.768,39,71,110,12,4,2,21,32,183,200,0.57,0.19,2012,13,4.575,0.5714285714285714,77,13,90,1.2222222222222223
2012-13,RegularSeason,711,327,Jerry Stackhouse,1610612751,BKN,37,544,66,172,0.384,30,89,0.337,20,23,0.87,5,28,33,35,7,4,24,31,182,128,1.46,0.29,2012,13,4.918918918918919,1.4583333333333333,106,3,109,0.30275229357798167
2012-13,RegularSeason,101153,328,Mickael Gelabale,1610612750,MIN,36,644,72,139,0.518,16,52,0.308,21,24,0.875,32,67,99,26,16,4,16,47,181,240,1.63,1.0,2012,13,5.027777777777778,1.625,67,3,70,1.4142857142857144
2012-13,RegularSeason,201958,328,Rodrigue Beaubois,1610612742,DAL,45,549,65,176,0.369,21,72,0.292,30,38,0.789,9,48,57,84,19,4,33,54,181,193,2.54,0.58,2012,13,4.022222222222222,2.5454545454545454,111,8,119,0.4789915966386555
2012-13,RegularSeason,200758,330,Ronnie Brewer,1610612760,OKC,60,852,70,198,0.354,23,76,0.303,16,39,0.41,42,98,140,50,43,6,18,33,179,249,2.78,2.39,2012,13,2.9833333333333334,2.7777777777777777,128,23,151,0.9271523178807947
2012-13,RegularSeason,2210,331,Richard Jefferson,1610612744,GSW,56,568,62,136,0.456,14,45,0.311,38,53,0.717,5,79,84,31,14,7,23,45,176,200,1.35,0.61,2012,13,3.142857142857143,1.3478260869565217,74,15,89,0.9438202247191011
2012-13,RegularSeason,965,332,Derek Fisher,1610612760,OKC,33,575,55,161,0.342,30,80,0.375,35,38,0.921,2,35,37,47,19,3,30,55,175,142,1.57,0.63,2012,13,5.303030303030303,1.5666666666666667,106,3,109,0.3394495412844037
2012-13,RegularSeason,203102,333,Arnett Moultrie,1610612755,PHI,47,542,78,134,0.582,0,0,0.0,18,28,0.643,76,69,145,10,17,10,19,43,174,271,0.53,0.9,2012,13,3.702127659574468,0.5263157894736842,56,10,66,2.196969696969697
2012-13,RegularSeason,201956,334,Omri Casspi,1610612739,CLE,43,503,63,160,0.394,25,76,0.329,22,41,0.537,20,94,114,28,25,12,22,45,173,214,1.27,1.14,2012,13,4.023255813953488,1.2727272727272727,97,19,116,0.9827586206896551
2012-13,RegularSeason,2575,335,Luke Walton,1610612739,CLE,50,857,71,181,0.392,20,67,0.299,10,20,0.5,38,107,145,166,42,13,60,98,172,358,2.77,0.7,2012,13,3.44,2.7666666666666666,110,10,120,1.2083333333333333
2012-13,RegularSeason,2767,336,Royal Ivey,1610612755,PHI,53,698,62,144,0.431,37,88,0.42,9,16,0.563,16,41,57,32,23,3,20,73,170,176,1.6,1.15,2012,13,3.207547169811321,1.6,82,7,89,0.6404494382022472
2012-13,RegularSeason,1737,337,Nazr Mohammed,1610612741,CHI,63,693,66,180,0.367,0,2,0.0,34,47,0.723,73,122,195,26,21,32,24,97,166,289,1.08,0.88,2012,13,2.634920634920635,1.0833333333333333,114,13,127,1.5354330708661417
2012-13,RegularSeason,203114,338,Khris Middleton,1610612765,DET,27,475,62,141,0.44,14,45,0.311,27,32,0.844,4,46,50,28,15,4,11,53,165,167,2.54,1.36,2012,13,6.111111111111111,2.5454545454545454,79,5,84,0.5952380952380952
2012-13,RegularSeason,201627,339,Anthony Morrow,1610612742,DAL,41,383,64,145,0.441,16,43,0.372,20,22,0.909,11,19,30,13,13,1,8,43,164,130,1.63,1.63,2012,13,4.0,1.625,81,2,83,0.3614457831325301
2012-13,RegularSeason,201934,340,Hasheem Thabeet,1610612760,OKC,66,770,64,106,0.604,0,0,0.0,32,53,0.604,69,126,195,11,30,60,41,148,160,352,0.27,0.73,2012,13,2.4242424242424243,0.2682926829268293,42,21,63,3.0952380952380953
2012-13,RegularSeason,201970,341,Sam Young,1610612754,IND,56,693,58,148,0.392,16,52,0.308,23,43,0.535,26,97,123,42,15,8,33,62,155,200,1.27,0.46,2012,13,2.767857142857143,1.2727272727272727,90,20,110,1.1181818181818182
2012-13,RegularSeason,203117,342,Doron Lamb,1610612753,ORL,47,578,60,163,0.368,14,37,0.378,20,34,0.588,8,38,46,32,13,0,26,52,154,102,1.23,0.5,2012,13,3.276595744680851,1.2307692307692308,103,14,117,0.39316239316239315
2012-13,RegularSeason,202341,343,James Anderson,1610612745,HOU,39,401,52,126,0.413,21,60,0.35,24,28,0.857,18,54,72,42,15,5,25,25,149,180,1.68,0.6,2012,13,3.8205128205128207,1.68,74,4,78,0.9230769230769231
2012-13,RegularSeason,202498,343,Lance Thomas,1610612740,NOH,59,646,53,106,0.5,0,0,0.0,43,59,0.729,44,71,115,17,11,7,14,78,149,216,1.21,0.79,2012,13,2.5254237288135593,1.2142857142857142,53,16,69,1.6666666666666667
2012-13,RegularSeason,101132,345,Linas Kleiza,1610612761,TOR,20,376,48,144,0.333,20,66,0.303,32,38,0.842,10,42,52,16,4,2,14,45,148,106,1.14,0.29,2012,13,7.4,1.1428571428571428,96,6,102,0.5098039215686274
2012-13,RegularSeason,739,346,Rasheed Wallace,1610612752,NYK,21,296,55,142,0.387,22,69,0.319,14,20,0.7,11,72,83,6,13,15,10,40,146,160,0.6,1.3,2012,13,6.9523809523809526,0.6,87,6,93,0.8924731182795699
2012-13,RegularSeason,202130,346,Reggie Williams,1610612766,CHA,40,380,57,132,0.432,22,72,0.306,10,21,0.476,8,43,51,39,12,1,19,19,146,144,2.05,0.63,2012,13,3.65,2.0526315789473686,75,11,86,0.5930232558139535
2012-13,RegularSeason,201965,348,Jeff Ayres,1610612754,IND,37,369,61,126,0.484,2,4,0.5,21,23,0.913,29,75,104,15,6,12,23,44,145,192,0.65,0.26,2012,13,3.918918918918919,0.6521739130434783,65,2,67,1.5522388059701493
2012-13,RegularSeason,201576,349,Anthony Randolph,1610612743,DEN,39,329,56,114,0.491,0,8,0.0,31,45,0.689,29,66,95,12,19,21,37,41,143,181,0.32,0.51,2012,13,3.6666666666666665,0.32432432432432434,58,14,72,1.3194444444444444
2012-13,RegularSeason,203088,349,Kendall Marshall,1610612756,PHX,48,702,56,151,0.371,23,73,0.315,8,14,0.571,4,38,42,143,22,4,57,48,143,196,2.51,0.39,2012,13,2.9791666666666665,2.508771929824561,95,6,101,0.4158415841584158
2012-13,RegularSeason,202714,349,Shelvin Mack,1610612737,ATL,31,416,58,126,0.46,18,49,0.367,9,16,0.563,3,37,40,68,15,0,34,39,143,157,2.0,0.44,2012,13,4.612903225806452,2.0,68,7,75,0.5333333333333333
2012-13,RegularSeason,201161,352,Daequan Cook,1610612741,CHI,49,441,51,167,0.305,26,91,0.286,9,12,0.75,7,54,61,19,8,7,15,26,137,98,1.27,0.53,2012,13,2.795918367346939,1.2666666666666666,116,3,119,0.5126050420168067
2012-13,RegularSeason,200777,353,Joel Freeland,1610612757,POR,51,477,58,142,0.408,0,0,0.0,18,27,0.667,40,79,119,13,13,11,19,67,134,178,0.68,0.68,2012,13,2.627450980392157,0.6842105263157895,84,9,93,1.2795698924731183
2012-13,RegularSeason,2768,354,Chris Duhon,1610612747,LAL,46,820,47,123,0.382,33,91,0.363,6,13,0.462,11,57,68,133,20,1,40,56,133,232,3.33,0.5,2012,13,2.891304347826087,3.325,76,7,83,0.8192771084337349
2012-13,RegularSeason,203108,355,Bernard James,1610612742,DAL,46,457,53,103,0.515,0,2,0.0,25,41,0.61,52,79,131,6,12,38,18,64,131,234,0.33,0.67,2012,13,2.847826086956522,0.3333333333333333,50,16,66,1.9848484848484849
2012-13,RegularSeason,2030,356,Kenyon Martin,1610612752,NYK,18,431,56,93,0.602,0,0,0.0,17,40,0.425,34,61,95,8,16,17,16,64,129,189,0.5,1.0,2012,13,7.166666666666667,0.5,37,23,60,1.5833333333333333
2012-13,RegularSeason,202709,357,Cory Joseph,1610612759,SAS,28,388,51,110,0.464,6,21,0.286,18,21,0.857,12,40,52,53,15,4,21,25,126,167,2.52,0.71,2012,13,4.5,2.5238095238095237,59,3,62,0.8387096774193549
2012-13,RegularSeason,202686,357,Jan Vesely,1610612764,WAS,51,601,57,114,0.5,0,1,0.0,12,39,0.308,43,79,122,28,15,17,27,107,126,197,1.04,0.56,2012,13,2.4705882352941178,1.037037037037037,57,27,84,1.4523809523809523
2012-13,RegularSeason,200778,359,James White,1610612752,NYK,57,435,50,116,0.431,14,41,0.341,11,19,0.579,5,43,48,29,13,4,17,44,125,128,1.71,0.77,2012,13,2.192982456140351,1.7058823529411764,66,8,74,0.6486486486486487
2012-13,RegularSeason,200748,359,Tyrus Thomas,1610612766,CHA,26,360,48,136,0.353,3,8,0.375,26,31,0.839,16,44,60,19,14,15,17,51,125,123,1.12,0.82,2012,13,4.8076923076923075,1.1176470588235294,88,5,93,0.6451612903225806
2012-13,RegularSeason,202397,361,Ish Smith,1610612749,MIL,52,516,56,159,0.352,8,27,0.296,3,7,0.429,12,49,61,87,21,9,37,26,123,157,2.35,0.57,2012,13,2.3653846153846154,2.3513513513513513,103,4,107,0.5700934579439252
2012-13,RegularSeason,203145,361,Kent Bazemore,1610612744,GSW,61,267,43,116,0.371,10,34,0.294,27,44,0.614,5,17,22,22,17,4,18,27,123,80,1.22,0.94,2012,13,2.0163934426229506,1.2222222222222223,73,17,90,0.24444444444444444
2012-13,RegularSeason,101142,363,Ronny Turiaf,1610612746,LAC,65,701,49,97,0.505,0,0,0.0,23,63,0.365,45,107,152,35,19,35,29,80,121,245,1.21,0.66,2012,13,1.8615384615384616,1.206896551724138,48,40,88,1.7272727272727273
2012-13,RegularSeason,201189,364,Aaron Gray,1610612761,TOR,42,513,48,90,0.533,0,0,0.0,23,44,0.523,48,85,133,33,7,5,36,85,119,198,0.92,0.19,2012,13,2.8333333333333335,0.9166666666666666,42,21,63,2.111111111111111
2012-13,RegularSeason,203119,364,Kim English,1610612765,DET,41,407,42,112,0.375,14,50,0.28,21,29,0.724,8,29,37,26,16,3,19,46,119,104,1.37,0.84,2012,13,2.902439024390244,1.368421052631579,70,8,78,0.47435897435897434
2012-13,RegularSeason,203121,366,Darius Miller,1610612740,NOH,52,694,44,108,0.407,22,56,0.393,8,8,1.0,8,70,78,44,17,12,23,89,118,182,1.91,0.74,2012,13,2.269230769230769,1.9130434782608696,64,0,64,1.21875
2012-13,RegularSeason,202419,367,Chris Johnson,1610612750,MIN,30,284,48,75,0.64,0,0,0.0,21,34,0.618,20,40,60,8,7,28,13,49,117,167,0.61,0.54,2012,13,3.9,0.6153846153846154,27,13,40,1.5
2012-13,RegularSeason,202346,368,Dominique Jones,1610612742,DAL,29,338,40,109,0.367,1,9,0.111,35,53,0.66,18,27,45,83,14,2,38,29,116,135,2.18,0.37,2012,13,4.0,2.1842105263157894,69,18,87,0.5172413793103449
2012-13,RegularSeason,203112,368,Quincy Acy,1610612761,TOR,29,342,42,75,0.56,1,2,0.5,31,38,0.816,30,47,77,11,13,15,17,53,116,175,0.65,0.77,2012,13,4.0,0.6470588235294118,33,7,40,1.925
2012-13,RegularSeason,202724,370,Charles Jenkins,1610612755,PHI,59,441,49,121,0.405,1,2,0.5,12,22,0.545,8,24,32,44,15,2,21,22,111,101,2.1,0.71,2012,13,1.88135593220339,2.0952380952380953,72,10,82,0.3902439024390244
2012-13,RegularSeason,202701,371,Nolan Smith,1610612757,POR,40,288,42,114,0.368,6,28,0.214,20,28,0.714,7,20,27,35,7,1,29,26,110,71,1.21,0.24,2012,13,2.75,1.206896551724138,72,8,80,0.3375
2012-13,RegularSeason,201944,371,Terrence Williams,1610612738,BOS,24,318,48,97,0.495,5,15,0.333,9,21,0.429,4,40,44,38,11,2,22,13,110,122,1.73,0.5,2012,13,4.583333333333333,1.7272727272727273,49,12,61,0.7213114754098361
2012-13,RegularSeason,101130,373,Johan Petro,1610612737,ATL,31,352,48,110,0.436,1,4,0.25,11,12,0.917,33,79,112,16,10,9,24,48,108,168,0.67,0.42,2012,13,3.4838709677419355,0.6666666666666666,62,1,63,1.7777777777777777
2012-13,RegularSeason,202389,373,Timofey Mozgov,1610612743,DEN,41,366,44,87,0.506,0,2,0.0,20,26,0.769,50,57,107,9,6,18,25,57,108,174,0.36,0.24,2012,13,2.6341463414634148,0.36,43,6,49,2.183673469387755
2012-13,RegularSeason,101179,375,Ronnie Price,1610612757,POR,39,510,39,120,0.325,10,39,0.256,17,24,0.708,13,31,44,73,26,3,34,61,105,129,2.15,0.77,2012,13,2.6923076923076925,2.1470588235294117,81,7,88,0.5
2012-13,RegularSeason,203093,376,Terrence Jones,1610612745,HOU,19,276,43,94,0.457,5,19,0.263,13,17,0.765,28,37,65,15,12,19,13,21,104,147,1.15,0.92,2012,13,5.473684210526316,1.1538461538461537,51,4,55,1.1818181818181819
2012-13,RegularSeason,2562,377,Sasha Pavlovic,1610612757,POR,39,528,42,119,0.353,18,60,0.3,1,6,0.167,7,49,56,32,24,5,14,59,103,124,2.29,1.71,2012,13,2.641025641025641,2.2857142857142856,77,5,82,0.6829268292682927
2012-13,RegularSeason,202332,378,Cole Aldrich,1610612758,SAC,45,388,44,80,0.55,0,0,0.0,12,20,0.6,30,90,120,9,5,23,23,60,100,190,0.39,0.22,2012,13,2.2222222222222223,0.391304347826087,36,8,44,2.727272727272727
2012-13,RegularSeason,2554,378,Mickael Pietrus,1610612761,TOR,19,386,34,98,0.347,20,64,0.313,12,18,0.667,5,31,36,9,12,6,16,33,100,77,0.56,0.75,2012,13,5.2631578947368425,0.5625,64,6,70,0.5142857142857142
2012-13,RegularSeason,203104,380,Marquis Teague,1610612741,CHI,48,392,43,113,0.381,4,23,0.174,9,16,0.563,3,41,44,63,9,7,35,47,99,110,1.8,0.26,2012,13,2.0625,1.8,70,7,77,0.5714285714285714
2012-13,RegularSeason,703,381,Kurt Thomas,1610612752,NYK,39,392,45,83,0.542,1,1,1.0,6,13,0.462,24,65,89,21,10,16,8,52,97,180,2.63,1.25,2012,13,2.4871794871794872,2.625,38,7,45,1.9777777777777779
2012-13,RegularSeason,2248,382,Earl Watson,1610612762,UTA,48,829,37,120,0.308,5,28,0.179,17,25,0.68,23,64,87,190,40,8,69,94,96,261,2.75,0.58,2012,13,2.0,2.753623188405797,83,8,91,0.9560439560439561
2012-13,RegularSeason,1894,383,Corey Maggette,1610612765,DET,18,257,27,76,0.355,5,21,0.238,36,48,0.75,5,20,25,19,6,2,17,42,95,69,1.12,0.35,2012,13,5.277777777777778,1.1176470588235294,49,12,61,0.4098360655737705
2012-13,RegularSeason,203158,383,Kevin Jones,1610612739,CLE,32,334,43,107,0.402,0,0,0.0,9,15,0.6,38,40,78,10,9,5,8,25,95,119,1.25,1.13,2012,13,2.96875,1.25,64,6,70,1.1142857142857143
2012-13,RegularSeason,255,385,Grant Hill,1610612746,LAC,29,437,38,98,0.388,3,11,0.273,14,24,0.583,6,43,49,26,11,7,25,39,93,91,1.04,0.44,2012,13,3.206896551724138,1.04,60,10,70,0.7
2012-13,RegularSeason,203100,386,Tony Wroten,1610612763,MEM,35,272,33,86,0.384,4,16,0.25,21,29,0.724,13,15,28,43,8,4,29,34,91,84,1.48,0.28,2012,13,2.6,1.4827586206896552,53,8,61,0.45901639344262296
2012-13,RegularSeason,203103,387,Perry Jones III,1610612760,OKC,38,280,39,99,0.394,0,2,0.0,10,15,0.667,12,50,62,10,5,6,15,23,88,91,0.67,0.33,2012,13,2.3157894736842106,0.6666666666666666,60,5,65,0.9538461538461539
2012-13,RegularSeason,201202,388,Joel Anthony,1610612748,MIA,62,566,35,68,0.515,0,0,0.0,17,28,0.607,45,70,115,13,13,42,22,49,87,204,0.59,0.59,2012,13,1.403225806451613,0.5909090909090909,33,11,44,2.6136363636363638
2012-13,RegularSeason,203116,389,Tyshawn Taylor,1610612751,BKN,38,221,32,87,0.368,6,13,0.462,15,27,0.556,2,16,18,21,13,0,25,25,85,45,0.84,0.52,2012,13,2.236842105263158,0.84,55,12,67,0.26865671641791045
2012-13,RegularSeason,201632,390,Hamed Haddadi,1610612756,PHX,30,322,35,82,0.427,0,0,0.0,14,27,0.519,43,68,111,12,6,27,31,60,84,149,0.39,0.19,2012,13,2.8,0.3870967741935484,47,13,60,1.85
2012-13,RegularSeason,202388,391,Donald Sloan,1610612740,NOH,23,263,27,78,0.346,7,19,0.368,20,25,0.8,3,25,28,38,5,0,14,17,81,82,2.71,0.36,2012,13,3.5217391304347827,2.7142857142857144,51,5,56,0.5
2012-13,RegularSeason,202723,392,Malcolm Lee,1610612750,MIN,16,289,29,76,0.382,8,24,0.333,12,20,0.6,15,24,39,20,12,6,10,30,78,90,2.0,1.2,2012,13,4.875,2.0,47,8,55,0.7090909090909091
2012-13,RegularSeason,203139,393,Viacheslav Kravtsov,1610612765,DET,25,224,33,46,0.717,0,0,0.0,11,37,0.297,24,21,45,9,5,9,14,32,77,92,0.64,0.36,2012,13,3.08,0.6428571428571429,13,26,39,1.1538461538461537
2012-13,RegularSeason,200811,394,Lou Amundson,1610612740,NOH,39,371,32,81,0.395,0,0,0.0,12,36,0.333,48,58,106,11,16,12,19,53,76,129,0.58,0.84,2012,13,1.9487179487179487,0.5789473684210527,49,24,73,1.452054794520548
2012-13,RegularSeason,203146,394,Maalik Wayns,1610612746,LAC,27,202,26,88,0.295,7,31,0.226,17,19,0.895,1,6,7,27,6,0,15,26,76,37,1.8,0.4,2012,13,2.814814814814815,1.8,62,2,64,0.109375
2012-13,RegularSeason,202379,396,Jeremy Evans,1610612762,UTA,37,215,27,44,0.614,0,1,0.0,21,33,0.636,26,32,58,11,8,13,8,30,75,128,1.38,1.0,2012,13,2.027027027027027,1.375,17,12,29,2.0
2012-13,RegularSeason,2572,397,Josh Howard,1610612750,MIN,11,207,31,77,0.403,5,16,0.313,7,12,0.583,9,27,36,4,10,3,10,18,74,66,0.4,1.0,2012,13,6.7272727272727275,0.4,46,5,51,0.7058823529411765
2012-13,RegularSeason,203087,398,Jeremy Lamb,1610612760,OKC,23,147,24,68,0.353,9,30,0.3,14,14,1.0,5,13,18,5,2,2,6,13,71,48,0.83,0.33,2012,13,3.0869565217391304,0.8333333333333334,44,0,44,0.4090909090909091
2012-13,RegularSeason,101183,399,Shavlik Randolph,1610612738,BOS,16,198,28,48,0.583,0,0,0.0,11,27,0.407,28,42,70,4,8,7,10,38,67,110,0.4,0.8,2012,13,4.1875,0.4,20,16,36,1.9444444444444444
2012-13,RegularSeason,202365,400,Devin Ebanks,1610612747,LAL,19,197,24,73,0.329,6,22,0.273,11,14,0.786,10,31,41,10,3,1,11,23,65,57,0.91,0.27,2012,13,3.4210526315789473,0.9090909090909091,49,3,52,0.7884615384615384
2012-13,RegularSeason,2211,400,Troy Murphy,1610612742,DAL,14,256,22,61,0.361,11,35,0.314,10,11,0.909,7,42,49,7,10,6,7,29,65,90,1.0,1.43,2012,13,4.642857142857143,1.0,39,1,40,1.225
2012-13,RegularSeason,2592,402,James Jones,1610612748,MIA,38,221,21,61,0.344,16,53,0.302,2,4,0.5,0,22,22,13,2,6,3,16,60,58,4.33,0.67,2012,13,1.5789473684210527,4.333333333333333,40,2,42,0.5238095238095238
2012-13,RegularSeason,202732,403,DeAndre Liggins,1610612760,OKC,39,290,21,47,0.447,7,19,0.368,9,18,0.5,13,40,53,15,18,3,14,33,58,98,1.07,1.29,2012,13,1.4871794871794872,1.0714285714285714,26,9,35,1.5142857142857142
2012-13,RegularSeason,202396,403,Samardo Samuels,1610612739,CLE,18,196,22,60,0.367,0,1,0.0,14,24,0.583,10,18,28,8,3,3,6,30,58,46,1.33,0.5,2012,13,3.2222222222222223,1.3333333333333333,38,10,48,0.5833333333333334
2012-13,RegularSeason,203162,405,Ben Hansbrough,1610612754,IND,28,200,15,45,0.333,6,23,0.261,21,27,0.778,2,16,18,21,7,2,18,23,57,51,1.17,0.39,2012,13,2.0357142857142856,1.1666666666666667,30,6,36,0.5
2012-13,RegularSeason,202720,406,Jon Leuer,1610612763,MEM,28,187,25,52,0.481,0,3,0.0,6,13,0.462,13,24,37,8,6,0,8,21,56,65,1.0,0.75,2012,13,2.0,1.0,27,7,34,1.088235294117647
2012-13,RegularSeason,2400,407,Drew Gooden,1610612749,MIL,16,151,20,61,0.328,1,5,0.2,11,16,0.688,13,18,31,6,5,6,9,21,52,45,0.67,0.56,2012,13,3.25,0.6666666666666666,41,5,46,0.6739130434782609
2012-13,RegularSeason,1733,408,Al Harrington,1610612753,ORL,10,119,20,57,0.351,8,30,0.267,3,4,0.75,6,21,27,10,4,1,7,18,51,48,1.43,0.57,2012,13,5.1,1.4285714285714286,37,1,38,0.7105263157894737
2012-13,RegularSeason,201187,408,Dominic McGuire,1610612754,IND,26,387,24,56,0.429,0,0,0.0,3,10,0.3,19,59,78,20,13,11,12,39,51,122,1.67,1.08,2012,13,1.9615384615384615,1.6666666666666667,32,7,39,2.0
2012-13,RegularSeason,2407,410,Jared Jeffries,1610612757,POR,38,350,16,54,0.296,0,2,0.0,12,23,0.522,26,34,60,14,6,6,17,58,44,64,0.82,0.35,2012,13,1.1578947368421053,0.8235294117647058,38,11,49,1.2244897959183674
2012-13,RegularSeason,203382,411,Aron Baynes,1610612759,SAS,16,141,18,36,0.5,0,1,0.0,7,12,0.583,12,20,32,5,1,6,11,23,43,53,0.46,0.09,2012,13,2.6875,0.45454545454545453,18,5,23,1.391304347826087
2012-13,RegularSeason,203135,411,Robert Sacre,1610612747,LAL,32,203,18,48,0.375,0,0,0.0,7,11,0.636,9,25,34,6,0,10,10,38,43,49,0.6,0.0,2012,13,1.34375,0.6,30,4,34,1.0
2012-13,RegularSeason,203200,413,Justin Holiday,1610612755,PHI,9,142,16,48,0.333,4,16,0.25,6,8,0.75,0,14,14,15,3,6,9,7,42,37,1.67,0.33,2012,13,4.666666666666667,1.6666666666666667,32,2,34,0.4117647058823529
2012-13,RegularSeason,948,413,Marcus Camby,1610612752,NYK,24,250,17,53,0.321,0,0,0.0,8,19,0.421,24,56,80,14,7,14,15,28,42,95,0.93,0.47,2012,13,1.75,0.9333333333333333,36,11,47,1.702127659574468
2012-13,RegularSeason,2215,415,Jason Collins,1610612764,WAS,38,385,9,29,0.31,0,0,0.0,23,32,0.719,22,38,60,8,12,10,18,85,41,84,0.44,0.67,2012,13,1.0789473684210527,0.4444444444444444,20,9,29,2.0689655172413794
2012-13,RegularSeason,2198,415,Kwame Brown,1610612755,PHI,22,269,17,37,0.459,0,0,0.0,7,19,0.368,23,51,74,9,6,10,8,37,41,100,1.13,0.75,2012,13,1.8636363636363635,1.125,20,12,32,2.3125
2012-13,RegularSeason,203197,417,Diante Garrett,1610612756,PHX,19,149,16,49,0.327,3,15,0.2,5,10,0.5,5,10,15,31,10,0,16,5,40,42,1.94,0.63,2012,13,2.1052631578947367,1.9375,33,5,38,0.39473684210526316
2012-13,RegularSeason,2853,418,Earl Barron,1610612752,NYK,12,158,18,51,0.353,0,0,0.0,3,7,0.429,22,39,61,5,5,6,11,24,39,68,0.46,0.46,2012,13,3.25,0.45454545454545453,33,4,37,1.6486486486486487
2012-13,RegularSeason,202350,419,Daniel Orton,1610612760,OKC,13,104,12,26,0.462,0,0,0.0,9,17,0.529,13,13,26,4,4,3,4,13,33,44,1.0,1.0,2012,13,2.5384615384615383,1.0,14,8,22,1.1818181818181819
2012-13,RegularSeason,2209,419,Vladimir Radmanovic,1610612741,CHI,25,144,13,43,0.302,5,27,0.185,2,3,0.667,10,18,28,8,8,4,7,29,33,43,1.14,1.14,2012,13,1.32,1.1428571428571428,30,1,31,0.9032258064516129
2012-13,RegularSeason,2045,421,Hedo Turkoglu,1610612753,ORL,11,189,14,53,0.264,1,24,0.042,3,6,0.5,4,22,26,23,7,1,12,11,32,35,1.92,0.58,2012,13,2.909090909090909,1.9166666666666667,39,3,42,0.6190476190476191
2012-13,RegularSeason,2039,422,Keyon Dooling,1610612763,MEM,7,82,10,21,0.476,5,12,0.417,6,7,0.857,0,1,1,8,1,0,5,8,31,24,1.6,0.2,2012,13,4.428571428571429,1.6,11,1,12,0.08333333333333333
2012-13,RegularSeason,203129,423,Tornike Shengelia,1610612751,BKN,19,93,10,23,0.435,1,2,0.5,9,16,0.563,9,14,23,3,3,1,11,11,30,29,0.27,0.27,2012,13,1.5789473684210527,0.2727272727272727,13,7,20,1.15
2012-13,RegularSeason,200750,424,Brandon Roy,1610612750,MIN,5,122,11,35,0.314,0,9,0.0,7,10,0.7,3,11,14,23,3,0,7,5,29,35,3.29,0.43,2012,13,5.8,3.2857142857142856,24,3,27,0.5185185185185185
2012-13,RegularSeason,203187,424,Chris Johnson,1610612763,MEM,8,102,11,25,0.44,6,18,0.333,1,2,0.5,5,6,11,2,4,0,3,5,29,28,0.67,1.33,2012,13,3.625,0.6666666666666666,14,1,15,0.7333333333333333
2012-13,RegularSeason,201591,424,DJ White,1610612738,BOS,12,86,12,23,0.522,0,0,0.0,5,9,0.556,4,9,13,4,1,6,2,5,29,36,2.0,0.5,2012,13,2.4166666666666665,2.0,11,4,15,0.8666666666666667
2012-13,RegularSeason,101122,427,Danny Granger,1610612754,IND,5,74,10,35,0.286,2,10,0.2,5,8,0.625,3,6,9,3,2,1,4,6,27,10,0.75,0.5,2012,13,5.4,0.75,25,3,28,0.32142857142857145
2012-13,RegularSeason,2740,428,Andris Biedrins,1610612744,GSW,53,495,10,21,0.476,0,0,0.0,4,13,0.308,34,119,153,14,15,42,14,101,24,214,1.0,1.07,2012,13,0.4528301886792453,1.0,11,9,20,7.65
2012-13,RegularSeason,202719,429,Jeremy Tyler,1610612737,ATL,21,68,9,24,0.375,0,0,0.0,4,6,0.667,6,14,20,1,1,2,6,10,22,23,0.17,0.17,2012,13,1.0476190476190477,0.16666666666666666,15,2,17,1.1764705882352942
2012-13,RegularSeason,436,430,Juwan Howard,1610612748,MIA,7,51,10,19,0.526,0,0,0.0,1,1,1.0,0,8,8,6,0,0,4,9,21,22,1.5,0.0,2012,13,3.0,1.5,9,0,9,0.8888888888888888
2012-13,RegularSeason,202729,431,Josh Selby,1610612763,MEM,10,59,6,22,0.273,1,6,0.167,7,11,0.636,0,5,5,4,2,0,7,7,20,4,0.57,0.29,2012,13,2.0,0.5714285714285714,16,4,20,0.25
2012-13,RegularSeason,202545,432,Luke Zeller,1610612756,PHX,16,58,9,26,0.346,1,5,0.2,0,0,0.0,1,9,10,3,0,0,0,5,19,15,0.0,0.0,2012,13,1.1875,inf,17,0,17,0.5882352941176471
2012-13,RegularSeason,201604,433,Chris Douglas-Roberts,1610612742,DAL,6,63,5,14,0.357,0,4,0.0,7,10,0.7,0,5,5,4,2,0,1,4,17,15,4.0,2.0,2012,13,2.8333333333333335,4.0,9,3,12,0.4166666666666667
2012-13,RegularSeason,2205,434,DeSagana Diop,1610612766,CHA,22,226,8,27,0.296,0,1,0.0,0,1,0.0,10,41,51,13,5,16,8,19,16,73,1.63,0.63,2012,13,0.7272727272727273,1.625,19,1,20,2.55
2012-13,RegularSeason,203099,434,Jared Cunningham,1610612742,DAL,8,26,6,14,0.429,2,3,0.667,2,2,1.0,1,2,3,1,1,0,2,3,16,11,0.5,0.5,2012,13,2.0,0.5,8,0,8,0.375
2012-13,RegularSeason,203122,436,Kevin Murphy,1610612762,UTA,17,52,7,28,0.25,1,5,0.2,0,0,0.0,0,4,4,2,1,0,3,4,15,-2,0.67,0.33,2012,13,0.8823529411764706,0.6666666666666666,21,0,21,0.19047619047619047
2012-13,RegularSeason,202952,436,Malcolm Thomas,1610612741,CHI,12,57,5,10,0.5,0,0,0.0,5,8,0.625,5,11,16,4,2,2,3,8,15,28,1.33,0.67,2012,13,1.25,1.3333333333333333,5,3,8,2.0
2012-13,RegularSeason,202227,436,Terrel Harris,1610612740,NOH,20,137,4,27,0.148,0,8,0.0,7,10,0.7,4,22,26,9,2,3,17,17,15,12,0.53,0.12,2012,13,0.75,0.5294117647058824,23,3,26,1.0
2012-13,RegularSeason,201575,439,Brandon Rush,1610612744,GSW,2,25,6,9,0.667,0,2,0.0,2,3,0.667,0,1,1,2,0,0,3,5,14,10,0.67,0.0,2012,13,7.0,0.6666666666666666,3,1,4,0.25
2012-13,RegularSeason,202809,439,Cory Higgins,1610612766,CHA,6,32,6,19,0.316,1,5,0.2,1,2,0.5,1,2,3,5,3,0,0,5,14,11,0.0,0.0,2012,13,2.3333333333333335,inf,13,1,14,0.21428571428571427
2012-13,RegularSeason,2735,439,Josh Childress,1610612751,BKN,14,100,6,21,0.286,1,3,0.333,1,2,0.5,6,9,15,5,2,2,0,3,14,22,0.0,0.0,2012,13,1.0,inf,15,1,16,0.9375
2012-13,RegularSeason,203101,442,Miles Plumlee,1610612754,IND,14,55,5,21,0.238,0,0,0.0,3,4,0.75,12,10,22,2,0,3,3,5,13,20,0.67,0.0,2012,13,0.9285714285714286,0.6666666666666666,16,1,17,1.2941176470588236
2012-13,RegularSeason,200809,443,Chris Quinn,1610612739,CLE,7,78,4,16,0.25,0,5,0.0,2,2,1.0,1,1,2,9,3,0,6,4,10,6,1.5,0.5,2012,13,1.4285714285714286,1.5,12,0,12,0.16666666666666666
2012-13,RegularSeason,202725,443,Josh Harrellson,1610612748,MIA,6,31,4,9,0.444,1,5,0.2,1,2,0.5,3,4,7,0,1,1,3,4,10,10,0.0,0.33,2012,13,1.6666666666666667,0.0,5,1,6,1.1666666666666667
2012-13,RegularSeason,202351,443,Lazar Hayward,1610612750,MIN,4,31,2,10,0.2,0,4,0.0,6,6,1.0,0,4,4,3,2,0,0,3,10,11,0.0,0.0,2012,13,2.5,inf,8,0,8,0.5
2012-13,RegularSeason,2201,446,Eddy Curry,1610612742,DAL,2,25,4,8,0.5,0,0,0.0,1,4,0.25,2,2,4,0,0,0,3,7,9,3,0.0,0.0,2012,13,4.5,0.0,4,3,7,0.5714285714285714
2012-13,RegularSeason,203126,446,Kris Joseph,1610612751,BKN,10,54,2,14,0.143,0,3,0.0,5,8,0.625,1,6,7,1,3,0,2,3,9,3,0.5,1.5,2012,13,0.9,0.5,12,3,15,0.4666666666666667
2012-13,RegularSeason,203113,446,Quincy Miller,1610612743,DEN,7,26,4,12,0.333,0,1,0.0,1,2,0.5,1,1,2,3,1,0,1,3,9,5,3.0,1.0,2012,13,1.2857142857142858,3.0,8,1,9,0.2222222222222222
2012-13,RegularSeason,202354,449,Dexter Pittman,1610612763,MEM,11,32,4,11,0.364,0,0,0.0,0,3,0.0,7,5,12,0,0,0,3,8,8,7,0.0,0.0,2012,13,0.7272727272727273,0.0,7,3,10,1.2
2012-13,RegularSeason,202363,449,Jarvis Varnado,1610612748,MIA,13,58,3,7,0.429,0,0,0.0,2,4,0.5,2,7,9,3,1,2,6,10,8,11,0.5,0.17,2012,13,0.6153846153846154,0.5,4,2,6,1.5
2012-13,RegularSeason,203159,449,Scott Machado,1610612744,GSW,6,21,3,6,0.5,0,1,0.0,2,2,1.0,0,1,1,6,2,0,8,0,8,6,0.75,0.25,2012,13,1.3333333333333333,0.75,3,0,3,0.3333333333333333
2012-13,RegularSeason,202715,449,Tyler Honeycutt,1610612758,SAC,9,32,3,11,0.273,0,2,0.0,2,2,1.0,3,7,10,2,0,1,5,2,8,8,0.4,0.0,2012,13,0.8888888888888888,0.4,8,0,8,1.25
2012-13,RegularSeason,203097,453,Fab Melo,1610612738,BOS,6,36,3,6,0.5,0,0,0.0,1,4,0.25,0,3,3,0,2,2,1,7,7,7,0.0,2.0,2012,13,1.1666666666666667,0.0,3,3,6,0.5
2012-13,RegularSeason,202933,453,Julyan Stone,1610612743,DEN,4,28,2,2,1.0,0,0,0.0,3,4,0.75,2,1,3,2,1,0,2,4,7,10,1.0,0.5,2012,13,1.75,1.0,0,1,1,3.0
2012-13,RegularSeason,203006,455,Josh Akognon,1610612742,DAL,3,9,2,4,0.5,1,2,0.5,0,0,0.0,0,1,1,1,0,0,0,3,5,5,0.0,0.0,2012,13,1.6666666666666667,inf,2,0,2,0.5
2012-13,RegularSeason,2047,455,Quentin Richardson,1610612752,NYK,1,29,1,11,0.091,1,4,0.25,2,2,1.0,5,5,10,1,0,0,2,1,5,4,0.5,0.0,2012,13,5.0,0.5,10,0,10,1.0
2012-13,RegularSeason,203156,457,Henry Sims,1610612740,NOH,2,5,2,3,0.667,0,0,0.0,0,0,0.0,2,0,2,0,0,0,1,1,4,4,0.0,0.0,2012,13,2.0,0.0,1,0,1,2.0
2012-13,RegularSeason,203317,458,Tim Ohlbrecht,1610612745,HOU,3,12,1,3,0.333,0,0,0.0,1,1,1.0,0,1,1,1,1,0,4,1,3,0,0.25,0.25,2012,13,1.0,0.25,2,0,2,0.5
2012-13,RegularSeason,203203,459,Chris Wright,1610612742,DAL,3,4,1,2,0.5,0,0,0.0,0,0,0.0,0,0,0,0,0,0,1,0,2,0,0.0,0.0,2012,13,0.6666666666666666,0.0,1,0,1,0.0
2012-13,RegularSeason,201969,459,DaJuan Summers,1610612746,LAC,2,7,1,4,0.25,0,0,0.0,0,0,0.0,0,2,2,1,0,0,0,0,2,2,0.0,0.0,2012,13,1.0,inf,3,0,3,0.6666666666666666
2012-13,RegularSeason,2038,459,Joel Przybilla,1610612749,MIL,12,68,1,4,0.25,0,0,0.0,0,2,0.0,5,16,21,4,1,2,4,10,2,21,1.0,0.25,2012,13,0.16666666666666666,1.0,3,2,5,4.2
2012-13,RegularSeason,101215,462,Will Conroy,1610612750,MIN,4,20,0,9,0.0,0,3,0.0,1,2,0.5,1,0,1,0,0,0,0,1,1,-8,0.0,0.0,2012,13,0.25,,9,1,10,0.1
2012-13,RegularSeason,202726,463,Andrew Goudelock,1610612747,LAL,1,6,0,2,0.0,0,0,0.0,0,0,0.0,1,0,1,0,0,0,0,0,0,-1,0.0,0.0,2012,13,0.0,,2,0,2,0.5
2012-13,RegularSeason,203130,463,Darius Johnson-Odom,1610612747,LAL,4,6,0,4,0.0,0,1,0.0,0,0,0.0,1,3,4,1,0,0,0,0,0,1,0.0,0.0,2012,13,0.0,inf,4,0,4,1.0
2012-13,RegularSeason,2545,463,Darko Milicic,1610612738,BOS,1,5,0,1,0.0,0,0,0.0,0,0,0.0,0,1,1,0,0,0,2,1,0,-2,0.0,0.0,2012,13,0.0,0.0,1,0,1,1.0
2012-13,RegularSeason,202458,463,Justin Dentmon,1610612742,DAL,2,4,0,2,0.0,0,0,0.0,0,0,0.0,0,0,0,0,0,0,0,0,0,-2,0.0,0.0,2012,13,0.0,,2,0,2,0.0
2012-13,RegularSeason,2679,463,Matt Carroll,1610612766,CHA,1,6,0,0,0.0,0,0,0.0,0,0,0.0,0,0,0,1,0,0,0,1,0,1,0.0,0.0,2012,13,0.0,inf,0,0,0,
2012-13,RegularSeason,200780,463,Solomon Jones,1610612752,NYK,2,26,0,1,0.0,0,0,0.0,0,0,0.0,1,2,3,0,0,1,3,3,0,0,0.0,0.0,2012,13,0.0,0.0,1,0,1,3.0
2012-13,Playoffs,2544,1,LeBron James,1610612748,MIA,23,960,212,432,0.491,36,96,0.375,136,175,0.777,37,156,193,152,41,18,70,43,596,671,2.17,0.59,2012,13,25.91304347826087,2.1714285714285713,220,39,259,0.7451737451737451
2012-13,Playoffs,2225,2,Tony Parker,1610612759,SAS,21,765,167,365,0.458,11,31,0.355,87,112,0.777,14,54,68,146,24,3,53,26,432,397,2.75,0.45,2012,13,20.571428571428573,2.7547169811320753,198,25,223,0.30493273542600896
2012-13,Playoffs,1495,3,Tim Duncan,1610612759,SAS,21,735,151,321,0.47,0,1,0.0,79,98,0.806,54,160,214,40,18,34,42,53,381,456,0.95,0.43,2012,13,18.142857142857142,0.9523809523809523,170,19,189,1.1322751322751323
2012-13,Playoffs,202331,4,Paul George,1610612754,IND,19,780,119,277,0.43,34,104,0.327,93,128,0.727,16,125,141,96,25,9,75,72,365,368,1.28,0.33,2012,13,19.210526315789473,1.28,158,35,193,0.7305699481865285
2012-13,Playoffs,2548,5,Dwyane Wade,1610612748,MIA,22,782,144,315,0.457,1,4,0.25,60,80,0.75,38,64,102,105,38,23,58,45,349,368,1.81,0.66,2012,13,15.863636363636363,1.8103448275862069,171,20,191,0.5340314136125655
2012-13,Playoffs,2546,6,Carmelo Anthony,1610612752,NYK,12,481,126,310,0.406,17,57,0.298,77,87,0.885,11,68,79,19,13,2,31,46,346,234,0.61,0.42,2012,13,28.833333333333332,0.6129032258064516,184,10,194,0.4072164948453608
2012-13,Playoffs,201142,7,Kevin Durant,1610612760,OKC,11,485,112,246,0.455,22,70,0.314,93,112,0.83,7,92,99,69,14,12,43,26,339,337,1.6,0.33,2012,13,30.818181818181817,1.6046511627906976,134,19,153,0.6470588235294118
2012-13,Playoffs,201579,8,Roy Hibbert,1610612754,IND,19,694,120,235,0.511,0,0,0.0,83,103,0.806,90,98,188,26,3,37,43,74,323,399,0.6,0.07,2012,13,17.0,0.6046511627906976,115,20,135,1.3925925925925926
2012-13,Playoffs,2561,9,David West,1610612754,IND,19,689,115,249,0.462,0,3,0.0,72,94,0.766,41,103,144,39,13,15,45,54,302,312,0.87,0.29,2012,13,15.894736842105264,0.8666666666666667,134,22,156,0.9230769230769231
2012-13,Playoffs,202695,10,Kawhi Leonard,1610612759,SAS,21,775,115,211,0.545,23,59,0.39,31,49,0.633,50,140,190,22,37,11,23,40,284,407,0.96,1.61,2012,13,13.523809523809524,0.9565217391304348,96,18,114,1.6666666666666667
2012-13,Playoffs,201939,11,Stephen Curry,1610612744,GSW,12,497,102,235,0.434,42,106,0.396,35,38,0.921,5,41,46,97,20,2,40,35,281,270,2.42,0.5,2012,13,23.416666666666668,2.425,133,3,136,0.3382352941176471
2012-13,Playoffs,2547,12,Chris Bosh,1610612748,MIA,23,751,110,240,0.458,15,37,0.405,44,60,0.733,38,129,167,34,23,36,27,67,279,366,1.26,0.85,2012,13,12.130434782608695,1.2592592592592593,130,16,146,1.143835616438356
2012-13,Playoffs,201588,13,George Hill,1610612754,IND,18,685,83,207,0.401,34,95,0.358,63,76,0.829,5,62,67,77,22,4,40,41,263,256,1.93,0.55,2012,13,14.61111111111111,1.925,124,13,137,0.48905109489051096
2012-13,Playoffs,2216,14,Zach Randolph,1610612763,MEM,15,554,99,215,0.46,0,1,0.0,63,94,0.67,59,91,150,24,10,7,31,52,261,274,0.77,0.32,2012,13,17.4,0.7741935483870968,116,31,147,1.0204081632653061
2012-13,Playoffs,201188,15,Marc Gasol,1610612763,MEM,15,609,93,205,0.454,0,0,0.0,72,90,0.8,25,102,127,48,13,33,18,53,258,331,2.67,0.72,2012,13,17.2,2.6666666666666665,112,18,130,0.9769230769230769
2012-13,Playoffs,201144,16,Mike Conley,1610612763,MEM,15,575,83,216,0.384,18,64,0.281,71,93,0.763,12,59,71,107,26,5,34,34,255,275,3.15,0.77,2012,13,17.0,3.1470588235294117,133,22,155,0.45806451612903226
2012-13,Playoffs,1938,17,Manu Ginobili,1610612759,SAS,21,560,77,193,0.399,29,96,0.302,59,80,0.738,9,69,78,105,24,6,55,52,242,263,1.91,0.44,2012,13,11.523809523809524,1.9090909090909092,116,21,137,0.5693430656934306
2012-13,Playoffs,951,18,Ray Allen,1610612748,MIA,23,573,74,172,0.43,39,96,0.406,47,54,0.87,13,51,64,29,12,3,27,42,234,210,1.07,0.44,2012,13,10.173913043478262,1.0740740740740742,98,7,105,0.6095238095238096
2012-13,Playoffs,201980,19,Danny Green,1610612759,SAS,21,669,83,186,0.446,55,114,0.482,12,15,0.8,18,69,87,32,22,23,19,51,233,272,1.68,1.16,2012,13,11.095238095238095,1.6842105263157894,103,3,106,0.8207547169811321
2012-13,Playoffs,201596,20,Mario Chalmers,1610612748,MIA,23,650,76,183,0.415,24,68,0.353,40,53,0.755,10,43,53,71,21,1,38,70,216,204,1.87,0.55,2012,13,9.391304347826088,1.868421052631579,107,13,120,0.44166666666666665
2012-13,Playoffs,101127,21,Jarrett Jack,1610612744,GSW,12,426,78,154,0.506,7,24,0.292,43,48,0.896,7,46,53,56,11,4,38,26,206,211,1.47,0.29,2012,13,17.166666666666668,1.4736842105263157,76,5,81,0.654320987654321
2012-13,Playoffs,2430,22,Carlos Boozer,1610612741,CHI,12,431,83,168,0.494,0,1,0.0,31,45,0.689,35,80,115,18,10,1,29,36,197,213,0.62,0.34,2012,13,16.416666666666668,0.6206896551724138,85,14,99,1.1616161616161615
2012-13,Playoffs,101126,23,Nate Robinson,1610612741,CHI,12,404,71,163,0.436,22,65,0.338,31,41,0.756,6,26,32,53,12,2,32,38,195,160,1.66,0.38,2012,13,16.25,1.65625,92,10,102,0.3137254901960784
2012-13,Playoffs,203084,24,Harrison Barnes,1610612744,GSW,12,461,72,162,0.444,19,52,0.365,30,35,0.857,18,59,77,15,7,5,16,33,193,186,0.94,0.44,2012,13,16.083333333333332,0.9375,90,5,95,0.8105263157894737
2012-13,Playoffs,202691,25,Klay Thompson,1610612744,GSW,12,495,76,174,0.437,25,59,0.424,5,6,0.833,9,46,55,22,12,7,24,44,182,155,0.92,0.5,2012,13,15.166666666666666,0.9166666666666666,98,1,99,0.5555555555555556
2012-13,Playoffs,202362,26,Lance Stephenson,1610612754,IND,19,673,69,169,0.408,18,64,0.281,23,37,0.622,14,130,144,63,23,2,36,47,179,261,1.75,0.64,2012,13,9.421052631578947,1.75,100,14,114,1.263157894736842
2012-13,Playoffs,101109,27,Raymond Felton,1610612752,NYK,12,454,72,162,0.444,9,28,0.321,16,24,0.667,17,24,41,56,20,5,20,26,169,173,2.8,1.0,2012,13,14.083333333333334,2.8,90,8,98,0.41836734693877553
2012-13,Playoffs,202710,28,Jimmy Butler,1610612741,CHI,12,490,50,115,0.435,15,37,0.405,45,55,0.818,9,53,62,32,15,6,16,26,160,184,2.0,0.94,2012,13,13.333333333333334,2.0,65,10,75,0.8266666666666667
2012-13,Playoffs,201935,29,James Harden,1610612745,HOU,6,243,45,115,0.391,15,44,0.341,53,66,0.803,5,35,40,27,12,6,27,18,158,133,1.0,0.44,2012,13,26.333333333333332,1.0,70,13,83,0.4819277108433735
2012-13,Playoffs,2747,30,JR Smith,1610612752,NYK,11,351,54,163,0.331,18,66,0.273,31,43,0.721,6,46,52,15,11,5,20,27,157,99,0.75,0.55,2012,13,14.272727272727273,0.75,109,12,121,0.4297520661157025
2012-13,Playoffs,201572,31,Brook Lopez,1610612751,BKN,7,263,58,123,0.472,1,1,1.0,39,44,0.886,29,23,52,10,6,21,16,20,156,159,0.63,0.38,2012,13,22.285714285714285,0.625,65,5,70,0.7428571428571429
2012-13,Playoffs,2755,32,Kevin Martin,1610612760,OKC,11,323,49,129,0.38,17,46,0.37,39,43,0.907,2,32,34,14,7,3,11,18,154,117,1.27,0.64,2012,13,14.0,1.2727272727272727,80,4,84,0.40476190476190477
2012-13,Playoffs,2754,32,Tony Allen,1610612763,MEM,15,422,54,125,0.432,2,8,0.25,44,58,0.759,37,54,91,27,30,5,19,48,154,203,1.42,1.58,2012,13,10.266666666666667,1.4210526315789473,71,14,85,1.0705882352941176
2012-13,Playoffs,202704,34,Reggie Jackson,1610612760,OKC,11,368,57,119,0.479,13,43,0.302,26,29,0.897,4,50,54,40,5,6,21,34,153,172,1.91,0.24,2012,13,13.909090909090908,1.9047619047619047,62,3,65,0.8307692307692308
2012-13,Playoffs,101114,35,Deron Williams,1610612751,BKN,7,292,45,106,0.425,17,43,0.395,37,45,0.822,1,21,22,59,7,4,21,17,144,146,2.81,0.33,2012,13,20.571428571428573,2.8095238095238093,61,8,69,0.3188405797101449
2012-13,Playoffs,202390,36,Gary Neal,1610612759,SAS,21,390,52,135,0.385,23,66,0.348,16,16,1.0,1,44,45,15,3,1,13,33,143,111,1.15,0.23,2012,13,6.809523809523809,1.1538461538461537,83,0,83,0.5421686746987951
2012-13,Playoffs,201171,37,Carl Landry,1610612744,GSW,12,246,52,100,0.52,0,0,0.0,38,52,0.731,22,40,62,17,7,2,19,29,142,149,0.9,0.37,2012,13,11.833333333333334,0.8947368421052632,48,14,62,1.0
2012-13,Playoffs,201586,38,Serge Ibaka,1610612760,OKC,11,366,59,135,0.437,4,9,0.444,19,24,0.792,39,53,92,8,0,33,7,38,141,186,1.14,0.0,2012,13,12.818181818181818,1.1428571428571428,76,5,81,1.1358024691358024
2012-13,Playoffs,201573,39,Jerryd Bayless,1610612763,MEM,15,320,49,137,0.358,18,59,0.305,23,26,0.885,1,29,30,32,7,5,16,35,139,106,2.0,0.44,2012,13,9.266666666666667,2.0,88,3,91,0.32967032967032966
2012-13,Playoffs,101108,40,Chris Paul,1610612746,LAC,6,224,49,92,0.533,6,19,0.316,33,37,0.892,3,21,24,38,11,0,9,17,137,154,4.22,1.22,2012,13,22.833333333333332,4.222222222222222,43,4,47,0.5106382978723404
2012-13,Playoffs,201158,41,Marco Belinelli,1610612741,CHI,12,325,44,107,0.411,16,47,0.34,29,33,0.879,0,35,35,31,5,0,15,26,133,122,2.07,0.33,2012,13,11.083333333333334,2.066666666666667,63,4,67,0.5223880597014925
2012-13,Playoffs,202347,41,Quincy Pondexter,1610612763,MEM,15,357,46,94,0.489,24,53,0.453,17,28,0.607,9,29,38,11,11,2,9,31,133,127,1.22,1.22,2012,13,8.866666666666667,1.2222222222222223,48,11,59,0.6440677966101694
2012-13,Playoffs,201149,43,Joakim Noah,1610612741,CHI,12,409,52,119,0.437,0,0,0.0,25,39,0.641,52,63,115,28,10,26,24,43,129,203,1.17,0.42,2012,13,10.75,1.1666666666666667,67,14,81,1.4197530864197532
2012-13,Playoffs,202708,43,Norris Cole,1610612748,MIA,21,418,49,102,0.48,17,32,0.531,14,19,0.737,6,33,39,42,15,2,23,40,129,146,1.83,0.65,2012,13,6.142857142857143,1.826086956521739,53,5,58,0.6724137931034483
2012-13,Playoffs,2365,45,Chris Andersen,1610612748,MIA,20,303,46,57,0.807,0,0,0.0,36,49,0.735,32,44,76,3,9,22,11,53,128,203,0.27,0.82,2012,13,6.4,0.2727272727272727,11,13,24,3.1666666666666665
2012-13,Playoffs,201951,45,Ty Lawson,1610612743,DEN,6,236,48,109,0.44,4,21,0.19,28,33,0.848,5,15,20,48,10,0,13,13,128,127,3.69,0.77,2012,13,21.333333333333332,3.6923076923076925,61,5,66,0.30303030303030304
2012-13,Playoffs,201145,47,Jeff Green,1610612738,BOS,6,258,37,85,0.435,10,22,0.455,38,45,0.844,6,26,32,14,2,4,19,22,122,100,0.74,0.1,2012,13,20.333333333333332,0.7368421052631579,48,7,55,0.5818181818181818
2012-13,Playoffs,201168,48,Tiago Splitter,1610612759,SAS,19,388,45,84,0.536,0,1,0.0,26,33,0.788,21,37,58,23,15,14,24,46,116,156,0.96,0.63,2012,13,6.105263157894737,0.9583333333333334,39,7,46,1.2608695652173914
2012-13,Playoffs,1718,49,Paul Pierce,1610612738,BOS,6,255,39,106,0.368,11,41,0.268,26,29,0.897,4,30,34,32,5,3,32,21,115,87,1.0,0.16,2012,13,19.166666666666668,1.0,67,3,70,0.4857142857142857
2012-13,Playoffs,202697,50,Iman Shumpert,1610612752,NYK,12,337,41,100,0.41,18,42,0.429,12,14,0.857,18,54,72,16,13,3,14,36,112,141,1.14,0.93,2012,13,9.333333333333334,1.1428571428571428,59,2,61,1.180327868852459
2012-13,Playoffs,2617,51,Udonis Haslem,1610612748,MIA,22,357,51,86,0.593,0,0,0.0,8,14,0.571,26,54,80,6,15,5,14,54,110,161,0.43,1.07,2012,13,5.0,0.42857142857142855,35,6,41,1.951219512195122
2012-13,Playoffs,202718,52,Chandler Parsons,1610612745,HOU,6,238,42,93,0.452,16,40,0.4,9,14,0.643,7,32,39,22,1,2,18,19,109,99,1.22,0.06,2012,13,18.166666666666668,1.2222222222222223,51,5,56,0.6964285714285714
2012-13,Playoffs,2738,53,Andre Iguodala,1610612743,DEN,6,243,38,76,0.5,14,29,0.483,18,25,0.72,9,39,48,32,12,2,17,9,108,140,1.88,0.71,2012,13,18.0,1.8823529411764706,38,7,45,1.0666666666666667
2012-13,Playoffs,2419,54,Tayshaun Prince,1610612763,MEM,15,454,43,121,0.355,5,19,0.263,14,23,0.609,12,45,57,29,7,5,10,18,105,106,2.9,0.7,2012,13,7.0,2.9,78,9,87,0.6551724137931034
2012-13,Playoffs,2207,55,Joe Johnson,1610612751,BKN,7,271,43,103,0.417,10,39,0.256,8,9,0.889,4,18,22,19,8,0,12,13,104,80,1.58,0.67,2012,13,14.857142857142858,1.5833333333333333,60,1,61,0.36065573770491804
2012-13,Playoffs,2203,56,Shane Battier,1610612748,MIA,22,392,27,93,0.29,26,88,0.295,23,28,0.821,9,29,38,12,5,6,5,49,103,88,2.4,1.0,2012,13,4.681818181818182,2.4,66,5,71,0.5352112676056338
2012-13,Playoffs,2746,57,Josh Smith,1610612737,ATL,6,199,39,90,0.433,5,20,0.25,19,36,0.528,10,35,45,21,11,3,16,21,102,98,1.31,0.69,2012,13,17.0,1.3125,51,17,68,0.6617647058823529
2012-13,Playoffs,201143,58,Al Horford,1610612737,ATL,6,218,41,83,0.494,0,0,0.0,18,27,0.667,12,41,53,18,6,5,9,17,100,122,2.0,0.67,2012,13,16.666666666666668,2.0,42,9,51,1.0392156862745099
2012-13,Playoffs,201571,59,D.J. Augustin,1610612754,IND,19,316,27,71,0.38,19,48,0.396,25,31,0.806,2,13,15,13,7,0,10,26,98,73,1.3,0.7,2012,13,5.157894736842105,1.3,44,6,50,0.3
2012-13,Playoffs,965,60,Derek Fisher,1610612760,OKC,11,261,32,70,0.457,24,51,0.471,8,12,0.667,1,16,17,8,7,1,8,33,96,79,1.0,0.88,2012,13,8.727272727272727,1.0,38,4,42,0.40476190476190477
2012-13,Playoffs,101106,61,Andrew Bogut,1610612744,GSW,12,327,39,67,0.582,0,0,0.0,8,23,0.348,39,92,131,22,6,18,22,39,86,198,1.0,0.27,2012,13,7.166666666666667,1.0,28,15,43,3.046511627906977
2012-13,Playoffs,1889,62,Andre Miller,1610612743,DEN,6,154,29,69,0.42,5,11,0.455,21,27,0.778,11,9,20,23,2,0,16,8,84,67,1.44,0.13,2012,13,14.0,1.4375,40,6,46,0.43478260869565216
2012-13,Playoffs,2222,62,Gerald Wallace,1610612751,BKN,7,243,31,67,0.463,11,29,0.379,11,20,0.55,5,23,28,17,8,5,9,20,84,88,1.89,0.89,2012,13,12.0,1.8888888888888888,36,9,45,0.6222222222222222
2012-13,Playoffs,2588,64,Matt Bonner,1610612759,SAS,20,267,28,59,0.475,15,32,0.469,10,12,0.833,9,30,39,6,5,5,2,35,81,101,3.0,2.5,2012,13,4.05,3.0,31,2,33,1.1818181818181819
2012-13,Playoffs,201952,65,Jeff Teague,1610612737,ATL,6,213,27,81,0.333,3,10,0.3,23,28,0.821,3,14,17,30,9,2,14,17,80,65,2.14,0.64,2012,13,13.333333333333334,2.142857142857143,54,5,59,0.288135593220339
2012-13,Playoffs,201933,66,Blake Griffin,1610612746,LAC,6,158,29,64,0.453,0,0,0.0,21,26,0.808,8,25,33,15,0,5,13,24,79,79,1.15,0.0,2012,13,13.166666666666666,1.1538461538461537,35,5,40,0.825
2012-13,Playoffs,201959,67,Taj Gibson,1610612741,CHI,12,206,31,66,0.47,0,2,0.0,16,22,0.727,15,21,36,4,4,6,9,37,78,78,0.44,0.44,2012,13,6.5,0.4444444444444444,35,6,41,0.8780487804878049
2012-13,Playoffs,201946,67,Tyler Hansbrough,1610612754,IND,19,241,26,62,0.419,0,0,0.0,26,44,0.591,36,25,61,5,6,0,15,41,78,81,0.33,0.4,2012,13,4.105263157894737,0.3333333333333333,36,18,54,1.1296296296296295
2012-13,Playoffs,708,69,Kevin Garnett,1610612738,BOS,6,212,30,60,0.5,0,2,0.0,16,17,0.941,9,73,82,21,5,6,19,23,76,140,1.1,0.26,2012,13,12.666666666666666,1.105263157894737,30,1,31,2.6451612903225805
2012-13,Playoffs,201600,70,Ömer Aşik,1610612745,HOU,6,208,22,39,0.564,0,0,0.0,30,47,0.638,21,46,67,3,3,10,12,22,74,111,0.25,0.25,2012,13,12.333333333333334,0.25,17,17,34,1.9705882352941178
2012-13,Playoffs,101154,71,Andray Blatche,1610612751,BKN,7,138,29,58,0.5,0,0,0.0,14,17,0.824,10,24,34,9,2,3,5,14,72,83,1.8,0.4,2012,13,10.285714285714286,1.8,29,3,32,1.0625
2012-13,Playoffs,1891,71,Jason Terry,1610612738,BOS,6,189,24,54,0.444,15,34,0.441,9,11,0.818,0,13,13,12,4,2,5,9,72,66,2.4,0.8,2012,13,12.0,2.4,30,2,32,0.40625
2012-13,Playoffs,201163,71,Wilson Chandler,1610612743,DEN,6,205,27,76,0.355,9,29,0.31,9,12,0.75,5,28,33,8,8,3,7,25,72,65,1.14,1.14,2012,13,12.0,1.1428571428571428,49,3,52,0.6346153846153846
2012-13,Playoffs,2440,74,Matt Barnes,1610612746,LAC,6,162,24,44,0.545,7,17,0.412,16,19,0.842,7,23,30,3,4,2,5,23,71,82,0.6,0.8,2012,13,11.833333333333334,0.6,20,3,23,1.3043478260869565
2012-13,Playoffs,201976,74,Patrick Beverley,1610612745,HOU,6,200,28,65,0.431,8,24,0.333,7,7,1.0,11,22,33,17,7,4,6,24,71,89,2.83,1.17,2012,13,11.833333333333334,2.8333333333333335,37,0,37,0.8918918918918919
2012-13,Playoffs,203110,76,Draymond Green,1610612744,GSW,12,223,24,56,0.429,9,23,0.391,13,17,0.765,14,37,51,19,6,10,12,35,70,108,1.58,0.5,2012,13,5.833333333333333,1.5833333333333333,32,4,36,1.4166666666666667
2012-13,Playoffs,2030,77,Kenyon Martin,1610612752,NYK,12,253,29,50,0.58,0,0,0.0,11,20,0.55,16,38,54,11,9,17,8,42,69,122,1.38,1.13,2012,13,5.75,1.375,21,9,30,1.8
2012-13,Playoffs,2736,77,Luol Deng,1610612741,CHI,5,224,32,84,0.381,1,18,0.056,4,10,0.4,5,33,38,19,5,3,12,12,69,64,1.58,0.42,2012,13,13.8,1.5833333333333333,52,6,58,0.6551724137931034
2012-13,Playoffs,2734,79,Devin Harris,1610612737,ATL,6,225,23,63,0.365,5,25,0.2,17,25,0.68,2,15,17,22,10,1,12,18,68,58,1.83,0.83,2012,13,11.333333333333334,1.8333333333333333,40,8,48,0.3541666666666667
2012-13,Playoffs,2730,79,Dwight Howard,1610612747,LAL,4,126,26,42,0.619,0,0,0.0,16,36,0.444,10,33,43,4,2,8,16,17,68,73,0.25,0.13,2012,13,17.0,0.25,16,20,36,1.1944444444444444
2012-13,Playoffs,2199,79,Tyson Chandler,1610612752,NYK,12,350,28,52,0.538,0,0,0.0,12,16,0.75,40,48,88,4,8,14,11,48,68,143,0.36,0.73,2012,13,5.666666666666667,0.36363636363636365,24,4,28,3.142857142857143
2012-13,Playoffs,2564,82,Boris Diaw,1610612759,SAS,16,273,24,54,0.444,5,13,0.385,12,14,0.857,8,32,40,28,4,3,13,28,65,95,2.15,0.31,2012,13,4.0625,2.1538461538461537,30,2,32,1.25
2012-13,Playoffs,201147,82,Corey Brewer,1610612743,DEN,6,146,21,68,0.309,9,36,0.25,14,21,0.667,3,8,11,7,6,1,7,19,65,29,1.0,0.86,2012,13,10.833333333333334,1.0,47,7,54,0.2037037037037037
2012-13,Playoffs,2037,82,Jamal Crawford,1610612746,LAC,6,161,24,62,0.387,6,22,0.273,11,11,1.0,2,10,12,10,3,1,4,9,65,49,2.5,0.75,2012,13,10.833333333333334,2.5,38,0,38,0.3157894736842105
2012-13,Playoffs,101128,85,Francisco Garcia,1610612745,HOU,6,164,22,50,0.44,17,37,0.459,3,5,0.6,3,17,20,9,4,5,4,21,64,68,2.25,1.0,2012,13,10.666666666666666,2.25,28,2,30,0.6666666666666666
2012-13,Playoffs,200757,86,Thabo Sefolosha,1610612760,OKC,11,300,21,61,0.344,12,38,0.316,9,11,0.818,13,36,49,23,12,5,8,26,63,102,2.88,1.5,2012,13,5.7272727272727275,2.875,40,2,42,1.1666666666666667
2012-13,Playoffs,2594,87,Kyle Korver,1610612737,ATL,6,177,19,49,0.388,12,34,0.353,11,12,0.917,0,20,20,4,2,4,6,14,61,54,0.67,0.33,2012,13,10.166666666666666,0.6666666666666666,30,1,31,0.6451612903225806
2012-13,Playoffs,201228,88,C.J. Watson,1610612751,BKN,7,161,24,55,0.436,4,15,0.267,8,12,0.667,5,12,17,13,5,1,1,11,60,60,13.0,5.0,2012,13,8.571428571428571,13.0,31,4,35,0.4857142857142857
2012-13,Playoffs,202709,89,Cory Joseph,1610612759,SAS,20,192,26,56,0.464,2,11,0.182,5,11,0.455,8,23,31,24,6,2,10,15,59,76,2.4,0.6,2012,13,2.95,2.4,30,6,36,0.8611111111111112
2012-13,Playoffs,201589,90,Darrell Arthur,1610612763,MEM,15,175,25,53,0.472,0,2,0.0,8,9,0.889,14,24,38,6,2,4,7,36,58,72,0.86,0.29,2012,13,3.8666666666666667,0.8571428571428571,28,1,29,1.3103448275862069
2012-13,Playoffs,2034,90,Mike Miller,1610612748,MIA,17,232,21,45,0.467,16,36,0.444,0,0,0.0,3,30,33,15,8,2,5,26,58,87,3.0,1.6,2012,13,3.411764705882353,3.0,24,0,24,1.375
2012-13,Playoffs,101145,92,Monta Ellis,1610612749,MIL,4,152,24,55,0.436,3,19,0.158,6,16,0.375,2,11,13,22,10,1,14,8,57,48,1.57,0.71,2012,13,14.25,1.5714285714285714,31,10,41,0.3170731707317073
2012-13,Playoffs,2200,93,Pau Gasol,1610612747,LAL,4,146,25,52,0.481,0,0,0.0,6,11,0.545,7,39,46,26,2,3,13,4,56,88,2.0,0.15,2012,13,14.0,2.0,27,5,32,1.4375
2012-13,Playoffs,101123,94,Gerald Green,1610612754,IND,9,105,21,50,0.42,11,33,0.333,2,2,1.0,2,10,12,3,0,1,6,10,55,36,0.5,0.0,2012,13,6.111111111111111,0.5,29,0,29,0.41379310344827586
2012-13,Playoffs,2555,94,Nick Collison,1610612760,OKC,11,178,22,47,0.468,0,0,0.0,11,12,0.917,25,26,51,12,5,11,10,37,55,98,1.2,0.5,2012,13,5.0,1.2,25,1,26,1.9615384615384615
2012-13,Playoffs,201943,96,Brandon Jennings,1610612749,MIL,4,133,17,57,0.298,6,28,0.214,13,18,0.722,1,8,9,16,9,1,11,6,53,32,1.46,0.82,2012,13,13.25,1.4545454545454546,40,5,45,0.2
2012-13,Playoffs,2406,97,Caron Butler,1610612746,LAC,6,136,22,46,0.478,4,16,0.25,3,3,1.0,1,15,16,0,2,2,6,11,51,41,0.0,0.33,2012,13,8.5,0.0,24,0,24,0.6666666666666666
2012-13,Playoffs,202702,97,Kenneth Faried,1610612743,DEN,5,145,20,32,0.625,0,0,0.0,11,15,0.733,12,30,42,1,5,1,5,22,51,79,0.2,1.0,2012,13,10.2,0.2,12,4,16,2.625
2012-13,Playoffs,2399,99,Mike Dunleavy,1610612749,MIL,4,91,17,30,0.567,7,16,0.438,8,9,0.889,3,13,16,8,2,0,3,5,49,58,2.67,0.67,2012,13,12.25,2.6666666666666665,13,1,14,1.1428571428571428
2012-13,Playoffs,203143,99,Pablo Prigioni,1610612752,NYK,11,230,17,43,0.395,13,30,0.433,2,4,0.5,2,15,17,35,14,1,6,21,49,82,5.83,2.33,2012,13,4.454545454545454,5.833333333333333,26,2,28,0.6071428571428571
2012-13,Playoffs,201566,101,Russell Westbrook,1610612760,OKC,2,68,17,41,0.415,2,9,0.222,12,14,0.857,1,12,13,14,6,0,8,5,48,47,1.75,0.75,2012,13,24.0,1.75,24,2,26,0.5
2012-13,Playoffs,201971,102,DeJuan Blair,1610612759,SAS,12,76,21,34,0.618,0,0,0.0,5,9,0.556,6,18,24,7,5,1,1,14,47,66,7.0,5.0,2012,13,3.9166666666666665,7.0,13,4,17,1.411764705882353
2012-13,Playoffs,101141,103,Ersan Ilyasova,1610612749,MIL,4,117,20,46,0.435,4,10,0.4,2,2,1.0,10,19,29,7,5,1,6,8,46,56,1.17,0.83,2012,13,11.5,1.1666666666666667,26,0,26,1.1153846153846154
2012-13,Playoffs,1737,103,Nazr Mohammed,1610612741,CHI,12,114,21,41,0.512,0,0,0.0,4,7,0.571,14,18,32,4,2,7,3,15,46,65,1.33,0.67,2012,13,3.8333333333333335,1.3333333333333333,20,3,23,1.391304347826087
2012-13,Playoffs,2568,105,Carlos Delfino,1610612745,HOU,5,120,15,40,0.375,11,31,0.355,4,4,1.0,1,11,12,10,3,1,5,10,45,41,2.0,0.6,2012,13,9.0,2.0,25,0,25,0.48
2012-13,Playoffs,2550,105,Kirk Hinrich,1610612741,CHI,4,162,16,37,0.432,4,11,0.364,9,14,0.643,1,10,11,23,8,1,8,14,45,54,2.88,1.0,2012,13,11.25,2.875,21,5,26,0.4230769230769231
2012-13,Playoffs,201580,107,JaVale McGee,1610612743,DEN,6,112,18,31,0.581,0,0,0.0,7,18,0.389,17,14,31,0,4,6,11,17,43,49,0.0,0.36,2012,13,7.166666666666667,0.0,13,11,24,1.2916666666666667
2012-13,Playoffs,202336,107,Larry Sanders,1610612749,MIL,4,113,19,33,0.576,0,0,0.0,5,11,0.455,11,22,33,5,3,5,12,18,43,57,0.42,0.25,2012,13,10.75,0.4166666666666667,14,6,20,1.65
2012-13,Playoffs,202721,109,Darius Morris,1610612747,LAL,4,105,16,35,0.457,3,9,0.333,7,9,0.778,1,4,5,12,2,0,6,6,42,34,2.0,0.33,2012,13,10.5,2.0,19,2,21,0.23809523809523808
2012-13,Playoffs,202340,110,Avery Bradley,1610612738,BOS,6,191,17,42,0.405,2,8,0.25,4,4,1.0,3,10,13,8,11,1,11,11,40,37,0.73,1.0,2012,13,6.666666666666667,0.7272727272727273,25,0,25,0.52
2012-13,Playoffs,101138,110,Brandon Bass,1610612738,BOS,6,204,14,29,0.483,0,0,0.0,12,15,0.8,8,32,40,7,2,1,5,17,40,67,1.4,0.4,2012,13,6.666666666666667,1.4,15,3,18,2.2222222222222223
2012-13,Playoffs,202339,112,Eric Bledsoe,1610612746,LAC,6,97,15,30,0.5,1,9,0.111,8,12,0.667,2,13,15,18,2,3,5,10,39,53,3.6,0.4,2012,13,6.5,3.6,15,4,19,0.7894736842105263
2012-13,Playoffs,1497,113,Chauncey Billups,1610612746,LAC,6,115,11,36,0.306,6,17,0.353,9,11,0.818,2,10,12,6,1,1,8,10,37,22,0.75,0.13,2012,13,6.166666666666667,0.75,25,2,27,0.4444444444444444
2012-13,Playoffs,203142,113,Chris Copeland,1610612752,NYK,9,93,12,30,0.4,11,23,0.478,2,2,1.0,2,7,9,1,5,0,4,9,37,30,0.25,1.25,2012,13,4.111111111111111,0.25,18,0,18,0.5
2012-13,Playoffs,202726,115,Andrew Goudelock,1610612747,LAL,3,80,16,36,0.444,2,10,0.2,2,2,1.0,1,4,5,3,5,0,4,7,36,25,0.75,1.25,2012,13,12.0,0.75,20,0,20,0.25
2012-13,Playoffs,201274,115,Ivan Johnson,1610612737,ATL,6,108,12,26,0.462,0,0,0.0,12,18,0.667,9,11,20,3,4,3,6,23,36,40,0.5,0.67,2012,13,6.0,0.5,14,6,20,1.0
2012-13,Playoffs,201601,117,Luc Mbah a Moute,1610612749,MIL,4,136,10,23,0.435,0,4,0.0,13,18,0.722,4,10,14,7,4,0,5,9,33,35,1.4,0.8,2012,13,8.25,1.4,13,5,18,0.7777777777777778
2012-13,Playoffs,2501,118,Reggie Evans,1610612751,BKN,7,209,11,23,0.478,0,0,0.0,10,18,0.556,16,70,86,6,7,2,6,21,32,107,1.0,1.17,2012,13,4.571428571428571,1.0,12,8,20,4.3
2012-13,Playoffs,2743,119,Kris Humphries,1610612751,BKN,7,83,14,31,0.452,0,0,0.0,3,7,0.429,10,13,23,1,1,3,2,15,31,36,0.5,0.5,2012,13,4.428571428571429,0.5,17,4,21,1.0952380952380953
2012-13,Playoffs,201166,120,Aaron Brooks,1610612745,HOU,6,67,13,34,0.382,1,9,0.111,3,5,0.6,3,6,9,11,1,1,6,3,30,23,1.83,0.17,2012,13,5.0,1.8333333333333333,21,2,23,0.391304347826087
2012-13,Playoffs,101135,120,David Lee,1610612744,GSW,6,65,13,33,0.394,0,0,0.0,4,6,0.667,6,22,28,5,3,1,5,5,30,40,1.0,0.6,2012,13,5.0,1.0,20,2,22,1.2727272727272727
2012-13,Playoffs,1885,120,Lamar Odom,1610612746,LAC,6,107,11,30,0.367,5,14,0.357,3,6,0.5,4,19,23,11,5,5,10,16,30,42,1.1,0.5,2012,13,5.0,1.1,19,3,22,1.0454545454545454
2012-13,Playoffs,1712,123,Antawn Jamison,1610612747,LAL,4,79,10,23,0.435,5,12,0.417,4,6,0.667,1,6,7,1,1,2,3,9,29,22,0.33,0.33,2012,13,7.25,0.3333333333333333,13,2,15,0.4666666666666667
2012-13,Playoffs,101133,123,Ian Mahinmi,1610612754,IND,18,150,13,29,0.448,0,0,0.0,3,10,0.3,20,22,42,1,0,13,12,28,29,50,0.08,0.0,2012,13,1.6111111111111112,0.08333333333333333,16,7,23,1.826086956521739
2012-13,Playoffs,200755,123,JJ Redick,1610612749,MIL,4,69,11,25,0.44,4,12,0.333,3,3,1.0,0,3,3,5,1,0,6,9,29,18,0.83,0.17,2012,13,7.25,0.8333333333333334,14,0,14,0.21428571428571427
2012-13,Playoffs,101130,123,Johan Petro,1610612737,ATL,6,101,14,27,0.519,0,0,0.0,1,2,0.5,4,18,22,4,1,4,3,18,29,43,1.33,0.33,2012,13,4.833333333333333,1.3333333333333333,13,1,14,1.5714285714285714
2012-13,Playoffs,2581,127,Steve Blake,1610612747,LAL,2,75,11,28,0.393,5,12,0.417,1,1,1.0,0,8,8,5,4,3,4,8,28,27,1.25,1.0,2012,13,14.0,1.25,17,0,17,0.47058823529411764
2012-13,Playoffs,2039,128,Keyon Dooling,1610612763,MEM,14,114,8,24,0.333,5,13,0.385,6,6,1.0,0,5,5,4,1,0,3,14,27,18,1.33,0.33,2012,13,1.9285714285714286,1.3333333333333333,16,0,16,0.3125
2012-13,Playoffs,201576,129,Anthony Randolph,1610612743,DEN,5,30,9,11,0.818,0,0,0.0,8,11,0.727,0,6,6,0,2,0,2,4,26,27,0.0,1.0,2012,13,5.2,0.0,2,3,5,1.2
2012-13,Playoffs,1888,129,Richard Hamilton,1610612741,CHI,4,68,10,27,0.37,3,7,0.429,3,4,0.75,0,3,3,5,1,2,5,5,26,14,1.0,0.2,2012,13,6.5,1.0,17,1,18,0.16666666666666666
2012-13,Playoffs,201970,129,Sam Young,1610612754,IND,15,130,9,24,0.375,2,10,0.2,6,8,0.75,11,18,29,4,4,1,7,17,26,40,0.57,0.57,2012,13,1.7333333333333334,0.5714285714285714,15,2,17,1.7058823529411764
2012-13,Playoffs,959,132,Steve Nash,1610612747,LAL,2,61,10,23,0.435,0,3,0.0,5,5,1.0,2,3,5,9,0,0,3,2,25,23,3.0,0.0,2012,13,12.5,3.0,13,0,13,0.38461538461538464
2012-13,Playoffs,201229,133,Anthony Tolliver,1610612737,ATL,6,68,8,14,0.571,7,11,0.636,1,3,0.333,3,6,9,1,1,1,1,7,24,27,1.0,1.0,2012,13,4.0,1.0,6,2,8,1.125
2012-13,Playoffs,203105,133,Festus Ezeli,1610612744,GSW,12,134,6,13,0.462,0,0,0.0,12,21,0.571,13,17,30,2,3,7,12,24,24,38,0.17,0.25,2012,13,2.0,0.16666666666666666,7,9,16,1.875
2012-13,Playoffs,2570,133,Kendrick Perkins,1610612760,OKC,11,210,10,38,0.263,0,1,0.0,4,4,1.0,15,26,41,7,8,5,23,39,24,34,0.3,0.35,2012,13,2.1818181818181817,0.30434782608695654,28,0,28,1.4642857142857142
2012-13,Playoffs,201599,136,DeAndre Jordan,1610612746,LAC,6,144,10,22,0.455,0,0,0.0,2,9,0.222,15,23,38,1,1,10,9,18,22,44,0.11,0.11,2012,13,3.6666666666666665,0.1111111111111111,12,7,19,2.0
2012-13,Playoffs,201585,137,Kosta Koufos,1610612743,DEN,6,100,7,19,0.368,1,1,1.0,5,6,0.833,9,12,21,3,3,4,2,13,20,36,1.5,1.5,2012,13,3.3333333333333335,1.5,12,1,13,1.6153846153846154
2012-13,Playoffs,203095,138,Evan Fournier,1610612743,DEN,4,53,6,17,0.353,0,8,0.0,7,8,0.875,0,0,0,4,2,0,6,6,19,7,0.67,0.33,2012,13,4.75,0.6666666666666666,11,1,12,0.0
2012-13,Playoffs,202962,139,Greg Smith,1610612745,HOU,5,59,6,9,0.667,0,0,0.0,6,12,0.5,7,6,13,0,2,2,4,9,18,22,0.0,0.5,2012,13,3.6,0.0,3,6,9,1.4444444444444444
2012-13,Playoffs,202348,139,Jordan Crawford,1610612738,BOS,5,59,7,23,0.304,3,12,0.25,1,2,0.5,0,3,3,0,2,0,3,3,18,3,0.0,0.67,2012,13,3.6,0.0,16,1,17,0.17647058823529413
2012-13,Playoffs,1897,139,Metta World Peace,1610612747,LAL,3,84,7,28,0.25,2,14,0.143,2,2,1.0,6,5,11,5,2,1,3,5,18,13,1.67,0.67,2012,13,6.0,1.6666666666666667,21,0,21,0.5238095238095238
2012-13,Playoffs,200779,139,Steve Novak,1610612752,NYK,9,50,7,13,0.538,4,9,0.444,0,0,0.0,2,2,4,0,1,0,0,5,18,17,0.0,0.0,2012,13,2.0,,6,0,6,0.6666666666666666
2012-13,Playoffs,1740,143,Rashard Lewis,1610612748,MIA,11,47,8,20,0.4,0,4,0.0,1,2,0.5,1,6,7,4,2,2,6,5,17,13,0.67,0.33,2012,13,1.5454545454545454,0.6666666666666666,12,1,13,0.5384615384615384
2012-13,Playoffs,201965,144,Jeff Ayres,1610612754,IND,9,71,8,24,0.333,0,1,0.0,0,0,0.0,4,14,18,1,0,2,3,14,16,18,0.33,0.0,2012,13,1.7777777777777777,0.3333333333333333,16,0,16,1.125
2012-13,Playoffs,202391,144,Jeremy Lin,1610612745,HOU,4,84,6,24,0.25,2,12,0.167,2,2,1.0,0,8,8,8,2,1,8,9,16,9,1.0,0.25,2012,13,4.0,1.0,18,0,18,0.4444444444444444
2012-13,Playoffs,101142,144,Ronny Turiaf,1610612746,LAC,5,59,7,10,0.7,0,0,0.0,2,4,0.5,4,4,8,0,1,3,2,14,16,21,0.0,0.5,2012,13,3.2,0.0,3,2,5,1.6
2012-13,Playoffs,2405,147,Amar'e Stoudemire,1610612752,NYK,4,33,5,13,0.385,1,1,1.0,4,4,1.0,4,5,9,0,0,0,3,9,15,13,0.0,0.0,2012,13,3.75,0.0,8,0,8,1.125
2012-13,Playoffs,201947,148,Earl Clark,1610612747,LAL,4,82,7,19,0.368,0,4,0.0,0,0,0.0,2,10,12,1,1,1,6,4,14,11,0.17,0.17,2012,13,3.5,0.16666666666666666,12,0,12,1.0
2012-13,Playoffs,202334,149,Ed Davis,1610612763,MEM,8,48,5,12,0.417,0,0,0.0,3,4,0.75,4,7,11,0,0,1,2,7,13,15,0.0,0.0,2012,13,1.625,0.0,7,1,8,1.375
2012-13,Playoffs,203118,149,Mike Scott,1610612737,ATL,4,20,5,10,0.5,0,1,0.0,3,4,0.75,1,6,7,1,0,0,0,2,13,15,0.0,0.0,2012,13,3.25,inf,5,1,6,1.1666666666666667
2012-13,Playoffs,2210,149,Richard Jefferson,1610612744,GSW,7,39,4,9,0.444,2,3,0.667,3,9,0.333,2,5,7,1,1,1,0,5,13,12,0.0,0.0,2012,13,1.8571428571428572,inf,5,6,11,0.6363636363636364
2012-13,Playoffs,2605,152,Marquis Daniels,1610612749,MIL,3,33,6,11,0.545,0,2,0.0,0,0,0.0,0,4,4,4,1,0,1,3,12,15,4.0,1.0,2012,13,4.0,4.0,5,0,5,0.8
2012-13,Playoffs,201988,152,Patty Mills,1610612759,SAS,9,31,5,10,0.5,2,7,0.286,0,0,0.0,1,2,3,2,0,0,1,2,12,11,2.0,0.0,2012,13,1.3333333333333333,2.0,5,0,5,0.6
2012-13,Playoffs,2768,154,Chris Duhon,1610612747,LAL,2,68,4,11,0.364,3,8,0.375,0,0,0.0,1,2,3,7,2,1,5,4,11,12,1.4,0.4,2012,13,5.5,1.4,7,0,7,0.42857142857142855
2012-13,Playoffs,467,154,Jason Kidd,1610612752,NYK,12,247,3,25,0.12,3,17,0.176,2,2,1.0,7,35,42,24,12,4,13,12,11,58,1.85,0.92,2012,13,0.9166666666666666,1.8461538461538463,22,0,22,1.9090909090909092
2012-13,Playoffs,200797,154,Ryan Hollins,1610612746,LAC,5,37,5,9,0.556,0,0,0.0,1,2,0.5,3,2,5,2,0,2,2,10,11,13,1.0,0.0,2012,13,2.2,1.0,4,1,5,1.0
2012-13,Playoffs,201941,157,Jordan Hill,1610612747,LAL,3,31,5,10,0.5,0,0,0.0,0,0,0.0,2,9,11,1,0,2,0,2,10,19,0.0,0.0,2012,13,3.3333333333333335,inf,5,0,5,2.2
2012-13,Playoffs,203104,157,Marquis Teague,1610612741,CHI,8,72,5,17,0.294,0,5,0.0,0,0,0.0,0,3,3,12,2,1,2,10,10,14,6.0,1.0,2012,13,1.25,6.0,12,0,12,0.25
2012-13,Playoffs,203111,157,Orlando Johnson,1610612754,IND,12,28,2,11,0.182,1,3,0.333,5,9,0.556,0,3,3,1,0,0,1,0,10,0,1.0,0.0,2012,13,0.8333333333333334,1.0,9,4,13,0.23076923076923078
2012-13,Playoffs,202714,157,Shelvin Mack,1610612737,ATL,4,22,4,9,0.444,2,5,0.4,0,0,0.0,3,4,7,7,0,0,0,0,10,19,0.0,0.0,2012,13,2.5,inf,5,0,5,1.4
2012-13,Playoffs,2052,161,DeShawn Stevenson,1610612737,ATL,4,45,3,5,0.6,3,5,0.6,0,0,0.0,3,7,10,1,0,0,2,5,9,16,0.5,0.0,2012,13,2.25,0.5,2,0,2,5.0
2012-13,Playoffs,2592,161,James Jones,1610612748,MIA,9,33,3,7,0.429,3,4,0.75,0,0,0.0,0,3,3,0,0,1,2,3,9,7,0.0,0.0,2012,13,1.0,0.0,4,0,4,0.75
2012-13,Playoffs,2209,161,Vladimir Radmanovic,1610612741,CHI,1,10,3,3,1.0,3,3,1.0,0,0,0.0,0,0,0,1,2,0,1,1,9,11,1.0,2.0,2012,13,9.0,1.0,0,0,0,
2012-13,Playoffs,203382,164,Aron Baynes,1610612759,SAS,4,23,4,7,0.571,0,0,0.0,0,0,0.0,2,3,5,0,0,0,1,4,8,9,0.0,0.0,2012,13,2.0,0.0,3,0,3,1.6666666666666667
2012-13,Playoffs,202732,164,DeAndre Liggins,1610612760,OKC,8,68,3,9,0.333,1,5,0.2,1,4,0.25,0,14,14,4,1,1,2,10,8,17,2.0,0.5,2012,13,1.0,2.0,6,3,9,1.5555555555555556
2012-13,Playoffs,202327,164,Ekpe Udoh,1610612749,MIL,4,54,4,9,0.444,0,0,0.0,0,0,0.0,3,3,6,1,2,2,0,4,8,14,0.0,0.0,2012,13,2.0,inf,5,0,5,1.2
2012-13,Playoffs,202705,164,MarShon Brooks,1610612751,BKN,7,40,3,8,0.375,0,1,0.0,2,2,1.0,1,4,5,3,0,0,3,3,8,8,1.0,0.0,2012,13,1.1428571428571428,1.0,5,0,5,1.0
2012-13,Playoffs,203093,164,Terrence Jones,1610612745,HOU,2,35,4,10,0.4,0,2,0.0,0,3,0.0,5,10,15,1,0,1,1,2,8,15,1.0,0.0,2012,13,4.0,1.0,6,3,9,1.6666666666666667
2012-13,Playoffs,203100,164,Tony Wroten,1610612763,MEM,6,17,2,11,0.182,0,2,0.0,4,4,1.0,1,3,4,2,1,0,2,1,8,4,1.0,0.5,2012,13,1.3333333333333333,1.0,9,0,9,0.4444444444444444
2012-13,Playoffs,201948,170,Austin Daye,1610612763,MEM,4,20,3,8,0.375,0,1,0.0,1,1,1.0,0,1,1,0,0,1,1,2,7,3,0.0,0.0,2012,13,1.75,0.0,5,0,5,0.2
2012-13,Playoffs,201584,171,Courtney Lee,1610612738,BOS,4,39,1,5,0.2,0,2,0.0,4,4,1.0,0,2,2,1,2,0,0,3,6,7,0.0,0.0,2012,13,1.5,inf,4,0,4,0.5
2012-13,Playoffs,201202,171,Joel Anthony,1610612748,MIA,14,71,3,10,0.3,0,0,0.0,0,0,0.0,10,11,21,0,2,4,3,13,6,23,0.0,0.67,2012,13,0.42857142857142855,0.0,7,0,7,3.0
2012-13,Playoffs,203089,171,John Henson,1610612749,MIL,4,33,3,11,0.273,0,1,0.0,0,0,0.0,0,8,8,1,2,0,2,5,6,7,0.5,1.0,2012,13,1.5,0.5,8,0,8,1.0
2012-13,Playoffs,2047,171,Quentin Richardson,1610612752,NYK,5,14,2,6,0.333,2,5,0.4,0,0,0.0,1,2,3,0,0,0,0,2,6,5,0.0,0.0,2012,13,1.2,,4,0,4,0.75
2012-13,Playoffs,2584,171,Willie Green,1610612746,LAC,3,20,2,3,0.667,0,1,0.0,2,2,1.0,0,3,3,2,1,0,0,0,6,11,0.0,0.0,2012,13,2.0,inf,1,0,1,3.0
2012-13,Playoffs,202700,176,Donatas Motiejunas,1610612745,HOU,1,5,2,2,1.0,0,0,0.0,1,1,1.0,1,0,1,0,0,0,0,0,5,6,0.0,0.0,2012,13,5.0,,0,0,0,inf
2012-13,Playoffs,711,176,Jerry Stackhouse,1610612751,BKN,4,28,1,10,0.1,0,7,0.0,3,4,0.75,1,3,4,0,0,0,2,2,5,-3,0.0,0.0,2012,13,1.25,0.0,9,1,10,0.4
2012-13,Playoffs,201944,176,Terrence Williams,1610612738,BOS,5,48,2,10,0.2,0,3,0.0,1,2,0.5,1,9,10,6,0,1,4,3,5,9,1.5,0.0,2012,13,1.0,1.5,8,1,9,1.1111111111111112
2012-13,Playoffs,2563,179,Dahntay Jones,1610612737,ATL,5,19,1,4,0.25,0,0,0.0,2,2,1.0,0,1,1,0,0,0,1,1,4,1,0.0,0.0,2012,13,0.8,0.0,3,0,3,0.3333333333333333
2012-13,Playoffs,255,179,Grant Hill,1610612746,LAC,1,20,2,4,0.5,0,0,0.0,0,0,0.0,2,2,4,2,0,0,1,5,4,7,2.0,0.0,2012,13,4.0,2.0,2,0,2,2.0
2012-13,Playoffs,202970,179,Gustavo Ayon,1610612749,MIL,3,7,2,4,0.5,0,0,0.0,0,0,0.0,0,0,0,0,0,0,0,0,4,2,0.0,0.0,2012,13,1.3333333333333333,,2,0,2,0.0
2012-13,Playoffs,200778,179,James White,1610612752,NYK,4,9,2,4,0.5,0,2,0.0,0,0,0.0,1,1,2,0,0,0,0,1,4,4,0.0,0.0,2012,13,1.0,,2,0,2,1.0
2012-13,Playoffs,201975,179,Jodie Meeks,1610612747,LAL,1,20,1,4,0.25,0,2,0.0,2,2,1.0,1,1,2,0,1,0,2,2,4,2,0.0,0.5,2012,13,4.0,0.0,3,0,3,0.6666666666666666
2012-13,Playoffs,201986,179,Nando De Colo,1610612759,SAS,5,14,1,4,0.25,0,3,0.0,2,2,1.0,2,2,4,2,0,0,0,1,4,7,0.0,0.0,2012,13,0.8,inf,3,0,3,1.3333333333333333
2012-13,Playoffs,201161,185,Daequan Cook,1610612741,CHI,6,36,1,10,0.1,1,8,0.125,0,0,0.0,0,3,3,4,1,0,4,6,3,-2,1.0,0.25,2012,13,0.5,1.0,9,0,9,0.3333333333333333
2012-13,Playoffs,202952,185,Malcolm Thomas,1610612741,CHI,3,6,1,2,0.5,0,0,0.0,1,5,0.2,4,0,4,0,0,0,0,0,3,2,0.0,0.0,2012,13,1.0,,1,4,5,0.8
2012-13,Playoffs,203159,185,Scott Machado,1610612744,GSW,5,8,1,2,0.5,0,0,0.0,1,2,0.5,0,1,1,1,0,0,1,1,3,2,1.0,0.0,2012,13,0.6,1.0,1,1,2,0.5
2012-13,Playoffs,201934,188,Hasheem Thabeet,1610612760,OKC,4,26,1,2,0.5,0,0,0.0,0,0,0.0,1,5,6,0,1,0,2,7,2,6,0.0,0.5,2012,13,0.5,0.0,1,0,1,6.0
2012-13,Playoffs,202341,188,James Anderson,1610612745,HOU,2,18,1,5,0.2,0,3,0.0,0,0,0.0,1,3,4,0,0,0,0,2,2,2,0.0,0.0,2012,13,1.0,,4,0,4,1.0
2012-13,Playoffs,202720,188,Jon Leuer,1610612763,MEM,5,11,1,2,0.5,0,0,0.0,0,0,0.0,2,1,3,0,1,1,0,1,2,6,0.0,0.0,2012,13,0.4,,1,0,1,3.0
2012-13,Playoffs,202933,188,Julyan Stone,1610612743,DEN,2,13,0,0,0.0,0,0,0.0,2,2,1.0,0,0,0,1,0,0,0,3,2,3,0.0,0.0,2012,13,1.0,inf,0,0,0,
2012-13,Playoffs,203145,188,Kent Bazemore,1610612744,GSW,9,16,1,8,0.125,0,1,0.0,0,4,0.0,1,4,5,2,1,0,2,3,2,-3,1.0,0.5,2012,13,0.2222222222222222,1.0,7,4,11,0.45454545454545453
2012-13,Playoffs,948,188,Marcus Camby,1610612752,NYK,3,3,1,1,1.0,0,0,0.0,0,0,0.0,1,1,2,0,0,0,1,1,2,3,0.0,0.0,2012,13,0.6666666666666666,0.0,0,0,0,inf
2012-13,Playoffs,2223,194,Samuel Dalembert,1610612749,MIL,1,9,0,2,0.0,0,0,0.0,1,4,0.25,1,2,3,0,1,0,2,3,1,-2,0.0,0.5,2012,13,1.0,0.0,2,3,5,0.6
2012-13,Playoffs,2740,195,Andris Biedrins,1610612744,GSW,3,17,0,0,0.0,0,0,0.0,0,0,0.0,2,5,7,1,0,2,1,6,0,9,1.0,0.0,2012,13,0.0,1.0,0,0,0,inf
2012-13,Playoffs,203162,195,Ben Hansbrough,1610612754,IND,6,22,0,5,0.0,0,3,0.0,0,0,0.0,1,2,3,3,0,1,2,2,0,0,1.5,0.0,2012,13,0.0,1.5,5,0,5,0.6
2012-13,Playoffs,2404,195,Chris Wilcox,1610612738,BOS,2,6,0,0,0.0,0,0,0.0,0,0,0.0,0,2,2,0,0,0,0,0,0,2,0.0,0.0,2012,13,0.0,,0,0,0,inf
2012-13,Playoffs,101204,195,Dwayne Jones,1610612744,GSW,2,2,0,0,0.0,0,0,0.0,0,0,0.0,0,0,0,0,0,0,0,0,0,0,0.0,0.0,2012,13,0.0,,0,0,0,
2012-13,Playoffs,202397,195,Ish Smith,1610612749,MIL,4,11,0,1,0.0,0,0,0.0,0,0,0.0,0,1,1,3,0,0,1,1,0,2,3.0,0.0,2012,13,0.0,3.0,1,0,1,1.0
2012-13,Playoffs,203098,195,John Jenkins,1610612737,ATL,4,24,0,3,0.0,0,1,0.0,0,0,0.0,0,2,2,3,0,0,2,2,0,0,1.5,0.0,2012,13,0.0,1.5,3,0,3,0.6666666666666666
2012-13,Playoffs,202706,195,Jordan Hamilton,1610612743,DEN,1,2,0,1,0.0,0,0,0.0,0,0,0.0,0,0,0,0,0,0,0,0,0,-1,0.0,0.0,2012,13,0.0,,1,0,1,0.0
2012-13,Playoffs,2586,195,Keith Bogans,1610612751,BKN,2,23,0,1,0.0,0,1,0.0,0,0,0.0,0,2,2,2,0,0,1,3,0,2,2.0,0.0,2012,13,0.0,2.0,1,0,1,2.0
2012-13,Playoffs,203141,195,Mirza Teletovic,1610612751,BKN,1,1,0,0,0.0,0,0,0.0,0,0,0.0,0,0,0,0,0,0,0,0,0,0,0.0,0.0,2012,13,0.0,,0,0,0,
2012-13,Playoffs,203103,195,Perry Jones III,1610612760,OKC,1,5,0,1,0.0,0,0,0.0,0,0,0.0,0,1,1,0,0,0,0,0,0,0,0.0,0.0,2012,13,0.0,,1,0,1,1.0
2012-13,Playoffs,203135,195,Robert Sacre,1610612747,LAL,2,4,0,1,0.0,0,0,0.0,0,0,0.0,0,2,2,0,1,0,0,0,0,2,0.0,0.0,2012,13,0.0,,1,0,1,2.0
2012-13,Playoffs,200758,195,Ronnie Brewer,1610612760,OKC,1,8,0,0,0.0,0,0,0.0,0,0,0.0,0,1,1,0,0,0,0,1,0,1,0.0,0.0,2012,13,0.0,,0,0,0,inf
2012-13,Playoffs,101183,195,Shavlik Randolph,1610612738,BOS,1,3,0,0,0.0,0,0,0.0,0,0,0.0,0,3,3,0,0,0,0,1,0,3,0.0,0.0,2012,13,0.0,,0,0,0,inf
2012-13,Playoffs,1503,195,Tracy McGrady,1610612759,SAS,6,31,0,7,0.0,0,3,0.0,0,0,0.0,1,7,8,7,2,3,2,1,0,11,3.5,1.0,2012,13,0.0,3.5,7,0,7,1.1428571428571428
2012-13,Playoffs,203116,195,Tyshawn Taylor,1610612751,BKN,2,2,0,1,0.0,0,0,0.0,0,0,0.0,0,0,0,0,0,0,0,0,0,-1,0.0,0.0,2012,13,0.0,,1,0,1,0.0
2013-14,RegularSeason,201142,1,Kevin Durant,1610612760,OKC,81,3122,849,1688,0.503,192,491,0.391,703,805,0.873,58,540,598,445,103,59,285,174,2593,2572,1.56,0.36,2013,14,32.01234567901235,1.5614035087719298,839,102,941,0.6354941551540914
2013-14,RegularSeason,2546,2,Carmelo Anthony,1610612752,NYK,77,2982,743,1643,0.452,167,415,0.402,459,541,0.848,145,477,622,242,95,51,198,224,2112,1942,1.22,0.48,2013,14,27.428571428571427,1.2222222222222223,900,82,982,0.6334012219959266
2013-14,RegularSeason,2544,3,LeBron James,1610612748,MIA,77,2902,767,1353,0.567,116,306,0.379,439,585,0.75,81,452,533,488,121,26,270,126,2089,2255,1.81,0.45,2013,14,27.12987012987013,1.8074074074074074,586,146,732,0.7281420765027322
2013-14,RegularSeason,201567,4,Kevin Love,1610612750,MIN,77,2797,650,1421,0.457,190,505,0.376,520,633,0.821,224,739,963,341,59,35,196,136,2010,2328,1.74,0.3,2013,14,26.103896103896105,1.739795918367347,771,113,884,1.089366515837104
2013-14,RegularSeason,201933,5,Blake Griffin,1610612746,LAC,80,2863,718,1359,0.528,12,44,0.273,482,674,0.715,192,565,757,309,92,51,224,265,1930,2082,1.38,0.41,2013,14,24.125,1.3794642857142858,641,192,833,0.9087635054021609
2013-14,RegularSeason,201939,6,Stephen Curry,1610612744,GSW,78,2846,652,1383,0.471,261,615,0.424,308,348,0.885,46,288,334,666,128,14,294,194,1873,1950,2.27,0.43,2013,14,24.012820512820515,2.2653061224489797,731,40,771,0.43320363164721143
2013-14,RegularSeason,201935,7,James Harden,1610612745,HOU,73,2777,549,1205,0.456,177,483,0.366,576,665,0.866,61,283,344,446,115,29,265,177,1851,1775,1.68,0.43,2013,14,25.356164383561644,1.6830188679245284,656,89,745,0.46174496644295304
2013-14,RegularSeason,201942,8,DeMar DeRozan,1610612761,TOR,79,3017,604,1407,0.429,64,210,0.305,519,630,0.824,51,292,343,313,86,28,176,197,1791,1471,1.78,0.49,2013,14,22.670886075949365,1.7784090909090908,803,111,914,0.37527352297593
2013-14,RegularSeason,202331,9,Paul George,1610612754,IND,80,2898,577,1362,0.424,182,500,0.364,401,464,0.864,64,478,542,283,151,22,224,198,1737,1663,1.26,0.67,2013,14,21.7125,1.2633928571428572,785,63,848,0.6391509433962265
2013-14,RegularSeason,1717,10,Dirk Nowitzki,1610612742,DAL,80,2628,633,1273,0.497,131,329,0.398,338,376,0.899,40,458,498,216,73,45,117,165,1735,1772,1.85,0.62,2013,14,21.6875,1.8461538461538463,640,38,678,0.7345132743362832
2013-14,RegularSeason,203081,11,Damian Lillard,1610612757,POR,82,2937,553,1304,0.424,218,554,0.394,371,426,0.871,35,253,288,457,64,22,193,197,1695,1527,2.37,0.33,2013,14,20.670731707317074,2.3678756476683938,751,55,806,0.3573200992555831
2013-14,RegularSeason,202326,12,DeMarcus Cousins,1610612758,SAC,71,2298,591,1191,0.496,0,7,0.0,432,595,0.726,218,613,831,207,109,91,251,270,1614,1838,0.82,0.43,2013,14,22.732394366197184,0.8247011952191236,600,163,763,1.089121887287025
2013-14,RegularSeason,200746,13,LaMarcus Aldridge,1610612757,POR,69,2499,652,1423,0.458,3,15,0.2,296,360,0.822,166,599,765,178,63,68,123,147,1603,1719,1.45,0.51,2013,14,23.231884057971016,1.4471544715447155,771,64,835,0.9161676646706587
2013-14,RegularSeason,2744,14,Al Jefferson,1610612766,CHA,73,2553,700,1376,0.509,3,15,0.2,191,277,0.69,156,636,792,155,67,79,124,176,1594,1801,1.25,0.54,2013,14,21.835616438356166,1.25,676,86,762,1.0393700787401574
2013-14,RegularSeason,202322,15,John Wall,1610612764,WAS,82,2980,579,1337,0.433,108,308,0.351,317,394,0.805,38,295,333,721,149,40,295,219,1583,1696,2.44,0.51,2013,14,19.304878048780488,2.4440677966101694,758,77,835,0.39880239520958083
2013-14,RegularSeason,101145,16,Monta Ellis,1610612742,DAL,82,3023,576,1278,0.451,69,209,0.33,339,430,0.788,38,257,295,471,141,23,264,197,1560,1433,1.78,0.53,2013,14,19.024390243902438,1.7840909090909092,702,91,793,0.3720050441361917
2013-14,RegularSeason,201609,17,Goran Dragic,1610612756,PHX,76,2668,552,1093,0.505,122,299,0.408,316,416,0.76,69,176,245,447,104,22,213,206,1542,1506,2.1,0.49,2013,14,20.289473684210527,2.0985915492957745,541,100,641,0.38221528861154447
2013-14,RegularSeason,202691,18,Klay Thompson,1610612744,GSW,81,2868,559,1259,0.444,223,535,0.417,147,185,0.795,38,211,249,181,74,37,135,234,1488,1156,1.34,0.55,2013,14,18.37037037037037,1.3407407407407408,700,38,738,0.33739837398373984
2013-14,RegularSeason,202681,19,Kyrie Irving,1610612739,CLE,71,2496,532,1237,0.43,123,344,0.358,291,338,0.861,52,207,259,433,108,23,190,163,1478,1359,2.28,0.57,2013,14,20.816901408450704,2.278947368421053,705,47,752,0.34441489361702127
2013-14,RegularSeason,202738,20,Isaiah Thomas,1610612758,SAC,72,2497,496,1096,0.453,127,364,0.349,346,407,0.85,47,163,210,454,93,8,213,185,1465,1356,2.13,0.44,2013,14,20.34722222222222,2.131455399061033,600,61,661,0.3177004538577912
2013-14,RegularSeason,200752,21,Rudy Gay,1610612758,SAC,73,2531,537,1179,0.455,65,197,0.33,318,387,0.822,113,324,437,209,95,56,224,171,1457,1319,0.93,0.42,2013,14,19.958904109589042,0.9330357142857143,642,69,711,0.6146272855133614
2013-14,RegularSeason,200768,22,Kyle Lowry,1610612761,TOR,79,2862,457,1080,0.423,190,500,0.38,313,385,0.813,88,281,369,586,121,15,194,267,1417,1619,3.02,0.62,2013,14,17.936708860759495,3.020618556701031,623,72,695,0.5309352517985612
2013-14,RegularSeason,201152,22,Thaddeus Young,1610612755,PHI,79,2718,582,1283,0.454,90,292,0.308,163,229,0.712,166,310,476,182,167,36,165,213,1417,1346,1.1,1.01,2013,14,17.936708860759495,1.103030303030303,701,66,767,0.6205997392438071
2013-14,RegularSeason,203076,24,Anthony Davis,1610612740,NOP,67,2358,522,1005,0.519,2,9,0.222,348,440,0.791,207,466,673,105,89,189,109,200,1394,1766,0.96,0.82,2013,14,20.80597014925373,0.963302752293578,483,92,575,1.1704347826086956
2013-14,RegularSeason,201145,25,Jeff Green,1610612738,BOS,82,2805,482,1171,0.412,135,396,0.341,283,356,0.795,54,326,380,138,57,47,165,180,1382,1077,0.84,0.34,2013,14,16.853658536585368,0.8363636363636363,689,73,762,0.49868766404199477
2013-14,RegularSeason,2216,26,Zach Randolph,1610612763,MEM,79,2705,560,1198,0.467,2,20,0.1,250,337,0.742,265,530,795,200,54,23,183,210,1372,1536,1.09,0.29,2013,14,17.367088607594937,1.092896174863388,638,87,725,1.096551724137931
2013-14,RegularSeason,202083,27,Wesley Matthews,1610612757,POR,82,2780,445,1009,0.441,201,511,0.393,252,301,0.837,51,238,289,197,76,14,110,176,1343,1196,1.79,0.69,2013,14,16.378048780487806,1.790909090909091,564,49,613,0.47145187601957583
2013-14,RegularSeason,201167,28,Arron Afflalo,1610612753,ORL,73,2552,464,1011,0.459,128,300,0.427,274,336,0.815,32,230,262,248,35,3,146,136,1330,1123,1.7,0.24,2013,14,18.21917808219178,1.6986301369863013,547,62,609,0.4302134646962233
2013-14,RegularSeason,200794,29,Paul Millsap,1610612737,ATL,74,2482,483,1047,0.461,76,212,0.358,286,391,0.731,154,473,627,232,129,78,185,210,1328,1540,1.25,0.7,2013,14,17.945945945945947,1.2540540540540541,564,105,669,0.9372197309417041
2013-14,RegularSeason,201952,30,Jeff Teague,1610612737,ATL,79,2542,456,1040,0.438,74,225,0.329,318,376,0.846,34,174,208,528,89,17,232,158,1304,1272,2.28,0.38,2013,14,16.50632911392405,2.2758620689655173,584,58,642,0.32398753894080995
2013-14,RegularSeason,2755,31,Kevin Martin,1610612750,MIN,68,2177,440,1023,0.43,115,297,0.387,303,340,0.891,34,169,203,121,66,6,106,123,1298,968,1.14,0.62,2013,14,19.08823529411765,1.1415094339622642,583,37,620,0.32741935483870965
2013-14,RegularSeason,2730,32,Dwight Howard,1610612745,HOU,71,2396,473,800,0.591,2,7,0.286,349,638,0.547,231,635,866,131,60,128,229,240,1297,1637,0.57,0.26,2013,14,18.267605633802816,0.5720524017467249,327,289,616,1.405844155844156
2013-14,RegularSeason,101123,33,Gerald Green,1610612756,PHX,82,2330,448,1006,0.445,204,510,0.4,195,230,0.848,48,227,275,122,70,42,145,220,1295,1066,0.84,0.48,2013,14,15.792682926829269,0.8413793103448276,558,35,593,0.463743676222597
2013-14,RegularSeason,202688,34,Brandon Knight,1610612749,MIL,72,2400,461,1092,0.422,110,338,0.325,259,323,0.802,46,209,255,352,69,17,188,146,1291,1101,1.87,0.37,2013,14,17.930555555555557,1.872340425531915,631,64,695,0.3669064748201439
2013-14,RegularSeason,202689,35,Kemba Walker,1610612766,CHA,73,2614,449,1143,0.393,109,327,0.333,282,337,0.837,39,267,306,447,86,32,169,128,1289,1242,2.65,0.51,2013,14,17.65753424657534,2.6449704142011834,694,55,749,0.40854472630173566
2013-14,RegularSeason,2037,36,Jamal Crawford,1610612746,LAC,69,2094,421,1011,0.416,161,446,0.361,279,322,0.866,34,124,158,223,59,12,135,120,1282,966,1.65,0.44,2013,14,18.579710144927535,1.651851851851852,590,43,633,0.24960505529225907
2013-14,RegularSeason,2547,37,Chris Bosh,1610612748,MIA,79,2531,492,953,0.516,74,218,0.339,223,272,0.82,98,424,522,87,80,78,125,192,1281,1413,0.7,0.64,2013,14,16.21518987341772,0.696,461,49,510,1.0235294117647058
2013-14,RegularSeason,2746,38,Josh Smith,1610612765,DET,77,2730,517,1233,0.419,70,265,0.264,160,301,0.532,102,418,520,252,105,110,199,197,1264,1195,1.27,0.53,2013,14,16.415584415584416,1.2663316582914572,716,141,857,0.6067677946324388
2013-14,RegularSeason,101135,39,David Lee,1610612744,GSW,69,2288,513,981,0.523,0,1,0.0,231,296,0.78,182,461,643,147,48,26,152,206,1257,1436,0.97,0.32,2013,14,18.217391304347824,0.9671052631578947,468,65,533,1.2063789868667918
2013-14,RegularSeason,201144,40,Mike Conley,1610612763,MEM,73,2446,463,1030,0.45,105,291,0.361,225,276,0.815,41,172,213,441,110,13,150,141,1256,1265,2.94,0.73,2013,14,17.205479452054796,2.94,567,51,618,0.3446601941747573
2013-14,RegularSeason,203078,41,Bradley Beal,1610612764,WAS,73,2530,481,1149,0.419,138,343,0.402,149,189,0.788,54,219,273,243,71,18,128,153,1249,1018,1.9,0.56,2013,14,17.10958904109589,1.8984375,668,40,708,0.3855932203389831
2013-14,RegularSeason,202328,41,Greg Monroe,1610612765,DET,82,2690,504,1015,0.497,0,1,0.0,241,367,0.657,256,504,760,171,91,47,166,205,1249,1515,1.03,0.55,2013,14,15.231707317073171,1.0301204819277108,511,126,637,1.1930926216640503
2013-14,RegularSeason,202330,43,Gordon Hayward,1610612762,UTA,77,2800,426,1032,0.413,85,280,0.304,311,381,0.816,62,329,391,400,110,40,212,155,1248,1301,1.89,0.52,2013,14,16.207792207792206,1.8867924528301887,606,70,676,0.5784023668639053
2013-14,RegularSeason,2207,44,Joe Johnson,1610612751,BKN,79,2575,462,1018,0.454,162,404,0.401,159,195,0.815,48,222,270,216,47,10,120,129,1245,1076,1.8,0.39,2013,14,15.759493670886076,1.8,556,36,592,0.4560810810810811
2013-14,RegularSeason,201943,45,Brandon Jennings,1610612765,DET,80,2728,423,1135,0.373,154,457,0.337,241,321,0.751,59,185,244,609,101,8,215,157,1241,1196,2.83,0.47,2013,14,15.5125,2.832558139534884,712,80,792,0.30808080808080807
2013-14,RegularSeason,201586,46,Serge Ibaka,1610612760,OKC,81,2666,524,978,0.536,23,60,0.383,156,199,0.784,224,485,709,85,39,219,123,233,1227,1659,0.69,0.32,2013,14,15.148148148148149,0.6910569105691057,454,43,497,1.4265593561368208
2013-14,RegularSeason,202718,47,Chandler Parsons,1610612745,HOU,74,2783,466,987,0.472,130,351,0.37,164,221,0.742,69,340,409,298,88,29,144,168,1226,1328,2.07,0.61,2013,14,16.56756756756757,2.0694444444444446,521,57,578,0.7076124567474048
2013-14,RegularSeason,201975,48,Jodie Meeks,1610612747,LAL,77,2556,413,892,0.463,162,404,0.401,221,258,0.857,30,164,194,138,111,4,111,119,1209,1029,1.24,1.0,2013,14,15.7012987012987,1.2432432432432432,479,37,516,0.375968992248062
2013-14,RegularSeason,101108,49,Chris Paul,1610612746,LAC,62,2171,406,870,0.467,78,212,0.368,295,345,0.855,38,230,268,663,154,4,145,157,1185,1615,4.57,1.06,2013,14,19.112903225806452,4.572413793103448,464,50,514,0.5214007782101168
2013-14,RegularSeason,203487,50,Michael Carter-Williams,1610612755,PHI,70,2414,427,1054,0.405,55,208,0.264,258,367,0.703,101,336,437,441,130,43,247,213,1167,1235,1.78,0.53,2013,14,16.67142857142857,1.785425101214575,627,109,736,0.59375
2013-14,RegularSeason,201156,51,Nick Young,1610612747,LAL,64,1810,387,889,0.435,135,350,0.386,235,285,0.825,29,137,166,95,46,12,95,156,1144,816,1.0,0.48,2013,14,17.875,1.0,502,50,552,0.3007246376811594
2013-14,RegularSeason,2225,52,Tony Parker,1610612759,SAS,68,1997,456,914,0.499,25,67,0.373,197,243,0.811,17,138,155,388,36,9,151,86,1134,1067,2.57,0.24,2013,14,16.676470588235293,2.5695364238410594,458,46,504,0.30753968253968256
2013-14,RegularSeason,202323,53,Evan Turner,1610612754,IND,81,2457,434,1021,0.425,50,156,0.321,213,262,0.813,62,346,408,262,67,7,189,195,1131,1050,1.39,0.35,2013,14,13.962962962962964,1.3862433862433863,587,49,636,0.6415094339622641
2013-14,RegularSeason,1495,54,Tim Duncan,1610612759,SAS,74,2158,444,906,0.49,0,5,0.0,231,316,0.731,158,563,721,220,43,139,159,134,1119,1536,1.38,0.27,2013,14,15.121621621621621,1.3836477987421383,462,85,547,1.3180987202925045
2013-14,RegularSeason,2561,55,David West,1610612754,IND,80,2472,458,939,0.488,4,15,0.267,198,251,0.789,120,422,542,223,61,74,133,186,1118,1351,1.68,0.46,2013,14,13.975,1.6766917293233083,481,53,534,1.0149812734082397
2013-14,RegularSeason,202693,56,Markieff Morris,1610612756,PHX,81,2153,411,845,0.486,34,108,0.315,259,327,0.792,139,346,485,144,68,51,147,232,1115,1214,0.98,0.46,2013,14,13.765432098765432,0.9795918367346939,434,68,502,0.9661354581673307
2013-14,RegularSeason,203079,57,Dion Waiters,1610612739,CLE,70,2072,430,993,0.433,92,250,0.368,161,235,0.685,32,163,195,209,63,17,154,153,1113,806,1.36,0.41,2013,14,15.9,1.3571428571428572,563,74,637,0.30612244897959184
2013-14,RegularSeason,2772,58,Trevor Ariza,1610612764,WAS,77,2723,389,853,0.456,180,442,0.407,149,193,0.772,99,376,475,191,126,20,132,179,1107,1279,1.45,0.95,2013,14,14.376623376623376,1.446969696969697,464,44,508,0.9350393700787402
2013-14,RegularSeason,203506,59,Victor Oladipo,1610612753,ORL,80,2487,392,936,0.419,74,226,0.327,248,318,0.78,43,286,329,327,129,37,256,210,1106,1058,1.28,0.5,2013,14,13.825,1.27734375,544,70,614,0.5358306188925082
2013-14,RegularSeason,202702,60,Kenneth Faried,1610612743,DEN,80,2178,447,820,0.545,0,3,0.0,202,311,0.65,238,446,684,96,70,69,135,193,1096,1398,0.71,0.52,2013,14,13.7,0.7111111111111111,373,109,482,1.4190871369294606
2013-14,RegularSeason,203083,61,Andre Drummond,1610612765,DET,81,2619,479,769,0.623,0,2,0.0,137,328,0.418,440,631,1071,35,101,131,110,273,1095,1842,0.32,0.92,2013,14,13.518518518518519,0.3181818181818182,290,191,481,2.226611226611227
2013-14,RegularSeason,201951,62,Ty Lawson,1610612743,DEN,62,2222,347,806,0.431,72,202,0.356,324,406,0.798,40,175,215,543,100,10,200,113,1090,1217,2.71,0.5,2013,14,17.580645161290324,2.715,459,82,541,0.3974121996303142
2013-14,RegularSeason,202692,63,Alec Burks,1610612762,UTA,78,2193,380,831,0.457,50,143,0.35,279,373,0.748,59,198,257,212,69,14,149,190,1089,947,1.42,0.46,2013,14,13.961538461538462,1.4228187919463087,451,94,545,0.47155963302752296
2013-14,RegularSeason,201945,64,Gerald Henderson,1610612766,CHA,77,2461,403,930,0.433,40,115,0.348,235,309,0.761,31,279,310,199,51,32,113,159,1081,959,1.76,0.45,2013,14,14.03896103896104,1.761061946902655,527,74,601,0.5158069883527454
2013-14,RegularSeason,202362,65,Lance Stephenson,1610612754,IND,78,2752,427,870,0.491,86,244,0.352,140,197,0.711,95,463,558,359,54,7,210,195,1080,1348,1.71,0.26,2013,14,13.846153846153847,1.7095238095238094,443,57,500,1.116
2013-14,RegularSeason,2747,66,JR Smith,1610612752,NYK,74,2421,396,955,0.415,189,480,0.394,90,138,0.652,35,261,296,219,65,20,108,196,1071,956,2.03,0.6,2013,14,14.472972972972974,2.0277777777777777,559,48,607,0.4876441515650741
2013-14,RegularSeason,201587,67,Nicolas Batum,1610612757,POR,82,2956,381,819,0.465,145,402,0.361,163,203,0.803,116,495,611,420,75,57,208,156,1070,1547,2.02,0.36,2013,14,13.048780487804878,2.019230769230769,438,40,478,1.2782426778242677
2013-14,RegularSeason,201959,68,Taj Gibson,1610612741,CHI,82,2351,429,896,0.479,0,7,0.0,211,281,0.751,200,358,558,91,41,112,150,207,1069,1184,0.61,0.27,2013,14,13.036585365853659,0.6066666666666667,467,70,537,1.0391061452513966
2013-14,RegularSeason,101162,69,Marcin Gortat,1610612764,WAS,81,2655,455,840,0.542,1,1,1.0,157,229,0.686,202,565,767,138,41,121,126,201,1068,1552,1.09,0.33,2013,14,13.185185185185185,1.0952380952380953,385,72,457,1.6783369803063457
2013-14,RegularSeason,200751,69,Randy Foye,1610612743,DEN,81,2485,361,875,0.413,189,498,0.38,157,185,0.849,36,196,232,287,67,39,145,205,1068,1006,1.98,0.46,2013,14,13.185185185185185,1.9793103448275862,514,28,542,0.4280442804428044
2013-14,RegularSeason,201150,71,Spencer Hawes,1610612739,CLE,80,2470,403,883,0.456,128,308,0.416,119,152,0.783,131,529,660,240,44,94,173,237,1053,1405,1.39,0.25,2013,14,13.1625,1.3872832369942196,480,33,513,1.286549707602339
2013-14,RegularSeason,202704,72,Reggie Jackson,1610612760,OKC,80,2277,403,916,0.44,83,245,0.339,158,177,0.893,43,270,313,331,85,9,168,142,1047,1085,1.97,0.51,2013,14,13.0875,1.9702380952380953,513,19,532,0.5883458646616542
2013-14,RegularSeason,2430,73,Carlos Boozer,1610612741,CHI,76,2141,447,980,0.456,0,2,0.0,148,193,0.767,137,495,632,118,53,22,154,216,1042,1135,0.77,0.34,2013,14,13.710526315789474,0.7662337662337663,533,45,578,1.0934256055363323
2013-14,RegularSeason,201936,73,Tyreke Evans,1610612740,NOP,72,2028,391,897,0.436,21,95,0.221,239,310,0.771,76,265,341,363,84,21,175,155,1042,1099,2.07,0.48,2013,14,14.472222222222221,2.0742857142857143,506,71,577,0.5909878682842288
2013-14,RegularSeason,2200,75,Pau Gasol,1610612747,LAL,60,1884,425,885,0.48,4,14,0.286,187,254,0.736,124,456,580,201,27,92,141,124,1041,1273,1.43,0.19,2013,14,17.35,1.425531914893617,460,67,527,1.1005692599620494
2013-14,RegularSeason,2548,76,Dwyane Wade,1610612748,MIA,54,1775,415,761,0.545,9,32,0.281,189,258,0.733,60,181,241,252,79,29,161,106,1028,1053,1.56,0.49,2013,14,19.037037037037038,1.565217391304348,346,69,415,0.5807228915662651
2013-14,RegularSeason,201196,77,Ramon Sessions,1610612749,MIL,83,2214,330,769,0.429,35,124,0.282,326,404,0.807,38,165,203,340,49,9,148,90,1021,957,2.3,0.33,2013,14,12.301204819277109,2.2972972972972974,439,78,517,0.39264990328820115
2013-14,RegularSeason,201155,78,Rodney Stuckey,1610612765,DET,73,1950,372,853,0.436,24,88,0.273,244,292,0.836,39,130,169,152,54,10,125,131,1012,743,1.22,0.43,2013,14,13.863013698630137,1.216,481,48,529,0.31947069943289225
2013-14,RegularSeason,2736,79,Luol Deng,1610612739,CLE,63,2213,371,860,0.431,57,189,0.302,212,268,0.791,99,262,361,183,62,9,114,111,1011,967,1.6,0.54,2013,14,16.047619047619047,1.605263157894737,489,56,545,0.6623853211009174
2013-14,RegularSeason,1718,80,Paul Pierce,1610612751,BKN,75,2098,321,712,0.451,112,300,0.373,256,310,0.826,26,322,348,178,86,31,153,190,1010,1055,1.16,0.56,2013,14,13.466666666666667,1.1633986928104576,391,54,445,0.7820224719101123
2013-14,RegularSeason,201149,81,Joakim Noah,1610612741,CHI,80,2820,380,800,0.475,0,2,0.0,247,335,0.737,282,618,900,431,99,121,194,245,1007,1856,2.22,0.51,2013,14,12.5875,2.2216494845360826,420,88,508,1.7716535433070866
2013-14,RegularSeason,201566,82,Russell Westbrook,1610612760,OKC,46,1412,346,791,0.437,68,214,0.318,242,293,0.826,55,208,263,319,88,7,177,104,1002,1006,1.8,0.5,2013,14,21.782608695652176,1.8022598870056497,445,51,496,0.530241935483871
2013-14,RegularSeason,201147,83,Corey Brewer,1610612750,MIN,81,2609,388,807,0.481,59,211,0.28,163,227,0.718,63,144,207,135,151,30,105,210,998,933,1.29,1.44,2013,14,12.320987654320987,1.2857142857142858,419,64,483,0.42857142857142855
2013-14,RegularSeason,203114,84,Khris Middleton,1610612749,MIL,82,2460,376,854,0.44,120,290,0.414,118,137,0.861,60,250,310,169,83,20,123,243,990,952,1.37,0.68,2013,14,12.073170731707316,1.3739837398373984,478,19,497,0.6237424547283702
2013-14,RegularSeason,201569,85,Eric Gordon,1610612740,NOP,64,2057,356,817,0.436,101,258,0.391,175,223,0.785,30,135,165,208,74,12,134,114,988,804,1.55,0.55,2013,14,15.4375,1.5522388059701493,461,48,509,0.3241650294695481
2013-14,RegularSeason,202683,86,Enes Freedom,1610612762,UTA,80,2138,419,853,0.491,0,1,0.0,149,204,0.73,222,376,598,75,28,42,144,230,987,1097,0.52,0.19,2013,14,12.3375,0.5208333333333334,434,55,489,1.2229038854805725
2013-14,RegularSeason,203096,87,Jared Sullinger,1610612738,BOS,74,2041,384,899,0.427,56,208,0.269,158,203,0.778,241,360,601,118,35,49,119,251,982,1106,0.99,0.29,2013,14,13.27027027027027,0.9915966386554622,515,45,560,1.0732142857142857
2013-14,RegularSeason,202324,88,Derrick Favors,1610612762,UTA,73,2201,390,747,0.522,0,1,0.0,190,284,0.669,199,438,637,91,75,108,129,236,970,1301,0.7,0.58,2013,14,13.287671232876713,0.7054263565891473,357,94,451,1.4124168514412416
2013-14,RegularSeason,1713,89,Vince Carter,1610612742,DAL,81,1973,330,811,0.407,146,371,0.394,161,196,0.821,67,217,284,212,61,35,108,209,967,935,1.96,0.56,2013,14,11.938271604938272,1.962962962962963,481,35,516,0.5503875968992248
2013-14,RegularSeason,202684,90,Tristan Thompson,1610612739,CLE,82,2594,363,761,0.477,0,1,0.0,235,339,0.693,269,485,754,72,42,35,108,188,961,1254,0.67,0.39,2013,14,11.71951219512195,0.6666666666666666,398,104,502,1.50199203187251
2013-14,RegularSeason,201593,91,Nikola Pekovic,1610612750,MIN,54,1663,379,701,0.541,0,0,0.0,186,249,0.747,206,262,468,50,30,23,84,129,944,1046,0.59,0.36,2013,14,17.48148148148148,0.5952380952380952,322,63,385,1.2155844155844155
2013-14,RegularSeason,203100,92,Tony Wroten,1610612755,PHI,72,1765,345,808,0.427,40,188,0.213,209,326,0.641,69,159,228,217,78,16,204,151,939,694,1.06,0.38,2013,14,13.041666666666666,1.0637254901960784,463,117,580,0.3931034482758621
2013-14,RegularSeason,201571,93,D.J. Augustin,1610612741,CHI,71,1939,298,718,0.415,133,332,0.401,201,227,0.885,15,115,130,313,53,3,125,147,930,858,2.5,0.42,2013,14,13.098591549295774,2.504,420,26,446,0.2914798206278027
2013-14,RegularSeason,2399,94,Mike Dunleavy,1610612741,CHI,82,2584,333,774,0.43,123,324,0.38,140,164,0.854,46,299,345,186,64,46,108,163,929,997,1.72,0.59,2013,14,11.329268292682928,1.7222222222222223,441,24,465,0.7419354838709677
2013-14,RegularSeason,101181,95,Jose Calderon,1610612742,DAL,81,2468,341,748,0.456,191,425,0.449,52,63,0.825,29,163,192,377,69,11,103,136,925,1053,3.66,0.67,2013,14,11.419753086419753,3.6601941747572817,407,11,418,0.45933014354066987
2013-14,RegularSeason,203093,96,Terrence Jones,1610612745,HOU,76,2078,386,712,0.542,31,101,0.307,118,195,0.605,162,366,528,87,53,99,71,139,921,1214,1.23,0.75,2013,14,12.118421052631579,1.2253521126760563,326,77,403,1.3101736972704714
2013-14,RegularSeason,202685,97,Jonas Valanciunas,1610612761,TOR,81,2282,359,676,0.531,0,1,0.0,198,260,0.762,226,488,714,57,24,71,136,249,916,1267,0.42,0.18,2013,14,11.308641975308642,0.41911764705882354,317,62,379,1.883905013192612
2013-14,RegularSeason,101114,98,Deron Williams,1610612751,BKN,64,2059,322,716,0.45,98,268,0.366,173,216,0.801,15,153,168,392,93,13,143,148,915,1001,2.74,0.65,2013,14,14.296875,2.7412587412587412,394,43,437,0.38443935926773454
2013-14,RegularSeason,101138,99,Brandon Bass,1610612738,BOS,82,2266,352,725,0.486,2,6,0.333,205,239,0.858,161,309,470,87,36,71,102,190,911,1066,0.85,0.35,2013,14,11.109756097560975,0.8529411764705882,373,34,407,1.1547911547911547
2013-14,RegularSeason,201954,99,Darren Collison,1610612746,LAC,80,2069,324,694,0.467,71,189,0.376,192,224,0.857,47,141,188,297,93,15,132,150,911,970,2.25,0.7,2013,14,11.3875,2.25,370,32,402,0.46766169154228854
2013-14,RegularSeason,201158,99,Marco Belinelli,1610612759,SAS,80,2016,337,695,0.485,126,293,0.43,111,131,0.847,18,208,226,179,50,7,95,130,911,900,1.88,0.53,2013,14,11.3875,1.8842105263157896,358,20,378,0.5978835978835979
2013-14,RegularSeason,101112,102,Channing Frye,1610612756,PHX,82,2312,336,778,0.432,160,432,0.37,78,95,0.821,73,343,416,98,60,63,89,245,910,999,1.1,0.67,2013,14,11.097560975609756,1.101123595505618,442,17,459,0.906318082788671
2013-14,RegularSeason,201577,103,Robin Lopez,1610612757,POR,82,2604,355,644,0.551,0,1,0.0,198,242,0.818,326,374,700,73,25,139,84,196,908,1428,0.87,0.3,2013,14,11.073170731707316,0.8690476190476191,289,44,333,2.1021021021021022
2013-14,RegularSeason,203504,104,Trey Burke,1610612762,UTA,70,2262,341,897,0.38,111,336,0.33,102,113,0.903,37,171,208,396,42,6,131,145,895,849,3.02,0.32,2013,14,12.785714285714286,3.0229007633587788,556,11,567,0.36684303350970016
2013-14,RegularSeason,202699,105,Tobias Harris,1610612753,ORL,61,1850,332,716,0.464,32,126,0.254,197,244,0.807,88,336,424,82,41,24,78,143,893,955,1.05,0.53,2013,14,14.639344262295081,1.0512820512820513,384,47,431,0.9837587006960556
2013-14,RegularSeason,202340,106,Avery Bradley,1610612738,BOS,60,1855,361,825,0.438,79,200,0.395,90,112,0.804,48,178,226,85,63,11,96,145,891,694,0.89,0.66,2013,14,14.85,0.8854166666666666,464,22,486,0.46502057613168724
2013-14,RegularSeason,202391,107,Jeremy Lin,1610612745,HOU,71,2054,295,662,0.446,82,229,0.358,218,265,0.823,34,153,187,294,68,27,176,166,890,876,1.67,0.39,2013,14,12.535211267605634,1.6704545454545454,367,47,414,0.45169082125603865
2013-14,RegularSeason,202348,107,Jordan Crawford,1610612744,GSW,81,1860,327,788,0.415,90,285,0.316,146,169,0.864,28,155,183,281,47,5,134,120,890,788,2.1,0.35,2013,14,10.987654320987655,2.0970149253731343,461,23,484,0.378099173553719
2013-14,RegularSeason,203082,109,Terrence Ross,1610612761,TOR,81,2159,318,751,0.423,161,408,0.395,82,98,0.837,43,209,252,79,64,27,88,183,879,764,0.9,0.73,2013,14,10.851851851851851,0.8977272727272727,433,16,449,0.5612472160356348
2013-14,RegularSeason,202710,110,Jimmy Butler,1610612741,CHI,67,2591,275,693,0.397,68,240,0.283,260,338,0.769,87,243,330,175,127,36,102,106,878,948,1.72,1.25,2013,14,13.104477611940299,1.7156862745098038,418,78,496,0.6653225806451613
2013-14,RegularSeason,201579,111,Roy Hibbert,1610612754,IND,81,2409,331,754,0.439,2,5,0.4,207,269,0.77,202,336,538,91,29,182,148,269,871,1078,0.61,0.2,2013,14,10.753086419753087,0.6148648648648649,423,62,485,1.109278350515464
2013-14,RegularSeason,201188,112,Marc Gasol,1610612763,MEM,59,1970,336,711,0.473,2,11,0.182,185,241,0.768,84,340,424,215,59,76,111,150,859,1091,1.94,0.53,2013,14,14.559322033898304,1.936936936936937,375,56,431,0.9837587006960556
2013-14,RegularSeason,201599,113,DeAndre Jordan,1610612746,LAC,82,2870,348,515,0.676,0,0,0.0,160,374,0.428,331,783,1114,74,80,203,123,264,856,1823,0.6,0.65,2013,14,10.439024390243903,0.6016260162601627,167,214,381,2.9238845144356955
2013-14,RegularSeason,2594,114,Kyle Korver,1610612737,ATL,71,2408,289,609,0.475,185,392,0.472,87,94,0.926,22,260,282,208,70,24,102,147,850,1005,2.04,0.69,2013,14,11.971830985915492,2.0392156862745097,320,7,327,0.8623853211009175
2013-14,RegularSeason,201163,115,Wilson Chandler,1610612743,DEN,62,1927,307,738,0.416,122,351,0.348,110,152,0.724,58,236,294,114,46,31,79,193,846,779,1.44,0.58,2013,14,13.64516129032258,1.4430379746835442,431,42,473,0.6215644820295984
2013-14,RegularSeason,202695,116,Kawhi Leonard,1610612759,SAS,66,1923,337,645,0.522,69,182,0.379,101,126,0.802,76,336,412,133,114,50,80,127,844,1140,1.66,1.43,2013,14,12.787878787878787,1.6625,308,25,333,1.2372372372372373
2013-14,RegularSeason,1938,117,Manu Ginobili,1610612759,SAS,68,1550,294,627,0.469,90,258,0.349,160,188,0.851,30,172,202,293,70,17,139,128,838,920,2.11,0.5,2013,14,12.323529411764707,2.1079136690647484,333,28,361,0.5595567867036011
2013-14,RegularSeason,2210,118,Richard Jefferson,1610612762,UTA,82,2213,294,654,0.45,123,301,0.409,120,162,0.741,18,201,219,130,56,14,94,168,831,754,1.38,0.6,2013,14,10.134146341463415,1.3829787234042554,360,42,402,0.5447761194029851
2013-14,RegularSeason,201988,119,Patty Mills,1610612759,SAS,81,1527,309,666,0.464,135,318,0.425,73,82,0.89,34,135,169,149,68,9,63,114,826,792,2.37,1.08,2013,14,10.197530864197532,2.365079365079365,357,9,366,0.46174863387978143
2013-14,RegularSeason,203501,120,Tim Hardaway Jr.,1610612752,NYK,81,1875,294,687,0.428,130,358,0.363,106,128,0.828,19,102,121,66,44,7,47,144,824,600,1.4,0.94,2013,14,10.17283950617284,1.4042553191489362,393,22,415,0.29156626506024097
2013-14,RegularSeason,101154,121,Andray Blatche,1610612751,BKN,73,1618,321,674,0.476,15,54,0.278,164,221,0.742,120,270,390,112,75,38,110,166,821,916,1.02,0.68,2013,14,11.246575342465754,1.018181818181818,353,57,410,0.9512195121951219
2013-14,RegularSeason,2749,122,Jameer Nelson,1610612753,ORL,68,2179,294,747,0.394,136,391,0.348,96,112,0.857,29,202,231,476,52,5,166,146,820,949,2.87,0.31,2013,14,12.058823529411764,2.8674698795180724,453,16,469,0.4925373134328358
2013-14,RegularSeason,201581,123,JJ Hickson,1610612743,DEN,69,1859,332,654,0.508,0,8,0.0,150,290,0.517,206,426,632,96,47,51,128,177,814,1050,0.75,0.37,2013,14,11.797101449275363,0.75,322,140,462,1.367965367965368
2013-14,RegularSeason,202696,124,Nikola Vucevic,1610612753,ORL,57,1812,353,696,0.507,0,0,0.0,105,137,0.766,185,441,626,104,60,47,112,169,811,1161,0.93,0.54,2013,14,14.228070175438596,0.9285714285714286,343,32,375,1.6693333333333333
2013-14,RegularSeason,201960,125,DeMarre Carroll,1610612737,ATL,73,2341,302,642,0.47,97,268,0.362,109,141,0.773,107,296,403,134,108,21,79,188,810,1025,1.7,1.37,2013,14,11.095890410958905,1.6962025316455696,340,32,372,1.0833333333333333
2013-14,RegularSeason,202341,125,James Anderson,1610612755,PHI,80,2309,309,717,0.431,115,351,0.328,77,106,0.726,59,241,300,149,74,28,106,154,810,818,1.41,0.7,2013,14,10.125,1.4056603773584906,408,29,437,0.6864988558352403
2013-14,RegularSeason,101161,127,Amir Johnson,1610612761,TOR,77,2214,344,612,0.562,20,66,0.303,91,143,0.636,172,333,505,115,56,88,123,271,799,1120,0.94,0.46,2013,14,10.376623376623376,0.9349593495934959,268,52,320,1.578125
2013-14,RegularSeason,202694,128,Marcus Morris Sr.,1610612756,PHX,82,1800,288,651,0.442,99,260,0.381,121,159,0.761,84,235,319,88,72,18,95,157,796,797,0.93,0.76,2013,14,9.707317073170731,0.9263157894736842,363,38,401,0.7955112219451371
2013-14,RegularSeason,1890,129,Shawn Marion,1610612742,DAL,76,2409,341,708,0.482,58,162,0.358,51,65,0.785,132,365,497,124,90,37,95,125,791,1063,1.3,0.95,2013,14,10.407894736842104,1.305263157894737,367,14,381,1.304461942257218
2013-14,RegularSeason,202713,130,Kyle Singler,1610612765,DET,82,2337,269,602,0.447,94,246,0.382,152,184,0.826,116,187,303,75,61,38,79,211,784,817,0.95,0.77,2013,14,9.560975609756097,0.9493670886075949,333,32,365,0.8301369863013699
2013-14,RegularSeason,201588,131,George Hill,1610612754,IND,76,2434,272,616,0.442,95,260,0.365,142,176,0.807,53,230,283,265,75,23,92,158,781,957,2.88,0.81,2013,14,10.276315789473685,2.880434782608696,344,34,378,0.7486772486772487
2013-14,RegularSeason,201937,131,Ricky Rubio,1610612750,MIN,82,2638,255,670,0.381,44,133,0.331,227,283,0.802,61,281,342,704,191,11,221,218,781,1337,3.19,0.86,2013,14,9.524390243902438,3.18552036199095,415,56,471,0.7261146496815286
2013-14,RegularSeason,203089,133,John Henson,1610612749,MIL,70,1856,344,639,0.538,0,1,0.0,91,177,0.514,171,326,497,113,41,116,114,185,779,1051,0.99,0.36,2013,14,11.128571428571428,0.9912280701754386,295,86,381,1.304461942257218
2013-14,RegularSeason,2405,134,Amar'e Stoudemire,1610612752,NYK,65,1466,311,558,0.557,0,0,0.0,150,203,0.739,112,208,320,34,23,37,91,159,772,795,0.37,0.25,2013,14,11.876923076923077,0.37362637362637363,247,53,300,1.0666666666666667
2013-14,RegularSeason,202389,135,Timofey Mozgov,1610612743,DEN,82,1770,285,545,0.523,4,24,0.167,196,260,0.754,171,357,528,62,27,100,122,213,770,1041,0.51,0.22,2013,14,9.390243902439025,0.5081967213114754,260,64,324,1.6296296296296295
2013-14,RegularSeason,203118,136,Mike Scott,1610612737,ATL,80,1482,301,628,0.479,62,200,0.31,103,132,0.78,62,222,284,75,30,7,79,121,767,728,0.95,0.38,2013,14,9.5875,0.9493670886075949,327,29,356,0.797752808988764
2013-14,RegularSeason,202339,137,Eric Bledsoe,1610612756,PHX,43,1416,265,556,0.477,50,140,0.357,183,237,0.772,27,175,202,235,69,14,143,99,763,795,1.64,0.48,2013,14,17.74418604651163,1.6433566433566433,291,54,345,0.5855072463768116
2013-14,RegularSeason,201584,138,Courtney Lee,1610612763,MEM,79,1973,295,614,0.48,72,194,0.371,99,112,0.884,29,158,187,115,65,28,73,127,761,751,1.57,0.89,2013,14,9.632911392405063,1.5753424657534247,319,13,332,0.5632530120481928
2013-14,RegularSeason,101127,139,Jarrett Jack,1610612739,CLE,80,2252,286,698,0.41,63,185,0.341,125,149,0.839,22,201,223,324,56,22,133,133,760,816,2.44,0.42,2013,14,9.5,2.43609022556391,412,24,436,0.5114678899082569
2013-14,RegularSeason,200782,139,P.J. Tucker,1610612756,PHX,81,2490,265,615,0.431,74,191,0.387,156,201,0.776,161,368,529,141,110,23,102,204,760,1066,1.38,1.08,2013,14,9.382716049382717,1.3823529411764706,350,45,395,1.339240506329114
2013-14,RegularSeason,101110,141,Martell Webster,1610612764,WAS,78,2157,254,587,0.433,146,372,0.392,105,125,0.84,38,184,222,97,41,15,58,150,759,723,1.67,0.71,2013,14,9.73076923076923,1.6724137931034482,333,20,353,0.6288951841359773
2013-14,RegularSeason,202349,142,Greivis Vasquez,1610612761,TOR,79,1779,277,658,0.421,109,289,0.377,95,108,0.88,20,153,173,323,31,5,128,143,758,768,2.52,0.24,2013,14,9.594936708860759,2.5234375,381,13,394,0.43908629441624364
2013-14,RegularSeason,2403,143,Nene,1610612764,WAS,53,1560,299,594,0.503,1,5,0.2,155,266,0.583,65,229,294,153,64,47,117,164,754,789,1.31,0.55,2013,14,14.226415094339623,1.3076923076923077,295,111,406,0.7241379310344828
2013-14,RegularSeason,203084,144,Harrison Barnes,1610612744,GSW,78,2204,271,679,0.399,66,190,0.347,130,181,0.718,66,245,311,116,65,20,84,158,738,707,1.38,0.77,2013,14,9.461538461538462,1.380952380952381,408,51,459,0.6775599128540305
2013-14,RegularSeason,2590,145,Mo Williams,1610612757,POR,74,1833,280,672,0.417,83,225,0.369,78,89,0.876,42,111,153,321,55,10,149,197,721,708,2.15,0.37,2013,14,9.743243243243244,2.1543624161073827,392,11,403,0.37965260545905705
2013-14,RegularSeason,203463,146,Ben McLemore,1610612758,SAC,82,2187,255,679,0.376,95,297,0.32,115,143,0.804,53,182,235,82,45,18,96,201,720,552,0.85,0.47,2013,14,8.78048780487805,0.8541666666666666,424,28,452,0.5199115044247787
2013-14,RegularSeason,2564,147,Boris Diaw,1610612759,SAS,79,1974,302,580,0.521,45,112,0.402,68,92,0.739,74,252,326,222,44,32,121,140,717,918,1.83,0.36,2013,14,9.075949367088608,1.834710743801653,278,24,302,1.0794701986754967
2013-14,RegularSeason,201596,148,Mario Chalmers,1610612748,MIA,73,2178,254,560,0.454,87,226,0.385,121,163,0.742,41,173,214,357,119,16,162,210,716,912,2.2,0.73,2013,14,9.808219178082192,2.2037037037037037,306,42,348,0.6149425287356322
2013-14,RegularSeason,202325,149,Wesley Johnson,1610612747,LAL,79,2240,277,651,0.425,100,271,0.369,61,77,0.792,70,278,348,124,86,77,90,207,715,870,1.38,0.96,2013,14,9.050632911392405,1.3777777777777778,374,16,390,0.8923076923076924
2013-14,RegularSeason,201977,150,Marcus Thornton,1610612751,BKN,72,1741,252,639,0.394,109,316,0.345,90,112,0.804,57,141,198,77,58,11,67,110,703,571,1.15,0.87,2013,14,9.76388888888889,1.1492537313432836,387,22,409,0.4841075794621027
2013-14,RegularSeason,951,151,Ray Allen,1610612748,MIA,73,1936,240,543,0.442,116,309,0.375,105,116,0.905,23,182,205,143,54,8,84,115,701,713,1.7,0.64,2013,14,9.602739726027398,1.7023809523809523,303,11,314,0.6528662420382165
2013-14,RegularSeason,201941,152,Jordan Hill,1610612747,LAL,72,1500,286,521,0.549,0,1,0.0,124,181,0.685,194,341,535,54,29,64,75,172,696,1011,0.72,0.39,2013,14,9.666666666666666,0.72,235,57,292,1.832191780821918
2013-14,RegularSeason,203148,153,Brian Roberts,1610612740,NOP,72,1667,244,581,0.42,64,178,0.36,125,133,0.94,17,119,136,234,43,7,95,132,677,657,2.46,0.45,2013,14,9.402777777777779,2.463157894736842,337,8,345,0.39420289855072466
2013-14,RegularSeason,201573,154,Jerryd Bayless,1610612738,BOS,72,1686,248,617,0.402,76,212,0.358,94,118,0.797,22,123,145,194,60,9,82,161,666,599,2.37,0.73,2013,14,9.25,2.3658536585365852,369,24,393,0.36895674300254455
2013-14,RegularSeason,2550,154,Kirk Hinrich,1610612741,CHI,73,2116,243,619,0.393,85,242,0.351,95,125,0.76,31,161,192,286,80,26,120,203,666,724,2.38,0.67,2013,14,9.123287671232877,2.3833333333333333,376,30,406,0.4729064039408867
2013-14,RegularSeason,203087,156,Jeremy Lamb,1610612760,OKC,78,1538,263,609,0.432,88,247,0.356,51,64,0.797,27,162,189,115,56,26,61,143,665,631,1.89,0.92,2013,14,8.525641025641026,1.8852459016393444,346,13,359,0.5264623955431755
2013-14,RegularSeason,201177,157,Josh McRoberts,1610612766,CHA,78,2360,247,566,0.436,105,291,0.361,62,85,0.729,85,288,373,333,58,46,83,189,661,1046,4.01,0.7,2013,14,8.474358974358974,4.0120481927710845,319,23,342,1.090643274853801
2013-14,RegularSeason,200826,158,J.J. Barea,1610612750,MIN,79,1471,254,656,0.387,73,231,0.316,79,100,0.79,16,138,154,303,26,0,125,129,660,595,2.42,0.21,2013,14,8.354430379746836,2.424,402,21,423,0.3640661938534279
2013-14,RegularSeason,203101,159,Miles Plumlee,1610612756,PHX,80,1964,286,553,0.517,0,0,0.0,74,132,0.561,198,428,626,43,50,90,111,185,646,1019,0.39,0.45,2013,14,8.075,0.38738738738738737,267,58,325,1.926153846153846
2013-14,RegularSeason,201166,160,Aaron Brooks,1610612743,DEN,72,1557,233,581,0.401,96,248,0.387,83,95,0.874,43,97,140,233,52,13,117,146,645,606,1.99,0.44,2013,14,8.958333333333334,1.9914529914529915,348,12,360,0.3888888888888889
2013-14,RegularSeason,201175,161,Glen Davis,1610612746,LAC,68,1662,271,593,0.457,4,11,0.364,95,137,0.693,108,243,351,77,58,29,76,159,641,716,1.01,0.76,2013,14,9.426470588235293,1.013157894736842,322,42,364,0.9642857142857143
2013-14,RegularSeason,203095,162,Evan Fournier,1610612743,DEN,76,1504,228,544,0.419,89,237,0.376,93,123,0.756,34,168,202,112,34,7,100,179,638,547,1.12,0.34,2013,14,8.394736842105264,1.12,316,30,346,0.5838150289017341
2013-14,RegularSeason,201627,163,Anthony Morrow,1610612740,NOP,76,1426,238,520,0.458,88,195,0.451,72,87,0.828,29,111,140,59,38,12,51,102,636,537,1.16,0.74,2013,14,8.368421052631579,1.1568627450980393,282,15,297,0.4713804713804714
2013-14,RegularSeason,101109,164,Raymond Felton,1610612752,NYK,65,2017,240,608,0.395,62,195,0.318,88,122,0.721,54,143,197,365,78,27,129,157,630,766,2.83,0.6,2013,14,9.692307692307692,2.8294573643410854,368,34,402,0.4900497512437811
2013-14,RegularSeason,2733,165,Shaun Livingston,1610612751,BKN,76,1974,235,487,0.483,1,6,0.167,158,191,0.827,67,179,246,245,93,31,105,172,629,854,2.33,0.89,2013,14,8.276315789473685,2.3333333333333335,252,33,285,0.8631578947368421
2013-14,RegularSeason,2449,166,Luis Scola,1610612754,IND,82,1399,263,560,0.47,1,7,0.143,99,136,0.728,86,305,391,81,26,16,108,164,626,698,0.75,0.24,2013,14,7.634146341463414,0.75,297,37,334,1.1706586826347305
2013-14,RegularSeason,101150,167,Lou Williams,1610612737,ATL,60,1445,197,493,0.4,79,231,0.342,152,179,0.849,10,114,124,210,45,4,92,65,625,593,2.28,0.49,2013,14,10.416666666666666,2.282608695652174,296,27,323,0.38390092879256965
2013-14,RegularSeason,2440,167,Matt Barnes,1610612746,LAC,63,1735,231,527,0.438,97,283,0.343,66,90,0.733,60,232,292,125,56,28,85,185,625,721,1.47,0.66,2013,14,9.920634920634921,1.4705882352941178,296,24,320,0.9125
2013-14,RegularSeason,202682,169,Derrick Williams,1610612758,SAC,78,1820,206,482,0.427,26,99,0.263,186,259,0.718,71,252,323,56,48,20,76,114,624,646,0.74,0.63,2013,14,8.0,0.7368421052631579,276,73,349,0.9255014326647565
2013-14,RegularSeason,203141,170,Mirza Teletovic,1610612751,BKN,72,1396,221,529,0.418,136,349,0.39,44,62,0.71,60,206,266,57,29,23,54,143,622,617,1.06,0.54,2013,14,8.63888888888889,1.0555555555555556,308,18,326,0.8159509202453987
2013-14,RegularSeason,201980,171,Danny Green,1610612759,SAS,68,1651,218,505,0.432,132,318,0.415,50,63,0.794,25,204,229,104,65,61,76,107,618,701,1.37,0.85,2013,14,9.088235294117647,1.368421052631579,287,13,300,0.7633333333333333
2013-14,RegularSeason,101141,171,Ersan Ilyasova,1610612749,MIL,55,1478,237,579,0.409,37,131,0.282,107,130,0.823,107,235,342,72,46,8,61,135,618,660,1.18,0.75,2013,14,11.236363636363636,1.180327868852459,342,23,365,0.936986301369863
2013-14,RegularSeason,201564,173,O.J. Mayo,1610612749,MIL,52,1346,224,550,0.407,84,227,0.37,76,88,0.864,24,100,124,113,28,13,95,111,608,453,1.19,0.29,2013,14,11.692307692307692,1.1894736842105262,326,12,338,0.3668639053254438
2013-14,RegularSeason,203482,174,Kelly Olynyk,1610612738,BOS,70,1400,234,502,0.466,40,114,0.351,99,122,0.811,140,225,365,109,35,27,106,227,607,746,1.03,0.33,2013,14,8.67142857142857,1.028301886792453,268,23,291,1.254295532646048
2013-14,RegularSeason,101107,175,Marvin Williams,1610612762,UTA,66,1674,231,526,0.439,84,234,0.359,57,73,0.781,82,252,334,78,54,31,53,151,603,736,1.47,1.02,2013,14,9.136363636363637,1.471698113207547,295,16,311,1.0739549839228295
2013-14,RegularSeason,203090,176,Maurice Harkless,1610612753,ORL,80,1950,224,483,0.464,59,154,0.383,85,143,0.594,69,195,264,80,97,50,86,140,592,680,0.93,1.13,2013,14,7.4,0.9302325581395349,259,58,317,0.832807570977918
2013-14,RegularSeason,2738,177,Andre Iguodala,1610612744,GSW,63,2040,220,458,0.48,62,175,0.354,86,132,0.652,53,240,293,263,95,18,100,103,588,873,2.63,0.95,2013,14,9.333333333333334,2.63,238,46,284,1.0316901408450705
2013-14,RegularSeason,2406,178,Caron Butler,1610612760,OKC,56,1419,213,540,0.394,98,249,0.394,63,75,0.84,21,208,229,82,47,17,60,120,587,563,1.37,0.78,2013,14,10.482142857142858,1.3666666666666667,327,12,339,0.6755162241887905
2013-14,RegularSeason,201574,179,Jason Thompson,1610612758,SAC,82,2007,251,496,0.506,0,0,0.0,84,145,0.579,153,374,527,53,32,56,95,251,586,853,0.56,0.34,2013,14,7.146341463414634,0.5578947368421052,245,61,306,1.7222222222222223
2013-14,RegularSeason,2743,180,Kris Humphries,1610612738,BOS,69,1376,231,461,0.501,0,2,0.0,117,144,0.813,127,282,409,67,31,61,64,136,579,826,1.05,0.48,2013,14,8.391304347826088,1.046875,230,27,257,1.5914396887159532
2013-14,RegularSeason,2034,180,Mike Miller,1610612763,MEM,82,1707,213,443,0.481,107,233,0.459,46,56,0.821,30,177,207,130,26,5,77,95,579,630,1.69,0.34,2013,14,7.060975609756097,1.6883116883116882,230,10,240,0.8625
2013-14,RegularSeason,201976,182,Patrick Beverley,1610612745,HOU,56,1751,199,481,0.414,92,255,0.361,83,102,0.814,72,124,196,151,77,23,66,174,573,653,2.29,1.17,2013,14,10.232142857142858,2.287878787878788,282,19,301,0.6511627906976745
2013-14,RegularSeason,202329,183,Al-Farouq Aminu,1610612740,NOP,80,2045,234,494,0.474,13,48,0.271,91,137,0.664,129,367,496,114,82,38,88,147,572,908,1.29,0.93,2013,14,7.15,1.2954545454545454,260,46,306,1.6209150326797386
2013-14,RegularSeason,101187,184,Alan Anderson,1610612751,BKN,78,1773,194,485,0.4,84,248,0.339,92,118,0.78,40,135,175,81,48,11,62,147,564,500,1.31,0.77,2013,14,7.230769230769231,1.3064516129032258,291,26,317,0.5520504731861199
2013-14,RegularSeason,200745,185,Andrea Bargnani,1610612752,NYK,42,1257,222,502,0.442,30,108,0.278,84,102,0.824,69,153,222,45,14,52,58,100,558,535,0.78,0.24,2013,14,13.285714285714286,0.7758620689655172,280,18,298,0.7449664429530202
2013-14,RegularSeason,202335,186,Patrick Patterson,1610612761,TOR,65,1532,225,489,0.46,55,151,0.364,50,71,0.704,117,225,342,78,55,37,65,159,555,717,1.2,0.85,2013,14,8.538461538461538,1.2,264,21,285,1.2
2013-14,RegularSeason,202390,187,Gary Neal,1610612766,CHA,52,1114,193,471,0.41,68,180,0.378,94,105,0.895,10,80,90,83,18,0,64,65,548,386,1.3,0.28,2013,14,10.538461538461538,1.296875,278,11,289,0.31141868512110726
2013-14,RegularSeason,2760,188,Anderson Varejao,1610612739,CLE,65,1800,227,459,0.495,0,7,0.0,92,135,0.681,187,442,629,140,69,39,72,164,546,1076,1.94,0.96,2013,14,8.4,1.9444444444444444,232,43,275,2.287272727272727
2013-14,RegularSeason,202714,189,Shelvin Mack,1610612737,ATL,73,1490,209,501,0.417,62,184,0.337,64,74,0.865,21,139,160,271,50,2,89,100,544,636,3.04,0.56,2013,14,7.4520547945205475,3.044943820224719,292,10,302,0.5298013245033113
2013-14,RegularSeason,201143,190,Al Horford,1610612737,ATL,29,958,238,420,0.567,4,11,0.364,58,85,0.682,66,178,244,76,27,44,64,56,538,656,1.19,0.42,2013,14,18.551724137931036,1.1875,182,27,209,1.167464114832536
2013-14,RegularSeason,200755,191,JJ Redick,1610612746,LAC,35,987,181,398,0.455,73,185,0.395,97,106,0.915,9,65,74,78,28,3,42,65,532,447,1.86,0.67,2013,14,15.2,1.8571428571428572,217,9,226,0.3274336283185841
2013-14,RegularSeason,203085,192,Austin Rivers,1610612740,NOP,69,1339,192,474,0.405,36,99,0.364,110,173,0.636,26,103,129,160,45,9,77,134,530,451,2.08,0.58,2013,14,7.681159420289855,2.0779220779220777,282,63,345,0.3739130434782609
2013-14,RegularSeason,2223,193,Samuel Dalembert,1610612742,DAL,80,1614,214,377,0.568,0,1,0.0,101,137,0.737,200,341,541,38,41,94,90,210,529,954,0.42,0.46,2013,14,6.6125,0.4222222222222222,163,36,199,2.7185929648241207
2013-14,RegularSeason,202708,194,Norris Cole,1610612748,MIA,82,2014,207,500,0.414,60,174,0.345,53,68,0.779,17,143,160,248,77,5,127,156,527,582,1.95,0.61,2013,14,6.426829268292683,1.952755905511811,293,15,308,0.5194805194805194
2013-14,RegularSeason,201148,195,Brandan Wright,1610612742,DAL,58,1077,224,331,0.677,0,0,0.0,77,106,0.726,102,142,244,31,32,55,35,94,525,716,0.89,0.91,2013,14,9.051724137931034,0.8857142857142857,107,29,136,1.7941176470588236
2013-14,RegularSeason,203507,195,Giannis Antetokounmpo,1610612749,MIL,77,1897,173,418,0.414,41,118,0.347,138,202,0.683,78,261,339,150,60,61,122,173,525,704,1.23,0.49,2013,14,6.818181818181818,1.2295081967213115,245,64,309,1.0970873786407767
2013-14,RegularSeason,203486,197,Mason Plumlee,1610612751,BKN,70,1275,199,302,0.659,0,3,0.0,122,195,0.626,99,209,308,60,49,55,77,171,520,739,0.78,0.64,2013,14,7.428571428571429,0.7792207792207793,103,73,176,1.75
2013-14,RegularSeason,201585,198,Kosta Koufos,1610612763,MEM,80,1349,227,459,0.495,0,0,0.0,60,93,0.645,160,258,418,39,32,71,67,182,514,742,0.58,0.48,2013,14,6.425,0.582089552238806,232,33,265,1.5773584905660378
2013-14,RegularSeason,203110,199,Draymond Green,1610612744,GSW,82,1797,187,459,0.407,55,165,0.333,82,123,0.667,86,323,409,152,102,72,91,231,511,842,1.67,1.12,2013,14,6.2317073170731705,1.6703296703296704,272,41,313,1.3067092651757188
2013-14,RegularSeason,201162,199,Jared Dudley,1610612746,LAC,74,1729,196,447,0.438,81,225,0.36,38,58,0.655,36,124,160,104,41,10,56,146,511,499,1.86,0.73,2013,14,6.905405405405405,1.8571428571428572,251,20,271,0.5904059040590406
2013-14,RegularSeason,201967,201,Dante Cunningham,1610612750,MIN,81,1635,236,509,0.464,0,5,0.0,38,67,0.567,112,218,330,83,62,58,42,146,510,699,1.98,1.48,2013,14,6.296296296296297,1.9761904761904763,273,29,302,1.0927152317880795
2013-14,RegularSeason,201578,202,Marreese Speights,1610612744,GSW,79,982,195,442,0.441,8,31,0.258,110,134,0.821,101,189,290,32,10,34,66,148,508,537,0.48,0.15,2013,14,6.430379746835443,0.48484848484848486,247,24,271,1.070110701107011
2013-14,RegularSeason,101139,203,CJ Miles,1610612739,CLE,51,984,178,409,0.435,83,211,0.393,64,75,0.853,18,85,103,52,46,15,44,103,503,433,1.18,1.04,2013,14,9.862745098039216,1.1818181818181819,231,11,242,0.4256198347107438
2013-14,RegularSeason,202734,204,E'Twaun Moore,1610612753,ORL,79,1506,195,456,0.428,57,161,0.354,52,68,0.765,29,107,136,112,60,13,55,106,499,488,2.04,1.09,2013,14,6.3164556962025316,2.036363636363636,261,16,277,0.49097472924187724
2013-14,RegularSeason,201971,205,DeJuan Blair,1610612742,DAL,78,1214,210,393,0.534,0,2,0.0,77,121,0.636,139,229,368,70,60,21,77,192,497,712,0.91,0.78,2013,14,6.371794871794871,0.9090909090909091,183,44,227,1.6211453744493391
2013-14,RegularSeason,202697,206,Iman Shumpert,1610612752,NYK,74,1962,183,484,0.378,76,228,0.333,53,71,0.746,81,227,308,129,92,13,79,209,495,639,1.63,1.17,2013,14,6.6891891891891895,1.6329113924050633,301,18,319,0.9655172413793104
2013-14,RegularSeason,2754,206,Tony Allen,1610612763,MEM,55,1278,204,413,0.494,11,47,0.234,76,121,0.628,79,129,208,94,90,19,90,121,495,562,1.04,1.0,2013,14,9.0,1.0444444444444445,209,45,254,0.8188976377952756
2013-14,RegularSeason,101106,208,Andrew Bogut,1610612744,GSW,67,1769,235,375,0.627,0,0,0.0,22,64,0.344,182,489,671,112,47,121,97,210,492,1164,1.16,0.48,2013,14,7.343283582089552,1.1546391752577319,140,42,182,3.6868131868131866
2013-14,RegularSeason,202344,209,Trevor Booker,1610612764,WAS,72,1553,222,403,0.551,0,2,0.0,47,76,0.618,149,230,379,64,41,45,58,131,491,752,1.1,0.71,2013,14,6.819444444444445,1.103448275862069,181,29,210,1.8047619047619048
2013-14,RegularSeason,203469,210,Cody Zeller,1610612766,CHA,82,1417,172,404,0.426,0,1,0.0,146,200,0.73,118,235,353,92,40,41,87,170,490,643,1.06,0.46,2013,14,5.975609756097561,1.0574712643678161,232,54,286,1.2342657342657342
2013-14,RegularSeason,201956,210,Omri Casspi,1610612745,HOU,71,1283,173,410,0.422,61,176,0.347,83,122,0.68,55,205,260,88,44,14,72,100,490,548,1.22,0.61,2013,14,6.901408450704225,1.2222222222222223,237,39,276,0.9420289855072463
2013-14,RegularSeason,201950,212,Jrue Holiday,1610612740,NOP,34,1143,203,454,0.447,30,77,0.39,51,63,0.81,28,114,142,268,56,12,105,92,487,597,2.55,0.53,2013,14,14.323529411764707,2.552380952380952,251,12,263,0.5399239543726235
2013-14,RegularSeason,101198,213,Will Bynum,1610612765,DET,56,1054,184,430,0.428,20,62,0.323,97,121,0.802,24,75,99,216,39,7,103,121,485,473,2.1,0.38,2013,14,8.660714285714286,2.0970873786407767,246,24,270,0.36666666666666664
2013-14,RegularSeason,201168,214,Tiago Splitter,1610612759,SAS,59,1271,181,346,0.523,0,3,0.0,121,173,0.699,123,240,363,90,29,31,75,117,483,704,1.2,0.39,2013,14,8.186440677966102,1.2,165,52,217,1.672811059907834
2013-14,RegularSeason,2199,215,Tyson Chandler,1610612752,NYK,55,1662,191,322,0.593,0,1,0.0,98,155,0.632,159,370,529,59,36,63,71,145,480,908,0.83,0.51,2013,14,8.727272727272727,0.8309859154929577,131,57,188,2.8138297872340425
2013-14,RegularSeason,2365,216,Chris Andersen,1610612748,MIA,72,1396,177,275,0.644,3,12,0.25,120,169,0.71,129,250,379,19,32,97,53,162,477,804,0.36,0.6,2013,14,6.625,0.3584905660377358,98,49,147,2.578231292517007
2013-14,RegularSeason,203527,217,Ryan Kelly,1610612747,LAL,59,1312,157,371,0.423,48,142,0.338,110,135,0.815,42,177,219,95,32,45,47,147,472,577,2.02,0.68,2013,14,8.0,2.021276595744681,214,25,239,0.9163179916317992
2013-14,RegularSeason,203484,218,Kentavious Caldwell-Pope,1610612765,DET,80,1583,182,460,0.396,59,185,0.319,47,61,0.77,38,118,156,55,75,12,28,145,470,448,1.96,2.68,2013,14,5.875,1.9642857142857142,278,14,292,0.5342465753424658
2013-14,RegularSeason,203138,219,Hollis Thompson,1610612755,PHI,77,1742,171,372,0.46,67,167,0.401,52,73,0.712,73,174,247,73,53,12,60,144,461,564,1.22,0.88,2013,14,5.987012987012987,1.2166666666666666,201,21,222,1.1126126126126126
2013-14,RegularSeason,101126,220,Nate Robinson,1610612743,DEN,44,866,164,383,0.428,58,154,0.377,71,85,0.835,21,60,81,112,36,4,58,92,457,399,1.93,0.62,2013,14,10.386363636363637,1.9310344827586208,219,14,233,0.34763948497854075
2013-14,RegularSeason,2419,221,Tayshaun Prince,1610612763,MEM,76,1948,200,492,0.407,20,69,0.29,34,60,0.567,32,202,234,119,39,19,41,63,454,506,2.9,0.95,2013,14,5.973684210526316,2.902439024390244,292,26,318,0.7358490566037735
2013-14,RegularSeason,203077,222,Michael Kidd-Gilchrist,1610612766,CHA,62,1502,167,353,0.473,1,9,0.111,113,184,0.614,109,215,324,52,43,39,60,145,448,589,0.87,0.72,2013,14,7.225806451612903,0.8666666666666667,186,71,257,1.2607003891050583
2013-14,RegularSeason,201563,223,Michael Beasley,1610612748,MIA,55,831,177,355,0.499,21,54,0.389,61,79,0.772,31,141,172,42,23,21,57,93,436,441,0.74,0.4,2013,14,7.927272727272728,0.7368421052631579,178,18,196,0.8775510204081632
2013-14,RegularSeason,201583,223,Ryan Anderson,1610612740,NOP,22,795,155,354,0.438,67,164,0.409,59,62,0.952,66,76,142,17,10,7,20,47,436,390,0.85,0.5,2013,14,19.818181818181817,0.85,199,3,202,0.7029702970297029
2013-14,RegularSeason,203094,225,Andrew Nicholson,1610612753,ORL,76,1174,180,420,0.429,28,89,0.315,47,57,0.825,53,202,255,25,18,23,51,150,435,455,0.49,0.35,2013,14,5.723684210526316,0.49019607843137253,240,10,250,1.02
2013-14,RegularSeason,202333,226,Xavier Henry,1610612747,LAL,43,908,144,345,0.417,28,81,0.346,116,177,0.655,25,89,114,51,44,7,57,79,432,329,0.9,0.77,2013,14,10.046511627906977,0.8947368421052632,201,61,262,0.4351145038167939
2013-14,RegularSeason,203088,227,Kendall Marshall,1610612747,LAL,54,1564,170,419,0.406,71,178,0.399,19,36,0.528,15,140,155,477,48,4,150,76,430,698,3.18,0.32,2013,14,7.962962962962963,3.18,249,17,266,0.5827067669172933
2013-14,RegularSeason,203124,228,Kyle O'Quinn,1610612753,ORL,69,1188,186,371,0.501,0,3,0.0,57,83,0.687,100,264,364,78,39,88,78,165,429,709,1.0,0.5,2013,14,6.217391304347826,1.0,185,26,211,1.7251184834123223
2013-14,RegularSeason,965,229,Derek Fisher,1610612760,OKC,81,1428,141,361,0.391,88,229,0.384,55,71,0.775,12,110,122,117,70,3,49,157,425,452,2.39,1.43,2013,14,5.246913580246914,2.3877551020408165,220,16,236,0.5169491525423728
2013-14,RegularSeason,1882,230,Elton Brand,1610612737,ATL,73,1414,179,332,0.539,0,2,0.0,61,94,0.649,97,264,361,74,40,88,60,192,419,736,1.23,0.67,2013,14,5.739726027397261,1.2333333333333334,153,33,186,1.9408602150537635
2013-14,RegularSeason,203489,231,Nate Wolters,1610612749,MIL,58,1309,170,389,0.437,18,62,0.29,59,90,0.656,33,116,149,187,35,15,57,67,417,496,3.28,0.61,2013,14,7.189655172413793,3.280701754385965,219,31,250,0.596
2013-14,RegularSeason,200770,232,Jordan Farmar,1610612747,LAL,41,912,151,364,0.415,70,160,0.438,44,59,0.746,20,84,104,199,38,8,95,65,416,442,2.1,0.4,2013,14,10.146341463414634,2.094736842105263,213,15,228,0.45614035087719296
2013-14,RegularSeason,201228,233,C.J. Watson,1610612754,IND,63,1193,146,334,0.437,53,145,0.366,69,88,0.784,19,82,101,107,60,8,60,66,414,423,1.78,1.0,2013,14,6.571428571428571,1.7833333333333334,188,19,207,0.48792270531400966
2013-14,RegularSeason,2585,234,Zaza Pachulia,1610612749,MIL,53,1325,149,349,0.427,0,1,0.0,110,130,0.846,141,192,333,136,45,14,92,124,408,624,1.48,0.49,2013,14,7.69811320754717,1.4782608695652173,200,20,220,1.5136363636363637
2013-14,RegularSeason,2549,235,Chris Kaman,1610612747,LAL,39,736,176,346,0.509,0,3,0.0,52,68,0.765,54,175,229,58,11,40,74,93,404,482,0.78,0.15,2013,14,10.35897435897436,0.7837837837837838,170,16,186,1.2311827956989247
2013-14,RegularSeason,202343,235,Elliot Williams,1610612755,PHI,67,1157,140,337,0.415,37,125,0.296,87,119,0.731,30,100,130,72,35,3,68,126,404,347,1.06,0.52,2013,14,6.029850746268656,1.0588235294117647,197,32,229,0.5676855895196506
2013-14,RegularSeason,202706,235,Jordan Hamilton,1610612745,HOU,60,1020,147,376,0.391,70,198,0.354,40,51,0.784,32,162,194,52,44,20,46,67,404,428,1.13,0.96,2013,14,6.733333333333333,1.1304347826086956,229,11,240,0.8083333333333333
2013-14,RegularSeason,2422,238,John Salmons,1610612761,TOR,78,1726,150,413,0.363,63,163,0.387,40,52,0.769,20,143,163,147,47,19,54,124,403,450,2.72,0.87,2013,14,5.166666666666667,2.7222222222222223,263,12,275,0.5927272727272728
2013-14,RegularSeason,203145,238,Kent Bazemore,1610612747,LAL,67,911,147,343,0.429,43,128,0.336,66,109,0.606,10,107,117,91,43,13,79,102,403,349,1.15,0.54,2013,14,6.014925373134329,1.1518987341772151,196,43,239,0.4895397489539749
2013-14,RegularSeason,201589,240,Darrell Arthur,1610612743,DEN,68,1161,162,410,0.395,24,64,0.375,53,62,0.855,52,158,210,61,39,47,58,185,401,443,1.05,0.67,2013,14,5.897058823529412,1.0517241379310345,248,9,257,0.8171206225680934
2013-14,RegularSeason,202379,240,Jeremy Evans,1610612762,UTA,66,1209,175,332,0.527,0,2,0.0,51,75,0.68,120,190,310,44,42,46,40,139,401,622,1.1,1.05,2013,14,6.075757575757576,1.1,157,24,181,1.712707182320442
2013-14,RegularSeason,203092,242,Tyler Zeller,1610612739,CLE,70,1049,156,290,0.538,0,1,0.0,87,121,0.719,103,179,282,36,18,38,60,137,399,545,0.6,0.3,2013,14,5.7,0.6,134,34,168,1.6785714285714286
2013-14,RegularSeason,201229,243,Anthony Tolliver,1610612766,CHA,64,1298,129,307,0.42,102,247,0.413,33,41,0.805,33,135,168,42,19,15,23,82,393,428,1.83,0.83,2013,14,6.140625,1.826086956521739,178,8,186,0.9032258064516129
2013-14,RegularSeason,201949,244,James Johnson,1610612763,MEM,52,956,143,308,0.464,22,87,0.253,76,90,0.844,60,106,166,111,42,57,66,102,384,515,1.68,0.64,2013,14,7.384615384615385,1.6818181818181819,165,14,179,0.9273743016759777
2013-14,RegularSeason,200757,245,Thabo Sefolosha,1610612760,OKC,61,1584,141,340,0.415,48,152,0.316,53,69,0.768,50,170,220,94,79,17,55,90,383,523,1.71,1.44,2013,14,6.278688524590164,1.709090909090909,199,16,215,1.0232558139534884
2013-14,RegularSeason,2581,246,Steve Blake,1610612744,GSW,55,1498,133,353,0.377,79,210,0.376,33,43,0.767,13,146,159,307,54,8,102,85,378,574,3.01,0.53,2013,14,6.872727272727273,3.0098039215686274,220,10,230,0.691304347826087
2013-14,RegularSeason,202399,247,Jeff Adrien,1610612749,MIL,53,962,143,275,0.52,0,0,0.0,76,119,0.639,102,204,306,38,24,36,39,108,362,552,0.97,0.61,2013,14,6.830188679245283,0.9743589743589743,132,43,175,1.7485714285714287
2013-14,RegularSeason,202334,248,Ed Davis,1610612763,MEM,63,956,155,290,0.534,0,0,0.0,47,89,0.528,92,168,260,27,17,43,40,114,357,487,0.68,0.42,2013,14,5.666666666666667,0.675,135,42,177,1.4689265536723164
2013-14,RegularSeason,203109,249,Jae Crowder,1610612742,DAL,78,1254,130,296,0.439,50,151,0.331,46,61,0.754,46,148,194,60,59,21,41,100,356,468,1.46,1.44,2013,14,4.564102564102564,1.4634146341463414,166,15,181,1.0718232044198894
2013-14,RegularSeason,201572,250,Brook Lopez,1610612751,BKN,17,533,129,229,0.563,0,1,0.0,94,115,0.817,39,63,102,16,9,30,28,52,352,360,0.57,0.32,2013,14,20.705882352941178,0.5714285714285714,100,21,121,0.8429752066115702
2013-14,RegularSeason,708,250,Kevin Garnett,1610612751,BKN,54,1109,157,356,0.441,0,3,0.0,38,47,0.809,60,298,358,82,43,40,69,123,352,598,1.19,0.62,2013,14,6.518518518518518,1.1884057971014492,199,9,208,1.7211538461538463
2013-14,RegularSeason,203544,250,Pero Antic,1610612737,ATL,50,925,123,294,0.418,56,171,0.327,50,66,0.758,57,152,209,58,19,12,55,126,352,408,1.05,0.34,2013,14,7.04,1.0545454545454545,171,16,187,1.1176470588235294
2013-14,RegularSeason,203156,253,Henry Sims,1610612755,PHI,46,875,130,274,0.474,0,1,0.0,90,121,0.744,104,133,237,52,28,20,41,116,350,471,1.27,0.68,2013,14,7.608695652173913,1.2682926829268293,144,31,175,1.3542857142857143
2013-14,RegularSeason,200765,253,Rajon Rondo,1610612738,BOS,30,998,141,350,0.403,26,90,0.289,42,67,0.627,22,142,164,294,40,2,99,65,350,517,2.97,0.4,2013,14,11.666666666666666,2.9696969696969697,209,25,234,0.7008547008547008
2013-14,RegularSeason,203135,253,Robert Sacre,1610612747,LAL,65,1089,143,300,0.477,0,0,0.0,64,94,0.681,82,172,254,51,24,47,44,134,350,495,1.16,0.55,2013,14,5.384615384615385,1.1590909090909092,157,30,187,1.358288770053476
2013-14,RegularSeason,979,256,Jermaine O'Neal,1610612744,GSW,44,883,125,248,0.504,0,0,0.0,99,132,0.75,85,157,242,25,14,40,52,102,349,462,0.48,0.27,2013,14,7.931818181818182,0.4807692307692308,123,33,156,1.5512820512820513
2013-14,RegularSeason,201979,257,Nick Calathes,1610612763,MEM,71,1173,142,311,0.457,19,61,0.311,44,72,0.611,23,114,137,207,66,8,101,117,347,467,2.05,0.65,2013,14,4.887323943661972,2.0495049504950495,169,28,197,0.6954314720812182
2013-14,RegularSeason,203503,258,Tony Snell,1610612741,CHI,77,1231,129,336,0.384,57,178,0.32,31,41,0.756,19,105,124,68,29,15,44,84,346,321,1.54,0.66,2013,14,4.4935064935064934,1.5454545454545454,207,10,217,0.5714285714285714
2013-14,RegularSeason,202709,259,Cory Joseph,1610612759,SAS,68,936,126,265,0.475,12,38,0.316,79,96,0.823,32,75,107,114,35,14,43,84,343,414,2.65,0.81,2013,14,5.044117647058823,2.6511627906976742,139,17,156,0.6858974358974359
2013-14,RegularSeason,2748,259,Dorell Wright,1610612757,POR,68,984,111,297,0.374,69,202,0.342,52,69,0.754,29,162,191,64,23,16,39,62,343,395,1.64,0.59,2013,14,5.044117647058823,1.641025641025641,186,17,203,0.9408866995073891
2013-14,RegularSeason,2566,259,Travis Outlaw,1610612758,SAC,63,1065,130,326,0.399,41,117,0.35,42,52,0.808,36,132,168,48,20,19,26,94,343,366,1.85,0.77,2013,14,5.444444444444445,1.8461538461538463,196,10,206,0.8155339805825242
2013-14,RegularSeason,202700,262,Donatas Motiejunas,1610612745,HOU,62,952,131,296,0.443,21,84,0.25,58,96,0.604,60,165,225,34,20,21,49,132,341,389,0.69,0.41,2013,14,5.5,0.6938775510204082,165,38,203,1.1083743842364533
2013-14,RegularSeason,201604,263,Chris Douglas-Roberts,1610612766,CHA,49,1016,111,252,0.44,51,132,0.386,66,82,0.805,16,103,119,51,29,16,36,61,339,361,1.42,0.81,2013,14,6.918367346938775,1.4166666666666667,141,16,157,0.7579617834394905
2013-14,RegularSeason,203521,263,Matthew Dellavedova,1610612739,CLE,72,1271,122,296,0.412,57,155,0.368,38,48,0.792,29,94,123,187,33,5,60,121,339,443,3.12,0.55,2013,14,4.708333333333333,3.1166666666666667,174,10,184,0.6684782608695652
2013-14,RegularSeason,203080,263,Thomas Robinson,1610612757,POR,70,873,141,293,0.481,0,1,0.0,57,101,0.564,105,202,307,34,23,20,57,131,339,470,0.6,0.4,2013,14,4.8428571428571425,0.5964912280701754,152,44,196,1.566326530612245
2013-14,RegularSeason,101122,266,Danny Granger,1610612746,LAC,41,848,116,307,0.378,43,128,0.336,63,67,0.94,31,102,133,41,12,17,46,62,338,300,0.89,0.26,2013,14,8.24390243902439,0.8913043478260869,191,4,195,0.6820512820512821
2013-14,RegularSeason,2555,266,Nick Collison,1610612760,OKC,81,1353,134,241,0.556,4,17,0.235,66,93,0.71,116,177,293,104,30,28,71,187,338,588,1.47,0.42,2013,14,4.172839506172839,1.4647887323943662,107,27,134,2.1865671641791047
2013-14,RegularSeason,201858,268,Cartier Martin,1610612737,ATL,59,870,111,264,0.42,59,151,0.391,48,65,0.738,13,97,110,33,27,7,34,71,329,302,0.97,0.79,2013,14,5.576271186440678,0.9705882352941176,153,17,170,0.6470588235294118
2013-14,RegularSeason,201582,269,Alexis Ajinca,1610612740,NOP,56,951,136,249,0.546,0,1,0.0,56,67,0.836,94,183,277,40,23,46,63,187,328,527,0.64,0.36,2013,14,5.857142857142857,0.6349206349206349,113,11,124,2.2338709677419355
2013-14,RegularSeason,2734,270,Devin Harris,1610612742,DAL,40,818,96,254,0.378,31,101,0.307,92,115,0.8,8,77,85,178,28,2,59,72,315,368,3.02,0.47,2013,14,7.875,3.016949152542373,158,23,181,0.4696132596685083
2013-14,RegularSeason,101128,270,Francisco Garcia,1610612745,HOU,55,1083,118,294,0.401,69,193,0.358,10,19,0.526,21,101,122,63,27,33,30,120,315,345,2.1,0.9,2013,14,5.7272727272727275,2.1,176,9,185,0.6594594594594595
2013-14,RegularSeason,201946,272,Tyler Hansbrough,1610612761,TOR,64,978,93,196,0.474,0,2,0.0,126,185,0.681,120,167,287,17,28,19,47,132,312,454,0.36,0.6,2013,14,4.875,0.3617021276595745,103,59,162,1.771604938271605
2013-14,RegularSeason,2557,273,Luke Ridnour,1610612766,CHA,61,1141,126,327,0.385,37,108,0.343,17,26,0.654,23,74,97,176,32,8,66,92,306,343,2.67,0.48,2013,14,5.016393442622951,2.6666666666666665,201,9,210,0.46190476190476193
2013-14,RegularSeason,202730,274,Lavoy Allen,1610612754,IND,65,1071,134,300,0.447,2,13,0.154,33,50,0.66,119,192,311,71,24,33,44,126,303,515,1.61,0.55,2013,14,4.661538461538462,1.6136363636363635,166,17,183,1.6994535519125684
2013-14,RegularSeason,202720,275,Jon Leuer,1610612763,MEM,49,642,121,246,0.492,23,49,0.469,37,47,0.787,37,121,158,20,18,13,27,63,302,349,0.74,0.67,2013,14,6.163265306122449,0.7407407407407407,125,10,135,1.1703703703703703
2013-14,RegularSeason,201160,276,Jason Smith,1610612740,NOP,31,830,131,282,0.465,0,0,0.0,39,50,0.78,51,130,181,29,11,29,28,100,301,361,1.04,0.39,2013,14,9.709677419354838,1.0357142857142858,151,11,162,1.117283950617284
2013-14,RegularSeason,2222,277,Gerald Wallace,1610612738,BOS,58,1416,116,230,0.504,19,64,0.297,47,101,0.465,36,176,212,143,73,14,97,79,298,475,1.47,0.75,2013,14,5.137931034482759,1.4742268041237114,114,54,168,1.2619047619047619
2013-14,RegularSeason,2203,277,Shane Battier,1610612748,MIA,73,1468,105,275,0.382,73,210,0.348,15,23,0.652,34,104,138,63,50,39,21,124,298,389,3.0,2.38,2013,14,4.082191780821918,3.0,170,8,178,0.7752808988764045
2013-14,RegularSeason,203476,279,Gorgui Dieng,1610612750,MIN,60,818,113,227,0.498,1,1,1.0,59,93,0.634,103,197,300,39,30,50,54,108,286,503,0.72,0.56,2013,14,4.766666666666667,0.7222222222222222,114,34,148,2.027027027027027
2013-14,RegularSeason,1889,280,Andre Miller,1610612764,WAS,58,982,106,231,0.459,11,21,0.524,60,77,0.779,28,102,130,197,34,9,61,75,283,450,3.23,0.56,2013,14,4.879310344827586,3.2295081967213113,125,17,142,0.9154929577464789
2013-14,RegularSeason,203492,281,Ray McCallum,1610612758,SAC,45,897,113,300,0.377,22,59,0.373,32,43,0.744,18,61,79,120,22,9,39,69,280,273,3.08,0.56,2013,14,6.222222222222222,3.076923076923077,187,11,198,0.398989898989899
2013-14,RegularSeason,201600,281,Ömer Aşik,1610612745,HOU,48,968,101,190,0.532,0,0,0.0,78,126,0.619,101,277,378,25,14,37,59,92,280,538,0.42,0.24,2013,14,5.833333333333333,0.423728813559322,89,48,137,2.759124087591241
2013-14,RegularSeason,201978,283,Chase Budinger,1610612750,MIN,41,751,100,254,0.394,42,120,0.35,32,39,0.821,19,84,103,31,19,2,24,58,274,244,1.29,0.79,2013,14,6.682926829268292,1.2916666666666667,154,7,161,0.639751552795031
2013-14,RegularSeason,202690,284,Jimmer Fredette,1610612741,CHI,49,519,107,227,0.471,40,84,0.476,19,21,0.905,8,44,52,64,14,3,48,35,273,236,1.33,0.29,2013,14,5.571428571428571,1.3333333333333333,120,2,122,0.4262295081967213
2013-14,RegularSeason,2584,284,Willie Green,1610612746,LAC,55,869,102,271,0.376,41,121,0.339,28,34,0.824,12,66,78,50,22,11,34,96,273,225,1.47,0.65,2013,14,4.963636363636364,1.4705882352941178,169,6,175,0.44571428571428573
2013-14,RegularSeason,101133,286,Ian Mahinmi,1610612754,IND,77,1248,91,189,0.481,0,1,0.0,90,145,0.621,107,150,257,24,41,72,58,207,272,455,0.41,0.71,2013,14,3.5324675324675323,0.41379310344827586,98,55,153,1.6797385620915033
2013-14,RegularSeason,201973,287,Jonas Jerebko,1610612765,DET,64,741,98,208,0.471,31,74,0.419,43,59,0.729,51,124,175,39,21,6,43,85,270,342,0.91,0.49,2013,14,4.21875,0.9069767441860465,110,16,126,1.3888888888888888
2013-14,RegularSeason,1740,288,Rashard Lewis,1610612748,MIA,60,971,98,236,0.415,46,134,0.343,26,33,0.788,24,86,110,57,53,8,35,90,268,316,1.63,1.51,2013,14,4.466666666666667,1.6285714285714286,138,7,145,0.7586206896551724
2013-14,RegularSeason,203500,289,Steven Adams,1610612760,OKC,81,1197,93,185,0.503,0,0,0.0,79,136,0.581,142,190,332,43,40,57,71,203,265,517,0.61,0.56,2013,14,3.271604938271605,0.6056338028169014,92,57,149,2.228187919463087
2013-14,RegularSeason,202397,290,Ish Smith,1610612756,PHX,70,1007,119,281,0.423,1,23,0.043,22,39,0.564,31,98,129,179,49,13,65,66,261,387,2.75,0.75,2013,14,3.7285714285714286,2.753846153846154,162,17,179,0.7206703910614525
2013-14,RegularSeason,202087,291,Alonzo Gee,1610612739,CLE,65,1020,98,236,0.415,19,58,0.328,43,61,0.705,35,114,149,47,39,15,44,96,258,308,1.07,0.89,2013,14,3.9692307692307693,1.0681818181818181,138,18,156,0.9551282051282052
2013-14,RegularSeason,201947,292,Earl Clark,1610612752,NYK,54,768,97,261,0.372,41,122,0.336,22,34,0.647,22,121,143,18,17,25,31,67,257,253,0.58,0.55,2013,14,4.7592592592592595,0.5806451612903226,164,12,176,0.8125
2013-14,RegularSeason,203113,292,Quincy Miller,1610612743,DEN,52,789,94,256,0.367,30,94,0.319,39,55,0.709,36,111,147,26,22,32,48,70,257,258,0.54,0.46,2013,14,4.9423076923076925,0.5416666666666666,162,16,178,0.8258426966292135
2013-14,RegularSeason,203143,294,Pablo Prigioni,1610612752,NYK,66,1283,88,191,0.461,65,140,0.464,11,12,0.917,36,93,129,228,67,2,60,132,252,514,3.8,1.12,2013,14,3.8181818181818183,3.8,103,1,104,1.2403846153846154
2013-14,RegularSeason,203144,295,Alexey Shved,1610612750,MIN,63,664,76,237,0.321,30,102,0.294,68,90,0.756,21,60,81,68,26,16,48,36,250,210,1.42,0.54,2013,14,3.9682539682539684,1.4166666666666667,161,22,183,0.4426229508196721
2013-14,RegularSeason,203187,295,Chris Johnson,1610612738,BOS,40,789,85,214,0.397,43,127,0.339,37,43,0.86,31,66,97,31,27,4,22,63,250,252,1.41,1.23,2013,14,6.25,1.4090909090909092,129,6,135,0.7185185185185186
2013-14,RegularSeason,202338,297,Kevin Seraphin,1610612764,WAS,53,578,111,220,0.505,0,0,0.0,27,31,0.871,53,75,128,17,3,26,41,103,249,269,0.41,0.07,2013,14,4.69811320754717,0.4146341463414634,109,4,113,1.1327433628318584
2013-14,RegularSeason,203197,298,Diante Garrett,1610612762,UTA,71,1048,101,265,0.381,36,96,0.375,10,12,0.833,11,86,97,120,41,5,75,75,248,270,1.6,0.55,2013,14,3.492957746478873,1.6,164,2,166,0.5843373493975904
2013-14,RegularSeason,201965,299,Jeff Ayres,1610612759,SAS,73,952,101,174,0.58,0,0,0.0,38,55,0.691,89,169,258,60,13,25,63,146,240,443,0.95,0.21,2013,14,3.287671232876712,0.9523809523809523,73,17,90,2.8666666666666667
2013-14,RegularSeason,1905,300,Andrei Kirilenko,1610612751,BKN,45,857,82,160,0.513,1,5,0.2,61,119,0.513,55,91,146,72,40,19,54,65,226,313,1.33,0.74,2013,14,5.022222222222222,1.3333333333333333,78,58,136,1.0735294117647058
2013-14,RegularSeason,1733,301,Al Harrington,1610612764,WAS,34,511,82,207,0.396,34,100,0.34,27,35,0.771,15,65,80,28,14,0,34,72,225,180,0.82,0.41,2013,14,6.617647058823529,0.8235294117647058,125,8,133,0.6015037593984962
2013-14,RegularSeason,101115,301,Andrew Bynum,1610612754,IND,26,516,94,225,0.418,0,0,0.0,37,49,0.755,53,92,145,29,6,29,34,31,225,257,0.85,0.18,2013,14,8.653846153846153,0.8529411764705882,131,12,143,1.013986013986014
2013-14,RegularSeason,201601,303,Luc Mbah a Moute,1610612750,MIN,64,1003,87,193,0.451,4,17,0.235,46,67,0.687,56,90,146,36,30,14,40,68,224,283,0.9,0.75,2013,14,3.5,0.9,106,21,127,1.1496062992125984
2013-14,RegularSeason,202687,304,Bismack Biyombo,1610612766,CHA,77,1072,88,144,0.611,0,0,0.0,46,89,0.517,105,261,366,8,7,86,40,124,222,550,0.2,0.17,2013,14,2.883116883116883,0.2,56,43,99,3.696969696969697
2013-14,RegularSeason,203461,305,Anthony Bennett,1610612739,CLE,52,663,80,225,0.356,13,53,0.245,44,69,0.638,49,106,155,17,21,8,47,93,217,201,0.36,0.45,2013,14,4.173076923076923,0.3617021276595745,145,25,170,0.9117647058823529
2013-14,RegularSeason,203103,306,Perry Jones III,1610612760,OKC,62,765,83,181,0.459,22,61,0.361,28,42,0.667,28,86,114,26,14,19,21,62,216,256,1.24,0.67,2013,14,3.4838709677419355,1.2380952380952381,98,14,112,1.0178571428571428
2013-14,RegularSeason,2501,307,Reggie Evans,1610612758,SAC,54,899,71,150,0.473,0,0,0.0,72,130,0.554,115,219,334,21,37,3,58,119,214,414,0.36,0.64,2013,14,3.962962962962963,0.3620689655172414,79,58,137,2.437956204379562
2013-14,RegularSeason,203515,308,Phil Pressey,1610612738,BOS,75,1132,78,253,0.308,28,106,0.264,29,45,0.644,20,85,105,241,68,5,87,97,213,354,2.77,0.78,2013,14,2.84,2.7701149425287355,175,16,191,0.5497382198952879
2013-14,RegularSeason,2570,309,Kendrick Perkins,1610612760,OKC,62,1207,87,193,0.451,0,1,0.0,37,67,0.552,82,223,305,67,26,32,90,177,211,415,0.74,0.29,2013,14,3.403225806451613,0.7444444444444445,106,30,136,2.2426470588235294
2013-14,RegularSeason,203106,310,Jeffery Taylor,1610612766,CHA,26,629,82,218,0.376,18,67,0.269,26,47,0.553,15,45,60,22,13,5,25,62,208,126,0.88,0.52,2013,14,8.0,0.88,136,21,157,0.3821656050955414
2013-14,RegularSeason,201576,311,Anthony Randolph,1610612743,DEN,43,527,68,176,0.386,18,61,0.295,52,69,0.754,20,102,122,32,26,19,39,64,206,241,0.82,0.67,2013,14,4.790697674418604,0.8205128205128205,108,17,125,0.976
2013-14,RegularSeason,200761,312,Shawne Williams,1610612747,LAL,36,751,73,192,0.38,42,129,0.326,14,20,0.7,25,142,167,30,19,30,21,93,202,302,1.43,0.91,2013,14,5.611111111111111,1.4285714285714286,119,6,125,1.336
2013-14,RegularSeason,201962,312,Toney Douglas,1610612748,MIA,51,675,73,190,0.384,31,102,0.304,25,34,0.735,18,69,87,68,19,5,34,81,202,221,2.0,0.56,2013,14,3.9607843137254903,2.0,117,9,126,0.6904761904761905
2013-14,RegularSeason,203468,314,CJ McCollum,1610612757,POR,38,476,74,178,0.416,30,80,0.375,23,34,0.676,7,41,48,27,14,2,35,53,201,142,0.77,0.4,2013,14,5.2894736842105265,0.7714285714285715,104,11,115,0.41739130434782606
2013-14,RegularSeason,2757,315,Beno Udrih,1610612763,MEM,41,643,78,178,0.438,19,42,0.452,25,30,0.833,10,49,59,116,23,4,47,50,200,250,2.47,0.49,2013,14,4.878048780487805,2.4680851063829787,100,5,105,0.5619047619047619
2013-14,RegularSeason,203121,315,Darius Miller,1610612740,NOP,45,723,73,166,0.44,25,77,0.325,29,36,0.806,9,43,52,43,24,9,22,88,200,206,1.96,1.09,2013,14,4.444444444444445,1.9545454545454546,93,7,100,0.52
2013-14,RegularSeason,202686,317,Jan Vesely,1610612743,DEN,54,776,89,173,0.514,0,0,0.0,19,56,0.339,81,110,191,21,53,35,36,121,197,340,0.58,1.47,2013,14,3.6481481481481484,0.5833333333333334,84,37,121,1.578512396694215
2013-14,RegularSeason,2588,317,Matt Bonner,1610612759,SAS,61,690,73,164,0.445,42,98,0.429,9,12,0.75,16,114,130,31,15,11,16,49,197,274,1.94,0.94,2013,14,3.2295081967213113,1.9375,91,3,94,1.3829787234042554
2013-14,RegularSeason,203462,319,Archie Goodwin,1610612756,PHX,52,533,76,167,0.455,5,36,0.139,37,55,0.673,25,62,87,20,20,11,44,45,194,179,0.46,0.46,2013,14,3.730769230769231,0.45454545454545453,91,18,109,0.7981651376146789
2013-14,RegularSeason,203117,320,Doron Lamb,1610612753,ORL,53,695,63,160,0.394,36,90,0.4,29,36,0.806,8,41,49,43,11,1,27,54,191,164,1.59,0.41,2013,14,3.6037735849056602,1.5925925925925926,97,7,104,0.47115384615384615
2013-14,RegularSeason,203481,321,Jeff Withey,1610612740,NOP,58,684,69,129,0.535,0,1,0.0,52,73,0.712,49,101,150,26,15,50,20,73,190,330,1.3,0.75,2013,14,3.2758620689655173,1.3,60,21,81,1.8518518518518519
2013-14,RegularSeason,201957,322,Byron Mullens,1610612755,PHI,45,414,73,165,0.442,33,89,0.371,10,20,0.5,24,68,92,14,15,11,27,64,189,192,0.52,0.56,2013,14,4.2,0.5185185185185185,92,10,102,0.9019607843137255
2013-14,RegularSeason,203471,323,Dennis Schroder,1610612737,ATL,49,641,72,188,0.383,10,42,0.238,29,43,0.674,5,55,60,93,17,0,61,54,183,162,1.52,0.28,2013,14,3.7346938775510203,1.5245901639344261,116,14,130,0.46153846153846156
2013-14,RegularSeason,2400,323,Drew Gooden,1610612764,WAS,22,395,76,143,0.531,7,17,0.412,24,27,0.889,37,77,114,15,10,7,17,53,183,242,0.88,0.59,2013,14,8.318181818181818,0.8823529411764706,67,3,70,1.6285714285714286
2013-14,RegularSeason,203545,325,Miroslav Raduljica,1610612749,MIL,48,465,68,126,0.54,0,0,0.0,45,55,0.818,54,54,108,23,7,13,28,84,181,236,0.82,0.25,2013,14,3.7708333333333335,0.8214285714285714,58,10,68,1.588235294117647
2013-14,RegularSeason,203133,325,Robbie Hummel,1610612750,MIN,53,655,67,177,0.379,32,89,0.36,15,16,0.938,35,97,132,23,16,2,10,57,181,233,2.3,1.6,2013,14,3.4150943396226414,2.3,110,1,111,1.1891891891891893
2013-14,RegularSeason,202336,327,Larry Sanders,1610612749,MIL,23,584,76,162,0.469,0,1,0.0,26,55,0.473,60,105,165,19,18,40,26,74,178,279,0.73,0.69,2013,14,7.739130434782608,0.7307692307692307,86,29,115,1.434782608695652
2013-14,RegularSeason,200779,327,Steve Novak,1610612761,TOR,54,540,60,146,0.411,52,122,0.426,6,6,1.0,8,50,58,13,12,4,5,44,178,174,2.6,2.4,2013,14,3.2962962962962963,2.6,86,0,86,0.6744186046511628
2013-14,RegularSeason,201986,329,Nando De Colo,1610612761,TOR,47,494,64,153,0.418,18,53,0.34,31,35,0.886,14,59,73,65,22,6,35,48,177,215,1.86,0.63,2013,14,3.765957446808511,1.8571428571428572,89,4,93,0.7849462365591398
2013-14,RegularSeason,200777,330,Joel Freeland,1610612757,POR,52,727,77,162,0.475,0,2,0.0,20,29,0.69,88,120,208,36,10,22,32,95,174,324,1.13,0.31,2013,14,3.3461538461538463,1.125,85,9,94,2.2127659574468086
2013-14,RegularSeason,2617,331,Udonis Haslem,1610612748,MIA,46,653,74,146,0.507,0,0,0.0,25,44,0.568,42,133,175,13,11,15,24,79,173,272,0.54,0.46,2013,14,3.760869565217391,0.5416666666666666,72,19,91,1.9230769230769231
2013-14,RegularSeason,203112,332,Quincy Acy,1610612758,SAC,63,848,66,141,0.468,4,15,0.267,35,53,0.66,72,144,216,28,23,26,30,122,171,341,0.93,0.77,2013,14,2.7142857142857144,0.9333333333333333,75,18,93,2.3225806451612905
2013-14,RegularSeason,202337,333,Luke Babbitt,1610612740,NOP,27,473,60,154,0.39,36,95,0.379,14,18,0.778,18,70,88,29,7,11,15,52,170,192,1.93,0.47,2013,14,6.296296296296297,1.9333333333333333,94,4,98,0.8979591836734694
2013-14,RegularSeason,203115,334,Will Barton,1610612757,POR,41,387,65,156,0.417,10,33,0.303,26,32,0.813,16,58,74,33,9,7,18,31,166,174,1.83,0.5,2013,14,4.048780487804878,1.8333333333333333,91,6,97,0.7628865979381443
2013-14,RegularSeason,203543,335,Vitor Faverani,1610612738,BOS,37,488,64,147,0.435,12,40,0.3,24,37,0.649,42,86,128,16,14,27,41,74,164,212,0.39,0.34,2013,14,4.4324324324324325,0.3902439024390244,83,13,96,1.3333333333333333
2013-14,RegularSeason,203382,336,Aron Baynes,1610612759,SAS,53,491,71,163,0.436,0,0,0.0,19,21,0.905,57,88,145,34,2,5,36,77,161,217,0.94,0.06,2013,14,3.0377358490566038,0.9444444444444444,92,2,94,1.5425531914893618
2013-14,RegularSeason,201565,337,Derrick Rose,1610612741,CHI,10,311,58,164,0.354,16,47,0.34,27,32,0.844,9,23,32,43,5,1,34,15,159,95,1.26,0.15,2013,14,15.9,1.2647058823529411,106,5,111,0.2882882882882883
2013-14,RegularSeason,201880,337,Greg Stiemsma,1610612740,NOP,55,1007,70,122,0.574,0,1,0.0,19,32,0.594,72,154,226,36,35,57,44,169,159,404,0.82,0.8,2013,14,2.890909090909091,0.8181818181818182,52,13,65,3.476923076923077
2013-14,RegularSeason,1891,337,Jason Terry,1610612751,BKN,35,570,55,152,0.362,39,103,0.379,10,15,0.667,4,33,37,56,13,0,27,48,159,136,2.07,0.48,2013,14,4.542857142857143,2.074074074074074,97,5,102,0.3627450980392157
2013-14,RegularSeason,101249,337,John Lucas III,1610612762,UTA,42,591,62,190,0.326,25,84,0.298,10,16,0.625,12,27,39,42,14,0,22,41,159,98,1.91,0.64,2013,14,3.7857142857142856,1.9090909090909092,128,6,134,0.291044776119403
2013-14,RegularSeason,202705,337,MarShon Brooks,1610612747,LAL,35,317,57,125,0.456,13,25,0.52,32,44,0.727,10,44,54,25,14,4,24,21,159,152,1.04,0.58,2013,14,4.542857142857143,1.0416666666666667,68,12,80,0.675
2013-14,RegularSeason,203142,342,Chris Copeland,1610612754,IND,41,265,55,117,0.47,33,79,0.418,10,14,0.714,7,25,32,18,3,7,14,38,153,133,1.29,0.21,2013,14,3.731707317073171,1.2857142857142858,62,4,66,0.48484848484848486
2013-14,RegularSeason,2571,343,Leandro Barbosa,1610612756,PHX,20,368,56,131,0.427,7,25,0.28,31,39,0.795,5,32,37,32,7,4,19,30,150,128,1.68,0.37,2013,14,7.5,1.6842105263157894,75,8,83,0.4457831325301205
2013-14,RegularSeason,101142,344,Ronny Turiaf,1610612750,MIN,31,606,64,107,0.598,0,0,0.0,21,50,0.42,55,119,174,24,8,50,24,65,149,309,1.0,0.33,2013,14,4.806451612903226,1.0,43,29,72,2.4166666666666665
2013-14,RegularSeason,202719,345,Jeremy Tyler,1610612752,NYK,41,398,60,116,0.517,0,0,0.0,26,48,0.542,38,71,109,8,6,20,26,70,146,185,0.31,0.23,2013,14,3.5609756097560976,0.3076923076923077,56,22,78,1.3974358974358974
2013-14,RegularSeason,201961,346,Wayne Ellington,1610612742,DAL,45,393,55,126,0.437,25,59,0.424,10,11,0.909,8,35,43,19,16,2,11,33,145,142,1.73,1.46,2013,14,3.2222222222222223,1.7272727272727273,71,1,72,0.5972222222222222
2013-14,RegularSeason,203561,347,Brandon Davies,1610612755,PHI,51,575,54,128,0.422,2,10,0.2,34,53,0.642,38,71,109,28,24,8,35,92,144,185,0.8,0.69,2013,14,2.823529411764706,0.8,74,19,93,1.1720430107526882
2013-14,RegularSeason,202327,347,Ekpe Udoh,1610612749,MIL,42,804,57,143,0.399,0,0,0.0,30,47,0.638,61,87,148,31,15,44,38,96,144,241,0.82,0.4,2013,14,3.4285714285714284,0.8157894736842105,86,17,103,1.4368932038834952
2013-14,RegularSeason,203498,349,Shabazz Muhammad,1610612750,MIN,37,290,57,124,0.46,3,11,0.273,26,40,0.65,24,29,53,6,8,1,16,24,143,114,0.38,0.5,2013,14,3.864864864864865,0.375,67,14,81,0.654320987654321
2013-14,RegularSeason,200797,350,Ryan Hollins,1610612746,LAC,61,482,53,72,0.736,0,0,0.0,35,56,0.625,31,59,90,8,9,31,29,87,141,210,0.28,0.31,2013,14,2.3114754098360657,0.27586206896551724,19,21,40,2.25
2013-14,RegularSeason,203315,351,Toure' Murry,1610612752,NYK,51,372,56,129,0.434,5,12,0.417,23,39,0.59,13,31,44,49,19,1,34,46,140,130,1.44,0.56,2013,14,2.7450980392156863,1.4411764705882353,73,16,89,0.4943820224719101
2013-14,RegularSeason,1897,352,Metta World Peace,1610612752,NYK,29,388,56,141,0.397,17,54,0.315,10,16,0.625,18,41,59,17,24,8,19,44,139,137,0.9,1.26,2013,14,4.793103448275862,0.8947368421052632,85,6,91,0.6483516483516484
2013-14,RegularSeason,202066,353,Garrett Temple,1610612764,WAS,75,638,51,141,0.362,6,29,0.207,30,43,0.698,21,47,68,72,35,11,42,72,138,179,1.71,0.83,2013,14,1.84,1.7142857142857142,90,13,103,0.6601941747572816
2013-14,RegularSeason,2030,354,Kenyon Martin,1610612752,NYK,32,633,63,123,0.512,0,1,0.0,11,19,0.579,36,98,134,50,25,27,26,85,137,279,1.92,0.96,2013,14,4.28125,1.9230769230769231,60,8,68,1.9705882352941178
2013-14,RegularSeason,2457,355,Jannero Pargo,1610612766,CHA,29,242,52,118,0.441,24,60,0.4,8,11,0.727,1,19,20,52,14,1,26,17,136,128,2.0,0.54,2013,14,4.689655172413793,2.0,66,3,69,0.2898550724637681
2013-14,RegularSeason,2446,355,Rasual Butler,1610612754,IND,50,378,51,110,0.464,26,62,0.419,8,14,0.571,6,35,41,17,7,9,11,30,136,134,1.54,0.64,2013,14,2.72,1.5454545454545454,59,6,65,0.6307692307692307
2013-14,RegularSeason,101236,357,Chuck Hayes,1610612761,TOR,61,753,56,130,0.431,0,1,0.0,20,25,0.8,69,141,210,35,34,12,33,95,132,311,1.06,1.03,2013,14,2.1639344262295084,1.0606060606060606,74,5,79,2.6582278481012658
2013-14,RegularSeason,203499,357,Shane Larkin,1610612742,DAL,48,489,52,137,0.38,12,38,0.316,16,25,0.64,11,31,42,71,26,1,39,46,132,139,1.82,0.67,2013,14,2.75,1.8205128205128205,85,9,94,0.44680851063829785
2013-14,RegularSeason,1737,359,Nazr Mohammed,1610612741,CHI,80,562,54,126,0.429,0,0,0.0,16,30,0.533,66,109,175,20,14,30,37,77,124,240,0.54,0.38,2013,14,1.55,0.5405405405405406,72,14,86,2.0348837209302326
2013-14,RegularSeason,2045,360,Hedo Turkoglu,1610612746,LAC,38,392,42,109,0.385,22,50,0.44,9,18,0.5,11,78,89,33,19,10,16,50,115,174,2.06,1.19,2013,14,3.026315789473684,2.0625,67,9,76,1.1710526315789473
2013-14,RegularSeason,203493,360,Reggie Bullock Jr.,1610612746,LAC,43,396,43,121,0.355,22,73,0.301,7,9,0.778,11,43,54,12,9,1,13,26,115,98,0.92,0.69,2013,14,2.6744186046511627,0.9230769230769231,78,2,80,0.675
2013-14,RegularSeason,202970,362,Gustavo Ayon,1610612737,ATL,26,429,52,102,0.51,0,0,0.0,8,20,0.4,42,83,125,28,25,10,29,47,112,209,0.97,0.86,2013,14,4.3076923076923075,0.9655172413793104,50,12,62,2.0161290322580645
2013-14,RegularSeason,202388,363,Donald Sloan,1610612754,IND,48,392,44,117,0.376,10,42,0.238,12,20,0.6,4,40,44,50,10,1,22,19,110,112,2.27,0.46,2013,14,2.2916666666666665,2.272727272727273,73,8,81,0.5432098765432098
2013-14,RegularSeason,101131,364,Jason Maxiell,1610612753,ORL,34,488,47,105,0.448,0,0,0.0,15,31,0.484,28,58,86,9,8,20,14,47,109,144,0.64,0.57,2013,14,3.2058823529411766,0.6428571428571429,58,16,74,1.162162162162162
2013-14,RegularSeason,202721,365,Darius Morris,1610612763,MEM,27,313,39,96,0.406,12,38,0.316,17,26,0.654,7,19,26,44,13,0,27,33,107,97,1.63,0.48,2013,14,3.962962962962963,1.6296296296296295,57,9,66,0.3939393939393939
2013-14,RegularSeason,203104,365,Marquis Teague,1610612751,BKN,40,442,38,119,0.319,5,18,0.278,26,35,0.743,1,39,40,58,10,5,39,46,107,91,1.49,0.26,2013,14,2.675,1.4871794871794872,81,9,90,0.4444444444444444
2013-14,RegularSeason,203497,367,Rudy Gobert,1610612762,UTA,45,434,36,74,0.486,0,0,0.0,32,65,0.492,51,104,155,7,8,41,32,57,104,212,0.22,0.25,2013,14,2.311111111111111,0.21875,38,33,71,2.183098591549296
2013-14,RegularSeason,959,368,Steve Nash,1610612747,LAL,15,313,36,94,0.383,8,24,0.333,22,24,0.917,4,25,29,86,7,2,31,18,102,135,2.77,0.23,2013,14,6.8,2.774193548387097,58,2,60,0.48333333333333334
2013-14,RegularSeason,203477,369,Isaiah Canaan,1610612745,HOU,22,252,31,87,0.356,18,55,0.327,21,29,0.724,7,17,24,22,8,4,21,25,101,74,1.05,0.38,2013,14,4.590909090909091,1.0476190476190477,56,8,64,0.375
2013-14,RegularSeason,203111,370,Orlando Johnson,1610612758,SAC,45,392,36,113,0.319,9,47,0.191,19,26,0.731,9,46,55,20,6,2,15,26,100,84,1.33,0.4,2013,14,2.2222222222222223,1.3333333333333333,77,7,84,0.6547619047619048
2013-14,RegularSeason,2732,371,Ben Gordon,1610612766,CHA,19,279,37,108,0.343,8,29,0.276,17,21,0.81,3,24,27,21,10,2,21,18,99,63,1.0,0.48,2013,14,5.2105263157894735,1.0,71,4,75,0.36
2013-14,RegularSeason,202363,371,Jarvis Varnado,1610612755,PHI,24,339,36,60,0.6,0,0,0.0,27,52,0.519,19,44,63,13,10,29,10,62,99,155,1.3,1.0,2013,14,4.125,1.3,24,25,49,1.2857142857142858
2013-14,RegularSeason,203086,373,Meyers Leonard,1610612757,POR,40,355,41,91,0.451,0,6,0.0,16,21,0.762,26,85,111,18,7,5,15,76,98,169,1.2,0.47,2013,14,2.45,1.2,50,5,55,2.018181818181818
2013-14,RegularSeason,203473,374,Dewayne Dedmon,1610612753,ORL,31,390,38,83,0.458,0,0,0.0,21,32,0.656,38,89,127,5,7,22,18,66,97,184,0.28,0.39,2013,14,3.129032258064516,0.2777777777777778,45,11,56,2.267857142857143
2013-14,RegularSeason,2592,374,James Jones,1610612748,MIA,20,236,31,68,0.456,28,54,0.519,7,11,0.636,2,21,23,9,3,4,4,6,97,91,2.25,0.75,2013,14,4.85,2.25,37,4,41,0.5609756097560976
2013-14,RegularSeason,202347,376,Quincy Pondexter,1610612763,MEM,15,270,31,79,0.392,11,34,0.324,21,26,0.808,10,16,26,20,5,1,15,18,94,78,1.33,0.33,2013,14,6.266666666666667,1.3333333333333333,48,5,53,0.49056603773584906
2013-14,RegularSeason,202725,377,Josh Harrellson,1610612765,DET,32,317,38,82,0.463,12,31,0.387,5,7,0.714,30,46,76,15,6,15,10,44,93,149,1.5,0.6,2013,14,2.90625,1.5,44,2,46,1.6521739130434783
2013-14,RegularSeason,101111,378,Charlie Villanueva,1610612765,DET,20,180,35,92,0.38,14,56,0.25,8,14,0.571,6,28,34,6,4,5,7,16,92,71,0.86,0.57,2013,14,4.6,0.8571428571428571,57,6,63,0.5396825396825397
2013-14,RegularSeason,202332,378,Cole Aldrich,1610612752,NYK,46,330,33,61,0.541,0,0,0.0,26,30,0.867,37,92,129,14,8,30,18,40,92,223,0.78,0.44,2013,14,2.0,0.7777777777777778,28,4,32,4.03125
2013-14,RegularSeason,203116,380,Tyshawn Taylor,1610612751,BKN,23,270,31,91,0.341,3,12,0.25,24,30,0.8,3,12,15,36,12,1,31,29,89,56,1.16,0.39,2013,14,3.869565217391304,1.1612903225806452,60,6,66,0.22727272727272727
2013-14,RegularSeason,203458,381,Alex Len,1610612756,PHX,42,362,33,78,0.423,0,0,0.0,20,31,0.645,39,60,99,4,4,18,26,68,86,129,0.15,0.15,2013,14,2.0476190476190474,0.15384615384615385,45,11,56,1.7678571428571428
2013-14,RegularSeason,1712,382,Antawn Jamison,1610612746,LAC,22,248,29,92,0.315,8,41,0.195,18,25,0.72,9,46,55,7,9,3,7,29,84,81,1.0,1.29,2013,14,3.8181818181818183,1.0,63,7,70,0.7857142857142857
2013-14,RegularSeason,200839,382,Mike Harris,1610612762,UTA,20,225,29,61,0.475,0,2,0.0,26,27,0.963,15,18,33,5,16,7,11,36,84,101,0.46,1.46,2013,14,4.2,0.45454545454545453,32,1,33,1.0
2013-14,RegularSeason,203540,384,Gigi Datome,1610612765,DET,34,238,34,97,0.351,7,39,0.179,8,10,0.8,14,32,46,11,6,1,11,20,83,71,1.0,0.55,2013,14,2.4411764705882355,1.0,63,2,65,0.7076923076923077
2013-14,RegularSeason,977,384,Kobe Bryant,1610612747,LAL,6,177,31,73,0.425,3,16,0.188,18,21,0.857,2,24,26,38,7,1,34,9,83,76,1.12,0.21,2013,14,13.833333333333334,1.1176470588235294,42,3,45,0.5777777777777777
2013-14,RegularSeason,201953,386,Eric Maynor,1610612755,PHI,31,327,32,101,0.317,12,37,0.324,6,11,0.545,9,30,39,52,9,3,29,17,82,82,1.79,0.31,2013,14,2.6451612903225805,1.793103448275862,69,5,74,0.527027027027027
2013-14,RegularSeason,201575,387,Brandon Rush,1610612762,UTA,38,418,30,90,0.333,16,47,0.34,3,5,0.6,5,39,44,24,5,9,20,31,79,79,1.2,0.25,2013,14,2.0789473684210527,1.2,60,2,62,0.7096774193548387
2013-14,RegularSeason,203490,388,Otto Porter Jr.,1610612764,WAS,37,319,33,91,0.363,4,21,0.19,8,12,0.667,21,36,57,10,8,1,14,26,78,78,0.71,0.57,2013,14,2.108108108108108,0.7142857142857143,58,4,62,0.9193548387096774
2013-14,RegularSeason,201171,389,Carl Landry,1610612758,SAC,18,233,31,60,0.517,0,0,0.0,14,17,0.824,15,42,57,5,3,1,9,34,76,101,0.56,0.33,2013,14,4.222222222222222,0.5555555555555556,29,3,32,1.78125
2013-14,RegularSeason,203488,389,Mike Muscala,1610612737,ATL,20,215,31,73,0.425,0,3,0.0,14,14,1.0,17,35,52,7,3,10,12,29,76,94,0.58,0.25,2013,14,3.8,0.5833333333333334,42,0,42,1.2380952380952381
2013-14,RegularSeason,203460,391,Andre Roberson,1610612760,OKC,40,399,33,68,0.485,2,13,0.154,7,10,0.7,36,58,94,15,19,10,19,74,75,156,0.79,1.0,2013,14,1.875,0.7894736842105263,35,3,38,2.473684210526316
2013-14,RegularSeason,202698,391,Chris Singleton,1610612764,WAS,25,250,25,67,0.373,7,19,0.368,18,25,0.72,18,37,55,6,9,3,17,25,75,82,0.35,0.53,2013,14,3.0,0.35294117647058826,42,7,49,1.1224489795918366
2013-14,RegularSeason,2427,393,Roger Mason Jr.,1610612748,MIA,25,260,25,67,0.373,17,48,0.354,7,7,1.0,1,21,22,19,6,1,9,26,74,71,2.11,0.67,2013,14,2.96,2.111111111111111,42,0,42,0.5238095238095238
2013-14,RegularSeason,101179,393,Ronnie Price,1610612753,ORL,31,377,28,92,0.304,9,43,0.209,9,13,0.692,8,35,43,66,25,2,26,50,74,116,2.54,0.96,2013,14,2.3870967741935485,2.5384615384615383,64,4,68,0.6323529411764706
2013-14,RegularSeason,203539,395,Gal Mekel,1610612742,DAL,31,292,30,86,0.349,5,20,0.25,8,12,0.667,5,22,27,63,4,1,31,31,73,77,2.03,0.13,2013,14,2.3548387096774195,2.032258064516129,56,4,60,0.45
2013-14,RegularSeason,202412,395,Manny Harris,1610612747,LAL,9,180,28,70,0.4,7,20,0.35,10,12,0.833,7,27,34,11,4,1,9,10,73,70,1.22,0.44,2013,14,8.11111111111111,1.2222222222222223,42,2,44,0.7727272727272727
2013-14,RegularSeason,1497,397,Chauncey Billups,1610612765,DET,19,309,24,79,0.304,14,48,0.292,10,12,0.833,4,24,28,42,8,1,25,25,72,69,1.68,0.32,2013,14,3.789473684210526,1.68,55,2,57,0.49122807017543857
2013-14,RegularSeason,202091,398,Dionte Christmas,1610612756,PHX,31,198,22,62,0.355,9,31,0.29,18,24,0.75,13,25,38,8,2,3,6,19,71,70,1.33,0.33,2013,14,2.2903225806451615,1.3333333333333333,40,6,46,0.8260869565217391
2013-14,RegularSeason,203546,399,Ian Clark,1610612762,UTA,23,172,26,67,0.388,11,31,0.355,5,7,0.714,3,16,19,15,8,2,14,24,68,55,1.07,0.57,2013,14,2.9565217391304346,1.0714285714285714,41,2,43,0.4418604651162791
2013-14,RegularSeason,202361,399,Landry Fields,1610612761,TOR,30,322,27,67,0.403,0,5,0.0,14,22,0.636,15,44,59,20,10,3,11,25,68,101,1.82,0.91,2013,14,2.2666666666666666,1.8181818181818181,40,8,48,1.2291666666666667
2013-14,RegularSeason,201141,401,Greg Oden,1610612748,MIA,23,212,27,49,0.551,0,0,0.0,13,23,0.565,23,31,54,1,7,13,12,52,67,98,0.08,0.58,2013,14,2.9130434782608696,0.08333333333333333,22,10,32,1.6875
2013-14,RegularSeason,201948,402,Austin Daye,1610612759,SAS,22,148,24,68,0.353,12,37,0.324,6,10,0.6,5,22,27,8,4,4,5,18,66,56,1.6,0.8,2013,14,3.0,1.6,44,4,48,0.5625
2013-14,RegularSeason,201189,403,Aaron Gray,1610612758,SAC,37,354,27,61,0.443,0,1,0.0,11,20,0.55,42,69,111,22,10,8,31,64,65,142,0.71,0.32,2013,14,1.7567567567567568,0.7096774193548387,34,9,43,2.5813953488372094
2013-14,RegularSeason,202350,403,Daniel Orton,1610612755,PHI,22,251,21,47,0.447,0,0,0.0,23,30,0.767,16,45,61,15,6,16,18,38,65,112,0.83,0.33,2013,14,2.9545454545454546,0.8333333333333334,26,7,33,1.8484848484848484
2013-14,RegularSeason,203485,405,Lorenzo Brown,1610612755,PHI,26,224,26,86,0.302,3,30,0.1,9,13,0.692,8,20,28,41,13,3,16,19,64,69,2.56,0.81,2013,14,2.4615384615384617,2.5625,60,4,64,0.4375
2013-14,RegularSeason,200769,406,Shannon Brown,1610612752,NYK,29,251,24,66,0.364,0,2,0.0,15,21,0.714,7,21,28,9,13,0,18,24,63,47,0.5,0.72,2013,14,2.1724137931034484,0.5,42,6,48,0.5833333333333334
2013-14,RegularSeason,203268,407,Jorge Gutierrez,1610612751,BKN,15,244,25,54,0.463,3,12,0.25,9,12,0.75,3,19,22,30,10,1,14,37,62,79,2.14,0.71,2013,14,4.133333333333334,2.142857142857143,29,3,32,0.6875
2013-14,RegularSeason,203491,408,Peyton Siva,1610612765,DET,24,224,18,57,0.316,7,25,0.28,11,15,0.733,2,12,14,34,9,1,18,27,54,51,1.89,0.5,2013,14,2.25,1.8888888888888888,39,4,43,0.32558139534883723
2013-14,RegularSeason,203810,409,Casper Ware,1610612755,PHI,9,116,18,42,0.429,7,21,0.333,5,6,0.833,0,9,9,10,8,0,5,11,48,45,2.0,1.6,2013,14,5.333333333333333,2.0,24,1,25,0.36
2013-14,RegularSeason,202874,409,Chris Wright,1610612749,MIL,8,126,21,35,0.6,0,1,0.0,6,15,0.4,10,10,20,5,7,5,5,17,48,57,1.0,1.4,2013,14,6.0,1.0,14,9,23,0.8695652173913043
2013-14,RegularSeason,203524,411,Solomon Hill,1610612754,IND,28,226,17,40,0.425,7,23,0.304,6,7,0.857,9,32,41,12,5,2,13,19,47,70,0.92,0.39,2013,14,1.6785714285714286,0.9230769230769231,23,1,24,1.7083333333333333
2013-14,RegularSeason,201964,411,Victor Claver,1610612757,POR,21,184,17,42,0.405,3,18,0.167,10,11,0.909,9,30,39,12,3,3,11,16,47,67,1.09,0.27,2013,14,2.238095238095238,1.0909090909090908,25,1,26,1.5
2013-14,RegularSeason,201985,413,AJ Price,1610612750,MIN,28,99,19,46,0.413,6,22,0.273,0,2,0.0,1,9,10,13,1,0,7,5,44,32,1.86,0.14,2013,14,1.5714285714285714,1.8571428571428572,27,2,29,0.3448275862068966
2013-14,RegularSeason,203263,413,James Nunnally,1610612755,PHI,13,165,15,46,0.326,8,25,0.32,6,9,0.667,1,18,19,8,6,2,7,11,44,38,1.14,0.86,2013,14,3.3846153846153846,1.1428571428571428,31,3,34,0.5588235294117647
2013-14,RegularSeason,202779,415,Dwight Buycks,1610612761,TOR,14,146,15,48,0.313,5,17,0.294,8,9,0.889,4,19,23,10,8,0,10,11,43,40,1.0,0.8,2013,14,3.0714285714285716,1.0,33,1,34,0.6764705882352942
2013-14,RegularSeason,203584,416,Troy Daniels,1610612745,HOU,5,75,15,31,0.484,12,25,0.48,0,0,0.0,0,4,4,5,0,0,3,6,42,32,1.67,0.0,2013,14,8.4,1.6666666666666667,16,0,16,0.25
2013-14,RegularSeason,203098,417,John Jenkins,1610612737,ATL,13,158,16,42,0.381,4,18,0.222,4,4,1.0,3,19,22,11,1,1,11,11,40,38,1.0,0.09,2013,14,3.076923076923077,1.0,26,0,26,0.8461538461538461
2013-14,RegularSeason,203479,418,Jamaal Franklin,1610612763,MEM,21,162,16,39,0.41,5,11,0.455,2,2,1.0,4,19,23,6,4,2,11,23,39,40,0.55,0.36,2013,14,1.8571428571428572,0.5454545454545454,23,0,23,1.0
2013-14,RegularSeason,202962,419,Greg Smith,1610612745,HOU,11,100,18,28,0.643,0,0,0.0,2,5,0.4,11,16,27,0,1,2,5,17,38,50,0.0,0.2,2013,14,3.4545454545454546,0.0,10,3,13,2.076923076923077
2013-14,RegularSeason,200811,419,Lou Amundson,1610612741,CHI,19,185,16,32,0.5,0,0,0.0,6,24,0.25,28,27,55,6,9,11,14,49,38,71,0.43,0.64,2013,14,2.0,0.42857142857142855,16,18,34,1.6176470588235294
2013-14,RegularSeason,203508,421,Sergey Karasev,1610612739,CLE,22,156,12,35,0.343,4,19,0.211,9,10,0.9,0,16,16,6,3,1,11,22,37,28,0.55,0.27,2013,14,1.6818181818181819,0.5454545454545454,23,1,24,0.6666666666666666
2013-14,RegularSeason,203102,422,Arnett Moultrie,1610612755,PHI,12,187,16,38,0.421,0,0,0.0,4,5,0.8,11,24,35,2,8,4,7,22,36,55,0.29,1.14,2013,14,3.0,0.2857142857142857,22,1,23,1.5217391304347827
2013-14,RegularSeason,201580,423,JaVale McGee,1610612743,DEN,5,79,17,38,0.447,0,0,0.0,1,1,1.0,10,7,17,2,1,7,8,16,35,33,0.25,0.13,2013,14,7.0,0.25,21,0,21,0.8095238095238095
2013-14,RegularSeason,203459,424,Allen Crabbe,1610612757,POR,15,100,12,33,0.364,6,14,0.429,3,4,0.75,1,8,9,6,2,1,3,10,33,26,2.0,0.67,2013,14,2.2,2.0,21,1,22,0.4090909090909091
2013-14,RegularSeason,203318,425,Glen Rice,1610612764,WAS,11,109,11,37,0.297,5,17,0.294,5,7,0.714,4,16,20,7,6,1,9,7,32,29,0.78,0.67,2013,14,2.909090909090909,0.7777777777777778,26,2,28,0.7142857142857143
2013-14,RegularSeason,203129,426,Tornike Shengelia,1610612741,CHI,26,155,13,28,0.464,0,6,0.0,3,8,0.375,4,12,16,14,3,1,12,18,29,31,1.17,0.25,2013,14,1.1153846153846154,1.1666666666666667,15,5,20,0.8
2013-14,RegularSeason,203108,427,Bernard James,1610612742,DAL,30,146,11,23,0.478,0,1,0.0,6,11,0.545,15,27,42,3,3,8,10,24,28,57,0.3,0.3,2013,14,0.9333333333333333,0.3,12,5,17,2.4705882352941178
2013-14,RegularSeason,201202,427,Joel Anthony,1610612738,BOS,33,186,12,32,0.375,0,0,0.0,4,8,0.5,15,23,38,2,3,12,3,17,28,56,0.67,1.0,2013,14,0.8484848484848485,0.6666666666666666,20,4,24,1.5833333333333333
2013-14,RegularSeason,201934,429,Hasheem Thabeet,1610612760,OKC,23,192,13,23,0.565,0,0,0.0,1,5,0.2,9,31,40,1,4,9,14,47,27,53,0.07,0.29,2013,14,1.173913043478261,0.07142857142857142,10,4,14,2.857142857142857
2013-14,RegularSeason,203099,430,Jared Cunningham,1610612758,SAC,13,80,6,21,0.286,1,7,0.143,13,16,0.813,1,5,6,8,3,0,2,16,26,23,4.0,1.5,2013,14,2.0,4.0,15,3,18,0.3333333333333333
2013-14,RegularSeason,203120,430,Justin Hamilton,1610612748,MIA,8,72,9,20,0.45,3,9,0.333,5,5,1.0,4,3,7,0,5,0,4,8,26,23,0.0,1.25,2013,14,3.25,0.0,11,0,11,0.6363636363636364
2013-14,RegularSeason,203517,430,Nemanja Nedovic,1610612744,GSW,24,142,8,39,0.205,3,18,0.167,7,8,0.875,3,12,15,13,0,1,13,13,26,10,1.0,0.0,2013,14,1.0833333333333333,1.0,31,1,32,0.46875
2013-14,RegularSeason,200756,433,Hilton Armstrong,1610612744,GSW,15,97,9,19,0.474,0,0,0.0,7,16,0.438,19,28,47,5,4,4,6,11,25,60,0.83,0.67,2013,14,1.6666666666666667,0.8333333333333334,10,9,19,2.473684210526316
2013-14,RegularSeason,2215,433,Jason Collins,1610612751,BKN,22,172,11,24,0.458,0,3,0.0,3,4,0.75,7,12,19,4,8,1,7,30,25,36,0.57,1.14,2013,14,1.1363636363636365,0.5714285714285714,13,1,14,1.3571428571428572
2013-14,RegularSeason,203569,435,Chris Babb,1610612738,BOS,14,132,8,30,0.267,6,27,0.222,0,0,0.0,4,13,17,3,6,0,3,13,22,23,1.0,2.0,2013,14,1.5714285714285714,1.0,22,0,22,0.7727272727272727
2013-14,RegularSeason,203502,435,Tony Mitchell,1610612765,DET,21,79,5,12,0.417,1,1,1.0,11,19,0.579,15,11,26,2,6,3,4,9,22,40,0.5,1.5,2013,14,1.0476190476190477,0.5,7,8,15,1.7333333333333334
2013-14,RegularSeason,101183,437,Shavlik Randolph,1610612756,PHX,14,95,7,14,0.5,0,0,0.0,6,11,0.545,7,18,25,1,3,1,5,15,20,33,0.2,0.6,2013,14,1.4285714285714286,0.2,7,5,12,2.0833333333333335
2013-14,RegularSeason,203139,437,Viacheslav Kravtsov,1610612756,PHX,20,59,8,15,0.533,0,0,0.0,4,8,0.5,9,8,17,1,0,1,6,7,20,22,0.17,0.0,2013,14,1.0,0.16666666666666666,7,4,11,1.5454545454545454
2013-14,RegularSeason,203467,439,Carrick Felix,1610612739,CLE,7,38,7,14,0.5,2,5,0.4,3,4,0.75,1,5,6,4,0,0,4,4,19,17,1.0,0.0,2013,14,2.7142857142857144,1.0,7,1,8,0.75
2013-14,RegularSeason,203495,439,Ricky Ledo,1610612742,DAL,11,33,6,17,0.353,3,8,0.375,4,4,1.0,0,2,2,2,1,0,2,2,19,11,1.0,0.5,2013,14,1.7272727272727273,1.0,11,0,11,0.18181818181818182
2013-14,RegularSeason,202933,441,Julyan Stone,1610612761,TOR,21,120,7,17,0.412,2,8,0.25,2,3,0.667,2,18,20,12,3,0,5,13,18,37,2.4,0.6,2013,14,0.8571428571428571,2.4,10,1,11,1.8181818181818181
2013-14,RegularSeason,203496,442,Robert Covington,1610612745,HOU,7,34,6,14,0.429,4,11,0.364,0,0,0.0,2,3,5,0,2,0,1,3,16,14,0.0,2.0,2013,14,2.2857142857142856,0.0,8,0,8,0.625
2013-14,RegularSeason,202952,443,Malcolm Thomas,1610612762,UTA,8,63,7,16,0.438,1,4,0.25,0,2,0.0,5,16,21,2,0,3,9,5,15,21,0.22,0.0,2013,14,1.875,0.2222222222222222,9,2,11,1.9090909090909092
2013-14,RegularSeason,203136,443,Ognjen Kuzmic,1610612744,GSW,21,92,5,13,0.385,0,0,0.0,5,11,0.455,10,11,21,2,3,4,10,17,15,21,0.2,0.3,2013,14,0.7142857142857143,0.2,8,6,14,1.5
2013-14,RegularSeason,1536,443,Stephen Jackson,1610612746,LAC,9,107,6,26,0.231,1,14,0.071,2,4,0.5,2,8,10,5,6,1,6,11,15,9,0.83,1.0,2013,14,1.6666666666666667,0.8333333333333334,20,2,22,0.45454545454545453
2013-14,RegularSeason,203519,446,Adonis Thomas,1610612755,PHI,6,38,6,14,0.429,1,5,0.2,1,1,1.0,0,3,3,3,0,0,1,6,14,11,3.0,0.0,2013,14,2.3333333333333335,3.0,8,0,8,0.375
2013-14,RegularSeason,203480,446,James Southerland,1610612740,NOP,4,30,5,15,0.333,3,6,0.5,1,2,0.5,0,8,8,0,1,2,1,3,14,13,0.0,1.0,2013,14,3.5,0.0,10,1,11,0.7272727272727273
2013-14,RegularSeason,200780,446,Solomon Jones,1610612753,ORL,11,85,6,17,0.353,0,0,0.0,2,4,0.5,8,8,16,2,2,2,2,12,14,21,1.0,1.0,2013,14,1.2727272727272727,1.0,11,2,13,1.2307692307692308
2013-14,RegularSeason,2248,449,Earl Watson,1610612757,POR,24,161,3,11,0.273,2,7,0.286,4,4,1.0,5,10,15,28,5,1,17,33,12,36,1.65,0.29,2013,14,0.5,1.6470588235294117,8,0,8,1.875
2013-14,RegularSeason,2586,449,Keith Bogans,1610612738,BOS,6,55,3,6,0.5,3,6,0.5,3,3,1.0,0,3,3,3,1,0,1,2,12,15,3.0,1.0,2013,14,2.0,3.0,3,0,3,1.0
2013-14,RegularSeason,2229,451,Mike James,1610612741,CHI,11,77,5,21,0.238,1,5,0.2,0,2,0.0,0,7,7,17,2,0,5,11,11,14,3.4,0.4,2013,14,1.0,3.4,16,2,18,0.3888888888888889
2013-14,RegularSeason,202130,451,Reggie Williams,1610612760,OKC,3,17,5,9,0.556,1,3,0.333,0,0,0.0,0,0,0,1,1,0,2,1,11,7,0.5,0.5,2013,14,3.6666666666666665,0.5,4,0,4,0.0
2013-14,RegularSeason,2224,453,Jamaal Tinsley,1610612762,UTA,8,110,4,20,0.2,1,15,0.067,0,0,0.0,2,9,11,23,2,0,9,10,9,20,2.56,0.22,2013,14,1.125,2.5555555555555554,16,0,16,0.6875
2013-14,RegularSeason,201785,453,Othyus Jeffers,1610612750,MIN,6,47,3,6,0.5,0,2,0.0,3,4,0.75,1,8,9,1,0,0,1,3,9,14,1.0,0.0,2013,14,1.5,1.0,3,1,4,2.25
2013-14,RegularSeason,203474,455,DJ Stephens,1610612749,MIL,3,15,3,7,0.429,0,0,0.0,1,1,1.0,1,4,5,0,0,0,0,0,7,8,0.0,0.0,2013,14,2.3333333333333335,,4,0,4,1.25
2013-14,RegularSeason,200758,455,Ronnie Brewer,1610612741,CHI,24,160,3,15,0.2,1,8,0.125,0,2,0.0,2,12,14,10,6,1,2,4,7,22,5.0,3.0,2013,14,0.2916666666666667,5.0,12,2,14,1.0
2013-14,RegularSeason,202345,457,Damion James,1610612759,SAS,5,50,2,9,0.222,0,2,0.0,2,2,1.0,1,11,12,3,0,1,1,3,6,14,3.0,0.0,2013,14,1.2,3.0,7,0,7,1.7142857142857142
2013-14,RegularSeason,203513,457,Erik Murphy,1610612741,CHI,24,62,3,13,0.231,0,3,0.0,0,0,0.0,2,6,8,2,0,4,2,7,6,8,1.0,0.0,2013,14,0.25,1.0,10,0,10,0.8
2013-14,RegularSeason,202380,457,Hamady Ndiaye,1610612758,SAC,14,74,3,9,0.333,0,0,0.0,0,1,0.0,5,13,18,3,0,4,3,15,6,21,1.0,0.0,2013,14,0.42857142857142855,1.0,6,1,7,2.5714285714285716
2013-14,RegularSeason,202498,457,Lance Thomas,1610612740,NOP,5,42,2,9,0.222,0,0,0.0,2,4,0.5,2,5,7,3,0,0,2,4,6,5,1.5,0.0,2013,14,1.2,1.5,7,2,9,0.7777777777777778
2013-14,RegularSeason,2408,457,Melvin Ely,1610612740,NOP,2,27,3,6,0.5,0,0,0.0,0,0,0.0,0,1,1,0,0,1,0,5,6,5,0.0,0.0,2013,14,3.0,,3,0,3,0.3333333333333333
2013-14,RegularSeason,101155,457,Ryan Gomes,1610612760,OKC,5,34,3,8,0.375,0,2,0.0,0,0,0.0,0,4,4,1,0,0,1,5,6,5,1.0,0.0,2013,14,1.2,1.0,5,0,5,0.8
2013-14,RegularSeason,203183,457,Tony Mitchell,1610612749,MIL,3,10,3,5,0.6,0,1,0.0,0,0,0.0,1,0,1,1,1,0,0,0,6,7,0.0,0.0,2013,14,2.0,inf,2,0,2,0.5
2013-14,RegularSeason,2756,464,Sasha Vujacic,1610612746,LAC,2,10,2,5,0.4,1,2,0.5,0,0,0.0,0,3,3,0,1,0,3,1,5,3,0.0,0.33,2013,14,2.5,0.0,3,0,3,1.0
2013-14,RegularSeason,203505,464,Vander Blue,1610612738,BOS,3,15,2,4,0.5,0,1,0.0,1,5,0.2,0,3,3,1,0,0,2,1,5,1,0.5,0.0,2013,14,1.6666666666666667,0.5,2,4,6,0.5
2013-14,RegularSeason,2694,466,Josh Powell,1610612745,HOU,1,19,2,6,0.333,0,0,0.0,0,0,0.0,0,5,5,0,0,1,1,1,4,5,0.0,0.0,2013,14,4.0,0.0,4,0,4,1.25
2013-14,RegularSeason,2740,467,Andris Biedrins,1610612762,UTA,6,45,1,1,1.0,0,0,0.0,1,6,0.167,2,15,17,0,0,0,2,6,3,13,0.0,0.0,2013,14,0.5,0.0,0,5,5,3.4
2013-14,RegularSeason,202620,467,Arinze Onuaku,1610612739,CLE,5,30,1,5,0.2,0,0,0.0,1,2,0.5,2,6,8,3,0,0,1,3,3,8,3.0,0.0,2013,14,0.6,3.0,4,1,5,1.6
2013-14,RegularSeason,203552,467,Seth Curry,1610612739,CLE,2,13,1,3,0.333,1,1,1.0,0,0,0.0,0,1,1,0,2,0,0,0,3,4,0.0,0.0,2013,14,1.5,,2,0,2,0.5
2013-14,RegularSeason,202732,470,DeAndre Liggins,1610612748,MIA,1,1,1,1,1.0,0,0,0.0,0,0,0.0,1,0,1,0,0,0,0,0,2,3,0.0,0.0,2013,14,2.0,,0,0,0,inf
2013-14,RegularSeason,203146,470,Maalik Wayns,1610612746,LAC,2,9,1,2,0.5,0,0,0.0,0,0,0.0,0,2,2,2,2,0,0,4,2,7,0.0,0.0,2013,14,1.0,inf,1,0,1,2.0
2013-14,RegularSeason,202197,470,Shane Edwards,1610612739,CLE,2,12,1,3,0.333,0,0,0.0,0,0,0.0,1,1,2,0,0,0,1,1,2,1,0.0,0.0,2013,14,1.0,0.0,2,0,2,1.0
2013-14,RegularSeason,201203,473,Mustafa Shakur,1610612760,OKC,3,11,0,3,0.0,0,1,0.0,1,2,0.5,0,0,0,4,0,0,2,2,1,-1,2.0,0.0,2013,14,0.3333333333333333,2.0,3,1,4,0.0
2013-14,RegularSeason,203816,473,Scotty Hopson,1610612739,CLE,2,7,0,4,0.0,0,2,0.0,1,2,0.5,0,0,0,1,1,0,0,0,1,-2,0.0,0.0,2013,14,0.5,inf,4,1,5,0.0
2013-14,RegularSeason,203147,475,Chris Smith,1610612752,NYK,2,2,0,0,0.0,0,0,0.0,0,0,0.0,0,0,0,0,0,0,0,0,0,0,0.0,0.0,2013,14,0.0,,0,0,0,
2013-14,RegularSeason,201591,475,DJ White,1610612766,CHA,2,10,0,1,0.0,0,0,0.0,0,0,0.0,0,2,2,0,1,0,0,1,0,2,0.0,0.0,2013,14,0.0,,1,0,1,2.0
2013-14,RegularSeason,203130,475,Darius Johnson-Odom,1610612755,PHI,3,15,0,7,0.0,0,3,0.0,0,2,0.0,0,2,2,1,1,0,2,3,0,-7,0.5,0.5,2013,14,0.0,0.5,7,2,9,0.2222222222222222
2013-14,RegularSeason,202354,475,Dexter Pittman,1610612737,ATL,2,3,0,1,0.0,0,0,0.0,0,2,0.0,3,0,3,0,0,0,0,0,0,0,0.0,0.0,2013,14,0.0,,1,2,3,1.0
2013-14,RegularSeason,203548,475,Elias Harris,1610612747,LAL,2,11,0,1,0.0,0,0,0.0,0,0,0.0,1,0,1,1,1,0,0,0,0,2,0.0,0.0,2013,14,0.0,inf,1,0,1,1.0
2013-14,RegularSeason,2735,475,Josh Childress,1610612740,NOP,4,24,0,0,0.0,0,0,0.0,0,0,0.0,0,3,3,2,1,0,1,1,0,5,2.0,1.0,2013,14,0.0,2.0,0,0,0,inf
2013-14,RegularSeason,2767,475,Royal Ivey,1610612760,OKC,2,5,0,2,0.0,0,1,0.0,0,0,0.0,0,1,1,0,0,0,0,1,0,-1,0.0,0.0,2013,14,0.0,,2,0,2,0.5
2013-14,RegularSeason,203091,475,Royce White,1610612758,SAC,3,9,0,1,0.0,0,0,0.0,0,0,0.0,0,0,0,0,0,0,0,2,0,-1,0.0,0.0,2013,14,0.0,,1,0,1,0.0
2013-14,Playoffs,201142,1,Kevin Durant,1610612760,OKC,19,815,194,422,0.46,43,125,0.344,132,163,0.81,25,145,170,75,19,25,72,41,563,521,1.04,0.26,2013,14,29.63157894736842,1.0416666666666667,228,31,259,0.6563706563706564
2013-14,Playoffs,2544,2,LeBron James,1610612748,MIA,20,763,192,340,0.565,35,86,0.407,129,160,0.806,14,127,141,95,36,11,61,46,548,591,1.56,0.59,2013,14,27.4,1.5573770491803278,148,31,179,0.7877094972067039
2013-14,Playoffs,201566,3,Russell Westbrook,1610612760,OKC,19,735,167,398,0.42,28,100,0.28,145,164,0.884,45,93,138,153,41,6,83,62,507,512,1.84,0.49,2013,14,26.68421052631579,1.8433734939759037,231,19,250,0.552
2013-14,Playoffs,202331,4,Paul George,1610612754,IND,19,781,138,315,0.438,52,129,0.403,101,128,0.789,13,132,145,73,41,7,49,56,429,442,1.49,0.84,2013,14,22.57894736842105,1.489795918367347,177,27,204,0.7107843137254902
2013-14,Playoffs,2225,5,Tony Parker,1610612759,SAS,23,719,168,346,0.486,13,35,0.371,51,70,0.729,5,40,45,111,15,2,62,37,400,314,1.79,0.24,2013,14,17.391304347826086,1.7903225806451613,178,19,197,0.22842639593908629
2013-14,Playoffs,1495,6,Tim Duncan,1610612759,SAS,23,752,149,285,0.523,0,2,0.0,76,100,0.76,65,146,211,45,7,29,26,52,374,480,1.73,0.27,2013,14,16.26086956521739,1.7307692307692308,136,24,160,1.31875
2013-14,Playoffs,2548,7,Dwyane Wade,1610612748,MIA,20,693,139,278,0.5,9,24,0.375,69,90,0.767,16,61,77,77,30,5,54,55,356,331,1.43,0.56,2013,14,17.8,1.4259259259259258,139,21,160,0.48125
2013-14,Playoffs,1938,8,Manu Ginobili,1610612759,SAS,23,586,104,237,0.439,41,105,0.39,81,94,0.862,9,66,75,95,36,2,52,60,330,340,1.83,0.69,2013,14,14.347826086956522,1.8269230769230769,133,13,146,0.5136986301369864
2013-14,Playoffs,202695,9,Kawhi Leonard,1610612759,SAS,23,736,122,239,0.51,31,74,0.419,53,72,0.736,31,124,155,38,39,14,29,66,328,409,1.31,1.34,2013,14,14.26086956521739,1.3103448275862069,117,19,136,1.1397058823529411
2013-14,Playoffs,201933,10,Blake Griffin,1610612746,LAC,13,478,117,234,0.5,1,7,0.143,71,96,0.74,35,61,96,50,16,14,31,54,306,309,1.61,0.52,2013,14,23.53846153846154,1.6129032258064515,117,25,142,0.676056338028169
2013-14,Playoffs,2547,11,Chris Bosh,1610612748,MIA,20,686,116,229,0.507,30,74,0.405,36,48,0.75,24,88,112,21,17,20,14,51,298,329,1.5,1.21,2013,14,14.9,1.5,113,12,125,0.896
2013-14,Playoffs,200746,12,LaMarcus Aldridge,1610612757,POR,11,441,113,250,0.452,2,3,0.667,60,75,0.8,30,87,117,16,7,18,19,40,288,275,0.84,0.37,2013,14,26.181818181818183,0.8421052631578947,137,15,152,0.7697368421052632
2013-14,Playoffs,2561,13,David West,1610612754,IND,19,687,121,245,0.494,2,10,0.2,43,61,0.705,24,104,128,75,14,15,43,57,287,334,1.74,0.33,2013,14,15.105263157894736,1.744186046511628,124,18,142,0.9014084507042254
2013-14,Playoffs,202362,14,Lance Stephenson,1610612754,IND,19,705,100,220,0.455,24,67,0.358,35,49,0.714,24,107,131,80,16,4,46,55,259,310,1.74,0.35,2013,14,13.631578947368421,1.7391304347826086,120,14,134,0.9776119402985075
2013-14,Playoffs,101108,15,Chris Paul,1610612746,LAC,13,472,92,197,0.467,32,70,0.457,41,53,0.774,12,43,55,134,37,0,39,50,257,327,3.44,0.95,2013,14,19.76923076923077,3.4358974358974357,105,12,117,0.4700854700854701
2013-14,Playoffs,2207,16,Joe Johnson,1610612751,BKN,12,469,98,184,0.533,22,53,0.415,36,43,0.837,9,37,46,35,6,3,19,20,254,232,1.84,0.32,2013,14,21.166666666666668,1.8421052631578947,86,7,93,0.4946236559139785
2013-14,Playoffs,203081,17,Damian Lillard,1610612757,POR,11,466,83,189,0.439,27,70,0.386,59,66,0.894,12,44,56,72,11,1,30,29,252,249,2.4,0.37,2013,14,22.90909090909091,2.4,106,7,113,0.49557522123893805
2013-14,Playoffs,201588,18,George Hill,1610612754,IND,19,687,79,178,0.444,28,77,0.364,44,61,0.721,14,58,72,57,23,4,28,43,230,242,2.04,0.82,2013,14,12.105263157894736,2.0357142857142856,99,17,116,0.6206896551724138
2013-14,Playoffs,201980,19,Danny Green,1610612759,SAS,23,529,78,159,0.491,48,101,0.475,9,11,0.818,9,60,69,21,32,17,20,50,213,249,1.05,1.6,2013,14,9.26086956521739,1.05,81,2,83,0.8313253012048193
2013-14,Playoffs,2564,20,Boris Diaw,1610612759,SAS,23,604,80,160,0.5,18,45,0.4,33,48,0.688,25,86,111,78,14,3,29,44,211,293,2.69,0.48,2013,14,9.173913043478262,2.689655172413793,80,15,95,1.168421052631579
2013-14,Playoffs,203078,20,Bradley Beal,1610612764,WAS,11,458,75,177,0.424,22,53,0.415,39,49,0.796,15,40,55,50,18,7,23,31,211,206,2.17,0.78,2013,14,19.181818181818183,2.1739130434782608,102,10,112,0.49107142857142855
2013-14,Playoffs,202704,22,Reggie Jackson,1610612760,OKC,19,531,75,161,0.466,21,53,0.396,39,44,0.886,13,59,72,46,5,4,38,49,210,208,1.21,0.13,2013,14,11.052631578947368,1.2105263157894737,86,5,91,0.7912087912087912
2013-14,Playoffs,201586,23,Serge Ibaka,1610612760,OKC,17,581,87,147,0.592,5,13,0.385,26,34,0.765,31,85,116,12,11,42,20,54,205,298,0.6,0.55,2013,14,12.058823529411764,0.6,60,8,68,1.7058823529411764
2013-14,Playoffs,2037,24,Jamal Crawford,1610612746,LAC,13,313,68,171,0.398,27,79,0.342,39,44,0.886,5,14,19,26,12,2,15,24,202,138,1.73,0.8,2013,14,15.538461538461538,1.7333333333333334,103,5,108,0.17592592592592593
2013-14,Playoffs,951,25,Ray Allen,1610612748,MIA,20,527,59,143,0.413,33,85,0.388,34,37,0.919,13,54,67,32,14,4,24,41,185,191,1.33,0.58,2013,14,9.25,1.3333333333333333,84,3,87,0.7701149425287356
2013-14,Playoffs,202322,26,John Wall,1610612764,WAS,11,420,60,164,0.366,7,32,0.219,52,68,0.765,5,39,44,78,18,8,36,29,179,171,2.17,0.5,2013,14,16.272727272727273,2.1666666666666665,104,16,120,0.36666666666666664
2013-14,Playoffs,201579,27,Roy Hibbert,1610612754,IND,19,542,66,147,0.449,0,1,0.0,44,57,0.772,43,61,104,17,4,26,25,62,176,208,0.68,0.16,2013,14,9.263157894736842,0.68,81,13,94,1.1063829787234043
2013-14,Playoffs,101114,28,Deron Williams,1610612751,BKN,12,428,60,152,0.395,18,53,0.34,36,45,0.8,7,31,38,70,13,2,27,31,174,169,2.59,0.48,2013,14,14.5,2.5925925925925926,92,9,101,0.37623762376237624
2013-14,Playoffs,200755,29,JJ Redick,1610612746,LAC,13,351,61,133,0.459,26,65,0.4,25,26,0.962,4,18,22,19,11,0,13,23,173,139,1.46,0.85,2013,14,13.307692307692308,1.4615384615384615,72,1,73,0.3013698630136986
2013-14,Playoffs,201168,29,Tiago Splitter,1610612759,SAS,23,516,61,100,0.61,0,1,0.0,51,71,0.718,45,95,140,46,16,11,18,53,173,309,2.56,0.89,2013,14,7.521739130434782,2.5555555555555554,39,20,59,2.3728813559322033
2013-14,Playoffs,201988,31,Patty Mills,1610612759,SAS,23,351,63,141,0.447,32,79,0.405,10,13,0.769,3,32,35,33,17,1,14,31,168,159,2.36,1.21,2013,14,7.304347826086956,2.357142857142857,78,3,81,0.43209876543209874
2013-14,Playoffs,201942,32,DeMar DeRozan,1610612761,TOR,7,282,45,117,0.385,6,18,0.333,71,79,0.899,3,26,29,25,8,2,18,23,167,133,1.39,0.44,2013,14,23.857142857142858,1.3888888888888888,72,8,80,0.3625
2013-14,Playoffs,201587,32,Nicolas Batum,1610612757,POR,11,459,67,142,0.472,21,60,0.35,12,15,0.8,10,74,84,53,15,5,28,21,167,218,1.89,0.54,2013,14,15.181818181818182,1.8928571428571428,75,3,78,1.0769230769230769
2013-14,Playoffs,1718,34,Paul Pierce,1610612751,BKN,12,368,60,129,0.465,19,53,0.358,25,32,0.781,4,50,54,24,14,4,20,44,164,164,1.2,0.7,2013,14,13.666666666666666,1.2,69,7,76,0.7105263157894737
2013-14,Playoffs,201935,35,James Harden,1610612745,HOU,6,263,50,133,0.376,16,54,0.296,45,50,0.9,5,23,28,35,12,1,21,21,161,128,1.67,0.57,2013,14,26.833333333333332,1.6666666666666667,83,5,88,0.3181818181818182
2013-14,Playoffs,201939,35,Stephen Curry,1610612744,GSW,7,296,51,116,0.44,22,57,0.386,37,42,0.881,4,21,25,59,12,1,26,18,161,162,2.27,0.46,2013,14,23.0,2.269230769230769,65,5,70,0.35714285714285715
2013-14,Playoffs,202083,37,Wesley Matthews,1610612757,POR,11,426,56,136,0.412,22,68,0.324,26,32,0.813,7,36,43,14,14,5,22,45,160,128,0.64,0.64,2013,14,14.545454545454545,0.6363636363636364,80,6,86,0.5
2013-14,Playoffs,2730,38,Dwight Howard,1610612745,HOU,6,231,58,106,0.547,0,0,0.0,40,64,0.625,27,55,82,11,4,17,19,25,156,179,0.58,0.21,2013,14,26.0,0.5789473684210527,48,24,72,1.1388888888888888
2013-14,Playoffs,2772,39,Trevor Ariza,1610612764,WAS,11,407,52,108,0.481,25,56,0.446,21,27,0.778,21,77,98,19,17,4,14,26,150,212,1.36,1.21,2013,14,13.636363636363637,1.3571428571428572,56,6,62,1.5806451612903225
2013-14,Playoffs,200768,40,Kyle Lowry,1610612761,TOR,7,271,44,109,0.404,17,43,0.395,43,49,0.878,9,24,33,33,6,0,20,27,148,129,1.65,0.3,2013,14,21.142857142857142,1.65,65,6,71,0.4647887323943662
2013-14,Playoffs,101162,41,Marcin Gortat,1610612764,WAS,11,382,58,118,0.492,0,0,0.0,27,41,0.659,36,73,109,16,5,14,20,22,143,193,0.8,0.25,2013,14,13.0,0.8,60,14,74,1.472972972972973
2013-14,Playoffs,101145,41,Monta Ellis,1610612742,DAL,7,249,52,127,0.409,12,34,0.353,27,31,0.871,6,11,17,20,9,1,15,19,143,96,1.33,0.6,2013,14,20.428571428571427,1.3333333333333333,75,4,79,0.21518987341772153
2013-14,Playoffs,2403,43,Nene,1610612764,WAS,10,325,64,138,0.464,0,0,0.0,9,26,0.346,8,45,53,26,9,11,17,36,137,128,1.53,0.53,2013,14,13.7,1.5294117647058822,74,17,91,0.5824175824175825
2013-14,Playoffs,200794,44,Paul Millsap,1610612737,ATL,7,267,41,103,0.398,9,27,0.333,45,56,0.804,21,55,76,20,10,13,20,25,136,162,1.0,0.5,2013,14,19.428571428571427,1.0,62,11,73,1.0410958904109588
2013-14,Playoffs,201952,45,Jeff Teague,1610612737,ATL,7,242,44,112,0.393,9,27,0.333,38,40,0.95,5,21,26,35,7,4,21,15,135,116,1.67,0.33,2013,14,19.285714285714285,1.6666666666666667,68,2,70,0.37142857142857144
2013-14,Playoffs,1717,46,Dirk Nowitzki,1610612742,DAL,7,263,54,126,0.429,1,12,0.083,25,31,0.806,5,51,56,11,6,6,15,20,134,120,0.73,0.4,2013,14,19.142857142857142,0.7333333333333333,72,6,78,0.717948717948718
2013-14,Playoffs,201596,47,Mario Chalmers,1610612748,MIA,20,535,47,111,0.423,15,43,0.349,19,25,0.76,2,44,46,72,19,6,30,48,128,171,2.4,0.63,2013,14,6.4,2.4,64,6,70,0.6571428571428571
2013-14,Playoffs,201599,48,DeAndre Jordan,1610612746,LAC,13,442,46,63,0.73,0,0,0.0,33,76,0.434,43,120,163,10,12,33,23,45,125,260,0.43,0.52,2013,14,9.615384615384615,0.43478260869565216,17,43,60,2.716666666666667
2013-14,Playoffs,201158,48,Marco Belinelli,1610612759,SAS,23,356,44,99,0.444,16,38,0.421,21,22,0.955,4,48,52,19,3,0,12,23,125,131,1.58,0.25,2013,14,5.434782608695652,1.5833333333333333,55,1,56,0.9285714285714286
2013-14,Playoffs,2440,50,Matt Barnes,1610612746,LAC,13,404,45,107,0.421,19,60,0.317,13,19,0.684,22,36,58,23,12,3,17,41,122,133,1.35,0.71,2013,14,9.384615384615385,1.3529411764705883,62,6,68,0.8529411764705882
2013-14,Playoffs,201188,51,Marc Gasol,1610612763,MEM,7,299,47,116,0.405,0,1,0.0,27,34,0.794,13,41,54,31,12,6,12,27,121,136,2.58,1.0,2013,14,17.285714285714285,2.5833333333333335,69,7,76,0.7105263157894737
2013-14,Playoffs,202718,52,Chandler Parsons,1610612745,HOU,6,250,46,105,0.438,13,36,0.361,11,15,0.733,6,35,41,14,4,2,5,19,116,109,2.8,0.8,2013,14,19.333333333333332,2.8,59,4,63,0.6507936507936508
2013-14,Playoffs,2733,52,Shaun Livingston,1610612751,BKN,12,325,44,86,0.512,1,1,1.0,27,37,0.73,8,34,42,40,5,5,22,41,116,134,1.82,0.23,2013,14,9.666666666666666,1.8181818181818181,42,10,52,0.8076923076923077
2013-14,Playoffs,202691,54,Klay Thompson,1610612744,GSW,7,257,40,98,0.408,16,44,0.364,19,24,0.792,4,20,24,25,7,5,15,24,115,98,1.67,0.47,2013,14,16.428571428571427,1.6666666666666667,58,5,63,0.38095238095238093
2013-14,Playoffs,2406,55,Caron Butler,1610612760,OKC,18,419,35,108,0.324,21,59,0.356,22,28,0.786,11,47,58,15,5,2,11,33,113,103,1.36,0.46,2013,14,6.277777777777778,1.3636363636363635,73,6,79,0.7341772151898734
2013-14,Playoffs,201144,56,Mike Conley,1610612763,MEM,7,267,44,102,0.431,3,27,0.111,20,26,0.769,5,27,32,55,14,1,15,14,111,134,3.67,0.93,2013,14,15.857142857142858,3.6666666666666665,58,6,64,0.5
2013-14,Playoffs,201954,57,Darren Collison,1610612746,LAC,13,249,35,90,0.389,1,12,0.083,39,45,0.867,10,17,27,31,6,1,12,17,110,102,2.58,0.5,2013,14,8.461538461538462,2.5833333333333335,55,6,61,0.4426229508196721
2013-14,Playoffs,2449,57,Luis Scola,1610612754,IND,18,243,48,105,0.457,1,3,0.333,13,22,0.591,11,31,42,9,6,3,7,29,110,97,1.29,0.86,2013,14,6.111111111111111,1.2857142857142858,57,9,66,0.6363636363636364
2013-14,Playoffs,201577,57,Robin Lopez,1610612757,POR,11,367,43,88,0.489,0,0,0.0,24,36,0.667,47,54,101,9,5,20,11,40,110,177,0.82,0.46,2013,14,10.0,0.8181818181818182,45,12,57,1.7719298245614035
2013-14,Playoffs,2216,60,Zach Randolph,1610612763,MEM,6,234,42,104,0.404,0,1,0.0,25,41,0.61,17,35,52,14,5,1,10,13,109,93,1.4,0.5,2013,14,18.166666666666668,1.4,62,16,78,0.6666666666666666
2013-14,Playoffs,201228,61,C.J. Watson,1610612754,IND,19,342,37,90,0.411,16,40,0.4,17,28,0.607,3,37,40,18,16,1,14,28,107,104,1.29,1.14,2013,14,5.631578947368421,1.2857142857142858,53,11,64,0.625
2013-14,Playoffs,203141,62,Mirza Teletovic,1610612751,BKN,12,220,36,82,0.439,19,56,0.339,8,12,0.667,15,25,40,3,5,2,5,14,99,94,0.6,1.0,2013,14,8.25,0.6,46,4,50,0.8
2013-14,Playoffs,101135,63,David Lee,1610612744,GSW,7,217,41,77,0.532,0,0,0.0,15,19,0.789,24,40,64,18,4,0,17,28,97,126,1.06,0.23,2013,14,13.857142857142858,1.0588235294117647,36,4,40,1.6
2013-14,Playoffs,1740,64,Rashard Lewis,1610612748,MIA,18,319,35,85,0.412,22,59,0.373,3,4,0.75,4,33,37,5,7,6,5,29,95,94,1.0,1.4,2013,14,5.277777777777778,1.0,50,1,51,0.7254901960784313
2013-14,Playoffs,2594,65,Kyle Korver,1610612737,ATL,7,250,30,66,0.455,23,54,0.426,11,12,0.917,2,35,37,5,4,2,11,15,94,94,0.46,0.36,2013,14,13.428571428571429,0.45454545454545453,36,1,37,1.0
2013-14,Playoffs,2738,66,Andre Iguodala,1610612744,GSW,7,248,32,62,0.516,8,15,0.533,20,33,0.606,5,28,33,31,9,2,21,19,92,103,1.48,0.43,2013,14,13.142857142857142,1.4761904761904763,30,13,43,0.7674418604651163
2013-14,Playoffs,2365,66,Chris Andersen,1610612748,MIA,18,317,33,57,0.579,0,1,0.0,26,38,0.684,26,81,107,5,5,18,9,34,92,182,0.56,0.56,2013,14,5.111111111111111,0.5555555555555556,24,12,36,2.9722222222222223
2013-14,Playoffs,202708,66,Norris Cole,1610612748,MIA,20,404,32,78,0.41,15,40,0.375,13,15,0.867,1,21,22,36,9,1,19,34,92,93,1.9,0.47,2013,14,4.6,1.894736842105263,46,2,48,0.4583333333333333
2013-14,Playoffs,201959,69,Taj Gibson,1610612741,CHI,5,154,32,57,0.561,0,0,0.0,27,36,0.75,21,10,31,2,2,12,8,12,91,96,0.25,0.25,2013,14,18.2,0.25,25,9,34,0.9117647058823529
2013-14,Playoffs,1713,70,Vince Carter,1610612742,DAL,7,190,31,68,0.456,15,31,0.484,11,14,0.786,7,18,25,17,3,2,6,12,88,89,2.83,0.5,2013,14,12.571428571428571,2.8333333333333335,37,3,40,0.625
2013-14,Playoffs,2754,71,Tony Allen,1610612763,MEM,7,230,35,72,0.486,0,7,0.0,16,21,0.762,23,31,54,10,12,1,12,23,86,109,0.83,1.0,2013,14,12.285714285714286,0.8333333333333334,37,5,42,1.2857142857142858
2013-14,Playoffs,203110,72,Draymond Green,1610612744,GSW,7,228,28,60,0.467,8,29,0.276,19,24,0.792,18,40,58,20,12,12,17,33,83,131,1.18,0.71,2013,14,11.857142857142858,1.1764705882352942,32,5,37,1.5675675675675675
2013-14,Playoffs,708,72,Kevin Garnett,1610612751,BKN,12,250,33,63,0.524,0,2,0.0,17,23,0.739,19,57,76,16,9,5,13,25,83,140,1.23,0.69,2013,14,6.916666666666667,1.2307692307692308,30,6,36,2.111111111111111
2013-14,Playoffs,2734,74,Devin Harris,1610612742,DAL,7,176,31,66,0.47,11,25,0.44,7,8,0.875,1,16,17,27,2,2,11,13,80,81,2.46,0.18,2013,14,11.428571428571429,2.4545454545454546,35,1,36,0.4722222222222222
2013-14,Playoffs,202689,75,Kemba Walker,1610612766,CHA,4,153,26,55,0.473,12,24,0.5,14,18,0.778,1,14,15,24,8,3,15,6,78,80,1.6,0.53,2013,14,19.5,1.6,29,4,33,0.45454545454545453
2013-14,Playoffs,101161,76,Amir Johnson,1610612761,TOR,7,191,34,52,0.654,0,2,0.0,9,12,0.75,16,26,42,7,3,4,12,29,77,100,0.58,0.25,2013,14,11.0,0.5833333333333334,18,3,21,2.0
2013-14,Playoffs,101154,76,Andray Blatche,1610612751,BKN,12,172,26,58,0.448,0,2,0.0,25,30,0.833,25,35,60,4,6,2,10,22,77,102,0.4,0.6,2013,14,6.416666666666667,0.4,32,5,37,1.6216216216216217
2013-14,Playoffs,202685,78,Jonas Valanciunas,1610612761,TOR,7,200,31,49,0.633,0,0,0.0,14,22,0.636,19,49,68,2,0,7,19,22,76,108,0.1,0.0,2013,14,10.857142857142858,0.10526315789473684,18,8,26,2.6153846153846154
2013-14,Playoffs,965,79,Derek Fisher,1610612760,OKC,19,299,23,73,0.315,12,41,0.293,15,15,1.0,6,27,33,16,13,0,6,27,73,79,2.67,2.17,2013,14,3.8421052631578947,2.6666666666666665,50,0,50,0.66
2013-14,Playoffs,202335,79,Patrick Patterson,1610612761,TOR,7,199,26,48,0.542,7,18,0.389,14,18,0.778,12,35,47,9,3,3,6,13,73,103,1.5,0.5,2013,14,10.428571428571429,1.5,22,4,26,1.8076923076923077
2013-14,Playoffs,101181,81,Jose Calderon,1610612742,DAL,7,191,30,65,0.462,11,23,0.478,1,1,1.0,2,7,9,31,1,0,7,16,72,71,4.43,0.14,2013,14,10.285714285714286,4.428571428571429,35,0,35,0.2571428571428571
2013-14,Playoffs,101187,82,Alan Anderson,1610612751,BKN,12,261,25,62,0.403,9,31,0.29,12,18,0.667,10,22,32,15,10,0,10,32,71,75,1.5,1.0,2013,14,5.916666666666667,1.5,37,6,43,0.7441860465116279
2013-14,Playoffs,202349,82,Greivis Vasquez,1610612761,TOR,7,190,27,64,0.422,10,27,0.37,7,9,0.778,3,23,26,36,4,1,10,22,71,89,3.6,0.4,2013,14,10.142857142857142,3.6,37,2,39,0.6666666666666666
2013-14,Playoffs,201584,84,Courtney Lee,1610612763,MEM,7,224,25,60,0.417,6,19,0.316,14,18,0.778,3,11,14,11,5,2,6,20,70,57,1.83,0.83,2013,14,10.0,1.8333333333333333,35,4,39,0.358974358974359
2013-14,Playoffs,203500,84,Steven Adams,1610612760,OKC,18,331,31,45,0.689,0,0,0.0,8,23,0.348,22,52,74,4,1,24,10,48,70,134,0.4,0.1,2013,14,3.888888888888889,0.4,14,15,29,2.5517241379310347
2013-14,Playoffs,202391,86,Jeremy Lin,1610612745,HOU,6,177,25,61,0.41,5,23,0.217,13,16,0.813,7,15,22,26,3,1,13,15,68,68,2.0,0.23,2013,14,11.333333333333334,2.0,36,3,39,0.5641025641025641
2013-14,Playoffs,202710,86,Jimmy Butler,1610612741,CHI,5,218,22,57,0.386,6,20,0.3,18,23,0.783,6,20,26,11,6,0,3,13,68,68,3.67,2.0,2013,14,13.6,3.6666666666666665,35,5,40,0.65
2013-14,Playoffs,201571,88,D.J. Augustin,1610612741,CHI,5,141,21,72,0.292,7,26,0.269,17,19,0.895,4,4,8,24,3,0,9,16,66,39,2.67,0.33,2013,14,13.2,2.6666666666666665,51,2,53,0.1509433962264151
2013-14,Playoffs,2399,88,Mike Dunleavy,1610612741,CHI,5,163,25,53,0.472,12,26,0.462,4,6,0.667,5,13,18,12,3,1,5,7,66,65,2.4,0.6,2013,14,13.2,2.4,28,2,30,0.6
2013-14,Playoffs,203118,88,Mike Scott,1610612737,ATL,7,146,23,63,0.365,10,31,0.323,10,14,0.714,3,15,18,3,1,0,2,11,66,42,1.5,0.5,2013,14,9.428571428571429,1.5,40,4,44,0.4090909090909091
2013-14,Playoffs,201960,91,DeMarre Carroll,1610612737,ATL,7,246,23,49,0.469,9,22,0.409,7,11,0.636,12,22,34,11,5,3,8,21,62,77,1.38,0.63,2013,14,8.857142857142858,1.375,26,4,30,1.1333333333333333
2013-14,Playoffs,2570,92,Kendrick Perkins,1610612760,OKC,19,384,24,45,0.533,0,0,0.0,12,15,0.8,33,69,102,14,4,6,25,64,60,137,0.56,0.16,2013,14,3.1578947368421053,0.56,21,3,24,4.25
2013-14,Playoffs,201977,93,Marcus Thornton,1610612751,BKN,10,124,21,54,0.389,5,21,0.238,12,18,0.667,7,12,19,1,2,1,2,4,59,41,0.5,1.0,2013,14,5.9,0.5,33,6,39,0.48717948717948717
2013-14,Playoffs,2590,93,Mo Williams,1610612757,POR,8,187,22,59,0.373,5,21,0.238,10,11,0.909,2,10,12,15,3,0,14,24,59,37,1.07,0.21,2013,14,7.375,1.0714285714285714,37,1,38,0.3157894736842105
2013-14,Playoffs,1890,93,Shawn Marion,1610612742,DAL,7,193,24,59,0.407,4,18,0.222,7,11,0.636,14,23,37,13,6,1,5,11,59,72,2.6,1.2,2013,14,8.428571428571429,2.6,35,4,39,0.9487179487179487
2013-14,Playoffs,101150,96,Lou Williams,1610612737,ATL,7,133,19,50,0.38,5,16,0.313,15,16,0.938,0,16,16,8,7,1,13,10,58,45,0.61,0.54,2013,14,8.285714285714286,0.6153846153846154,31,1,32,0.5
2013-14,Playoffs,202714,97,Shelvin Mack,1610612737,ATL,7,118,19,47,0.404,10,27,0.37,9,12,0.75,3,10,13,25,4,0,6,10,57,62,4.17,0.67,2013,14,8.142857142857142,4.166666666666667,28,3,31,0.41935483870967744
2013-14,Playoffs,2744,98,Al Jefferson,1610612766,CHA,3,106,26,53,0.491,0,0,0.0,4,5,0.8,6,22,28,2,1,5,1,7,56,63,2.0,1.0,2013,14,18.666666666666668,2.0,27,1,28,1.0
2013-14,Playoffs,200757,98,Thabo Sefolosha,1610612760,OKC,15,236,23,55,0.418,6,23,0.261,4,5,0.8,7,24,31,10,10,0,7,10,56,67,1.43,1.43,2013,14,3.7333333333333334,1.4285714285714286,32,1,33,0.9393939393939394
2013-14,Playoffs,2757,100,Beno Udrih,1610612763,MEM,7,115,21,45,0.467,4,12,0.333,9,13,0.692,2,10,12,12,3,0,9,11,55,45,1.33,0.33,2013,14,7.857142857142857,1.3333333333333333,24,4,28,0.42857142857142855
2013-14,Playoffs,203084,100,Harrison Barnes,1610612744,GSW,7,156,19,48,0.396,8,21,0.381,9,16,0.563,7,21,28,8,1,3,5,13,55,54,1.6,0.2,2013,14,7.857142857142857,1.6,29,7,36,0.7777777777777778
2013-14,Playoffs,2550,100,Kirk Hinrich,1610612741,CHI,5,167,23,56,0.411,7,19,0.368,2,4,0.5,1,14,15,22,4,1,11,22,55,51,2.0,0.36,2013,14,11.0,2.0,33,2,35,0.42857142857142855
2013-14,Playoffs,2592,103,James Jones,1610612748,MIA,15,126,18,40,0.45,15,32,0.469,2,3,0.667,3,8,11,5,3,2,0,17,53,51,0.0,0.0,2013,14,3.533333333333333,inf,22,1,23,0.4782608695652174
2013-14,Playoffs,201149,104,Joakim Noah,1610612741,CHI,5,210,21,41,0.512,0,0,0.0,10,17,0.588,15,49,64,23,5,7,19,19,52,105,1.21,0.26,2013,14,10.4,1.2105263157894737,20,7,27,2.3703703703703702
2013-14,Playoffs,201976,104,Patrick Beverley,1610612745,HOU,6,202,19,50,0.38,7,22,0.318,7,10,0.7,13,12,25,11,3,2,4,21,52,55,2.75,0.75,2013,14,8.666666666666666,2.75,31,3,34,0.7352941176470589
2013-14,Playoffs,2034,106,Mike Miller,1610612763,MEM,7,173,15,42,0.357,14,29,0.483,7,9,0.778,2,24,26,9,6,0,5,16,51,58,1.8,1.2,2013,14,7.285714285714286,1.8,27,2,29,0.896551724137931
2013-14,Playoffs,201175,107,Glen Davis,1610612746,LAC,13,158,25,41,0.61,0,0,0.0,0,0,0.0,14,22,36,9,3,3,7,24,50,78,1.29,0.43,2013,14,3.8461538461538463,1.2857142857142858,16,0,16,2.25
2013-14,Playoffs,2430,108,Carlos Boozer,1610612741,CHI,5,121,20,47,0.426,0,0,0.0,8,9,0.889,8,31,39,5,1,0,7,13,48,58,0.71,0.14,2013,14,9.6,0.7142857142857143,27,1,28,1.3928571428571428
2013-14,Playoffs,202709,108,Cory Joseph,1610612759,SAS,17,87,17,35,0.486,0,3,0.0,14,18,0.778,1,8,9,9,3,0,4,7,48,43,2.25,0.75,2013,14,2.823529411764706,2.25,18,4,22,0.4090909090909091
2013-14,Playoffs,201177,110,Josh McRoberts,1610612766,CHA,4,154,15,33,0.455,8,17,0.471,8,10,0.8,1,26,27,15,4,1,6,13,46,67,2.5,0.67,2013,14,11.5,2.5,18,2,20,1.35
2013-14,Playoffs,203093,110,Terrence Jones,1610612745,HOU,6,138,20,39,0.513,0,1,0.0,6,12,0.5,17,20,37,8,5,3,2,13,46,72,4.0,2.5,2013,14,7.666666666666667,4.0,19,6,25,1.48
2013-14,Playoffs,202390,112,Gary Neal,1610612766,CHA,4,104,18,51,0.353,4,18,0.222,5,7,0.714,3,5,8,4,0,0,8,9,45,14,0.5,0.0,2013,14,11.25,0.5,33,2,35,0.22857142857142856
2013-14,Playoffs,203115,112,Will Barton,1610612757,POR,7,81,17,34,0.5,6,11,0.545,5,6,0.833,5,7,12,3,1,2,6,7,45,39,0.5,0.17,2013,14,6.428571428571429,0.5,17,1,18,0.6666666666666666
2013-14,Playoffs,1889,114,Andre Miller,1610612764,WAS,11,108,19,41,0.463,1,3,0.333,5,9,0.556,2,9,11,9,3,0,8,12,44,33,1.13,0.38,2013,14,4.0,1.125,22,4,26,0.4230769230769231
2013-14,Playoffs,201578,114,Marreese Speights,1610612744,GSW,7,68,19,36,0.528,0,0,0.0,6,12,0.5,9,13,22,3,2,4,2,12,44,50,1.5,1.0,2013,14,6.285714285714286,1.5,17,6,23,0.9565217391304348
2013-14,Playoffs,979,116,Jermaine O'Neal,1610612744,GSW,7,84,18,32,0.563,0,0,0.0,6,8,0.75,12,12,24,1,1,3,4,12,42,51,0.25,0.25,2013,14,6.0,0.25,14,2,16,1.5
2013-14,Playoffs,101110,116,Martell Webster,1610612764,WAS,11,195,15,41,0.366,6,26,0.231,6,9,0.667,4,21,25,5,4,5,4,14,42,48,1.25,1.0,2013,14,3.8181818181818183,1.25,26,3,29,0.8620689655172413
2013-14,Playoffs,201971,118,DeJuan Blair,1610612742,DAL,6,81,16,27,0.593,0,0,0.0,8,13,0.615,14,23,37,1,12,0,5,14,40,69,0.2,2.4,2013,14,6.666666666666667,0.2,11,5,16,2.3125
2013-14,Playoffs,203087,118,Jeremy Lamb,1610612760,OKC,11,100,17,42,0.405,2,14,0.143,4,4,1.0,4,12,16,7,7,1,3,8,40,43,2.33,2.33,2013,14,3.6363636363636362,2.3333333333333335,25,0,25,0.64
2013-14,Playoffs,2617,118,Udonis Haslem,1610612748,MIA,16,169,17,37,0.459,0,0,0.0,6,10,0.6,12,29,41,4,1,3,1,28,40,64,4.0,1.0,2013,14,2.5,4.0,20,4,24,1.7083333333333333
2013-14,Playoffs,202323,121,Evan Turner,1610612754,IND,12,149,15,35,0.429,4,7,0.571,5,5,1.0,0,26,26,19,4,0,11,9,39,57,1.73,0.36,2013,14,3.25,1.7272727272727273,20,0,20,1.3
2013-14,Playoffs,201945,121,Gerald Henderson,1610612766,CHA,4,119,14,37,0.378,0,9,0.0,11,17,0.647,1,15,16,9,4,1,6,12,39,34,1.5,0.67,2013,14,9.75,1.5,23,6,29,0.5517241379310345
2013-14,Playoffs,201604,123,Chris Douglas-Roberts,1610612766,CHA,4,70,11,16,0.688,4,8,0.5,12,14,0.857,2,6,8,2,0,0,4,11,38,37,0.5,0.0,2013,14,9.5,0.5,5,2,7,1.1428571428571428
2013-14,Playoffs,101133,124,Ian Mahinmi,1610612754,IND,19,241,13,27,0.481,0,0,0.0,11,18,0.611,22,23,45,3,5,16,10,38,37,75,0.3,0.5,2013,14,1.9473684210526316,0.3,14,7,21,2.142857142857143
2013-14,Playoffs,202348,124,Jordan Crawford,1610612744,GSW,6,57,12,33,0.364,2,7,0.286,11,14,0.786,4,5,9,2,1,0,5,7,37,20,0.4,0.2,2013,14,6.166666666666667,0.4,21,3,24,0.375
2013-14,Playoffs,2203,124,Shane Battier,1610612748,MIA,16,202,12,26,0.462,9,20,0.45,4,5,0.8,1,9,10,5,5,1,5,23,37,38,1.0,1.0,2013,14,2.3125,1.0,14,1,15,0.6666666666666666
2013-14,Playoffs,203142,127,Chris Copeland,1610612754,IND,12,82,12,28,0.429,6,16,0.375,6,9,0.667,1,4,5,1,3,3,5,13,36,24,0.2,0.6,2013,14,3.0,0.2,16,3,19,0.2631578947368421
2013-14,Playoffs,203082,128,Terrence Ross,1610612761,TOR,7,158,14,47,0.298,4,24,0.167,3,5,0.6,1,13,14,2,6,3,8,19,35,17,0.25,0.75,2013,14,5.0,0.25,33,2,35,0.4
2013-14,Playoffs,201600,128,Ömer Aşik,1610612745,HOU,6,163,16,33,0.485,0,0,0.0,3,3,1.0,21,28,49,4,3,4,11,29,35,67,0.36,0.27,2013,14,5.833333333333333,0.36363636363636365,17,0,17,2.8823529411764706
2013-14,Playoffs,101122,130,Danny Granger,1610612746,LAC,13,134,11,40,0.275,5,22,0.227,7,9,0.778,2,18,20,3,6,1,3,24,34,30,1.0,2.0,2013,14,2.6153846153846154,1.0,29,2,31,0.6451612903225806
2013-14,Playoffs,2400,130,Drew Gooden,1610612764,WAS,10,146,14,38,0.368,0,4,0.0,6,8,0.75,20,22,42,4,3,4,4,30,34,57,1.0,0.75,2013,14,3.4,1.0,24,2,26,1.6153846153846154
2013-14,Playoffs,203077,130,Michael Kidd-Gilchrist,1610612766,CHA,4,91,14,27,0.519,0,1,0.0,6,10,0.6,8,18,26,6,0,2,8,13,34,43,0.75,0.0,2013,14,8.5,0.75,13,4,17,1.5294117647058822
2013-14,Playoffs,201148,133,Brandan Wright,1610612742,DAL,6,90,15,18,0.833,0,0,0.0,3,6,0.5,5,7,12,8,2,6,2,8,33,53,4.0,1.0,2013,14,5.5,4.0,3,3,6,2.0
2013-14,Playoffs,2555,133,Nick Collison,1610612760,OKC,17,183,12,29,0.414,2,5,0.4,7,10,0.7,12,26,38,13,4,7,6,28,33,69,2.17,0.67,2013,14,1.9411764705882353,2.1666666666666665,17,3,20,1.9
2013-14,Playoffs,203382,135,Aron Baynes,1610612759,SAS,14,101,12,24,0.5,0,1,0.0,8,10,0.8,12,19,31,0,3,0,7,15,32,45,0.0,0.43,2013,14,2.2857142857142856,0.0,12,2,14,2.2142857142857144
2013-14,Playoffs,2223,135,Samuel Dalembert,1610612742,DAL,7,135,11,24,0.458,0,0,0.0,10,15,0.667,23,36,59,0,2,10,4,15,32,81,0.0,0.5,2013,14,4.571428571428571,0.0,13,5,18,3.2777777777777777
2013-14,Playoffs,203080,135,Thomas Robinson,1610612757,POR,11,122,13,31,0.419,0,0,0.0,6,7,0.857,10,18,28,6,5,5,5,23,32,52,1.2,1.0,2013,14,2.909090909090909,1.2,18,1,19,1.4736842105263157
2013-14,Playoffs,203584,138,Troy Daniels,1610612745,HOU,4,68,9,17,0.529,8,15,0.533,5,5,1.0,3,6,9,1,2,0,2,10,31,33,0.5,1.0,2013,14,7.75,0.5,8,0,8,1.125
2013-14,Playoffs,202344,139,Trevor Booker,1610612764,WAS,9,146,13,29,0.448,0,2,0.0,4,6,0.667,16,23,39,8,2,9,3,25,30,67,2.67,0.67,2013,14,3.3333333333333335,2.6666666666666665,16,2,18,2.1666666666666665
2013-14,Playoffs,2748,140,Dorell Wright,1610612757,POR,8,88,7,19,0.368,4,12,0.333,11,15,0.733,2,14,16,3,3,9,5,8,29,39,0.6,0.6,2013,14,3.625,0.6,12,4,16,1.0
2013-14,Playoffs,2588,141,Matt Bonner,1610612759,SAS,22,136,10,21,0.476,4,12,0.333,3,4,0.75,2,12,14,11,2,1,2,12,27,41,5.5,1.0,2013,14,1.2272727272727273,5.5,11,1,12,1.1666666666666667
2013-14,Playoffs,1905,142,Andrei Kirilenko,1610612751,BKN,10,144,7,15,0.467,0,0,0.0,11,17,0.647,10,13,23,10,10,3,3,11,25,54,3.33,3.33,2013,14,2.5,3.3333333333333335,8,6,14,1.6428571428571428
2013-14,Playoffs,203486,143,Mason Plumlee,1610612751,BKN,10,114,7,16,0.438,0,0,0.0,8,18,0.444,5,18,23,2,3,7,9,24,22,29,0.22,0.33,2013,14,2.2,0.2222222222222222,9,10,19,1.2105263157894737
2013-14,Playoffs,203544,143,Pero Antic,1610612737,ATL,7,170,7,42,0.167,3,25,0.12,5,8,0.625,10,17,27,5,5,3,8,26,22,16,0.63,0.63,2013,14,3.142857142857143,0.625,35,3,38,0.7105263157894737
2013-14,Playoffs,2419,145,Tayshaun Prince,1610612763,MEM,7,113,10,26,0.385,1,4,0.25,0,0,0.0,4,6,10,6,1,0,1,8,21,21,6.0,1.0,2013,14,3.0,6.0,16,0,16,0.625
2013-14,Playoffs,203109,146,Jae Crowder,1610612742,DAL,7,81,8,18,0.444,3,7,0.429,0,0,0.0,4,8,12,2,2,1,3,13,19,23,0.67,0.67,2013,14,2.7142857142857144,0.6666666666666666,10,0,10,1.2
2013-14,Playoffs,201949,146,James Johnson,1610612763,MEM,3,28,5,15,0.333,2,5,0.4,7,10,0.7,4,2,6,0,1,0,0,3,19,13,0.0,0.0,2013,14,6.333333333333333,,10,3,13,0.46153846153846156
2013-14,Playoffs,2446,146,Rasual Butler,1610612754,IND,11,70,6,15,0.4,5,12,0.417,2,2,1.0,0,6,6,1,1,1,1,3,19,18,1.0,1.0,2013,14,1.7272727272727273,1.0,9,0,9,0.6666666666666666
2013-14,Playoffs,201585,149,Kosta Koufos,1610612763,MEM,7,45,7,16,0.438,0,0,0.0,4,4,1.0,7,8,15,2,2,3,3,7,18,28,0.67,0.67,2013,14,2.5714285714285716,0.6666666666666666,9,0,9,1.6666666666666667
2013-14,Playoffs,1733,150,Al Harrington,1610612764,WAS,7,59,6,15,0.4,0,7,0.0,5,7,0.714,1,15,16,0,3,0,4,14,17,21,0.0,0.75,2013,14,2.4285714285714284,0.0,9,2,11,1.4545454545454546
2013-14,Playoffs,201965,150,Jeff Ayres,1610612759,SAS,17,65,6,13,0.462,0,0,0.0,5,8,0.625,6,13,19,5,0,0,1,6,17,30,5.0,0.0,2013,14,1.0,5.0,7,3,10,1.9
2013-14,Playoffs,203103,150,Perry Jones III,1610612760,OKC,11,55,7,18,0.389,3,10,0.3,0,0,0.0,3,6,9,1,0,1,1,9,17,16,1.0,0.0,2013,14,1.5454545454545454,1.0,11,0,11,0.8181818181818182
2013-14,Playoffs,2045,153,Hedo Turkoglu,1610612746,LAC,5,41,6,13,0.462,4,10,0.4,0,0,0.0,0,5,5,1,3,0,0,3,16,18,0.0,0.0,2013,14,3.2,inf,7,0,7,0.7142857142857143
2013-14,Playoffs,2422,154,John Salmons,1610612761,TOR,6,77,5,17,0.294,2,12,0.167,1,1,1.0,0,6,6,5,2,0,1,9,13,13,5.0,2.0,2013,14,2.1666666666666665,5.0,12,0,12,0.5
2013-14,Playoffs,201563,155,Michael Beasley,1610612748,MIA,4,23,5,10,0.5,0,0,0.0,1,3,0.333,2,2,4,2,0,0,1,3,11,9,2.0,0.0,2013,14,2.75,2.0,5,2,7,0.5714285714285714
2013-14,Playoffs,2581,155,Steve Blake,1610612744,GSW,6,45,4,12,0.333,3,10,0.3,0,1,0.0,1,3,4,2,0,0,2,2,11,6,1.0,0.0,2013,14,1.8333333333333333,1.0,8,1,9,0.4444444444444444
2013-14,Playoffs,2557,157,Luke Ridnour,1610612766,CHA,4,36,4,13,0.308,2,6,0.333,0,0,0.0,0,4,4,12,0,1,4,1,10,14,3.0,0.0,2013,14,2.5,3.0,9,0,9,0.4444444444444444
2013-14,Playoffs,201962,157,Toney Douglas,1610612748,MIA,10,29,3,9,0.333,3,6,0.5,1,2,0.5,1,3,4,5,0,0,1,3,10,11,5.0,0.0,2013,14,1.0,5.0,6,1,7,0.5714285714285714
2013-14,Playoffs,201162,159,Jared Dudley,1610612746,LAC,7,45,3,11,0.273,3,6,0.5,0,0,0.0,0,6,6,2,1,0,0,5,9,10,0.0,0.0,2013,14,1.2857142857142858,inf,8,0,8,0.75
2013-14,Playoffs,202720,159,Jon Leuer,1610612763,MEM,3,23,3,7,0.429,1,2,0.5,2,2,1.0,2,6,8,2,1,0,0,2,9,16,0.0,0.0,2013,14,3.0,inf,4,0,4,2.0
2013-14,Playoffs,202687,161,Bismack Biyombo,1610612766,CHA,3,48,3,5,0.6,0,0,0.0,2,6,0.333,5,6,11,1,0,2,0,4,8,16,0.0,0.0,2013,14,2.6666666666666665,inf,2,4,6,1.8333333333333333
2013-14,Playoffs,203469,161,Cody Zeller,1610612766,CHA,4,53,3,9,0.333,0,0,0.0,2,4,0.5,5,4,9,2,0,3,2,3,8,12,1.0,0.0,2013,14,2.0,1.0,6,2,8,1.125
2013-14,Playoffs,1882,161,Elton Brand,1610612737,ATL,7,81,2,12,0.167,0,0,0.0,4,5,0.8,7,16,23,6,1,6,0,10,8,33,0.0,0.0,2013,14,1.1428571428571428,inf,10,1,11,2.090909090909091
2013-14,Playoffs,200756,161,Hilton Armstrong,1610612744,GSW,7,17,4,8,0.5,0,1,0.0,0,2,0.0,3,1,4,2,0,2,4,6,8,6,0.5,0.0,2013,14,1.1428571428571428,0.5,4,2,6,0.6666666666666666
2013-14,Playoffs,201961,161,Wayne Ellington,1610612742,DAL,2,14,2,6,0.333,2,6,0.333,2,2,1.0,0,2,2,2,0,0,2,1,8,6,1.0,0.0,2013,14,4.0,1.0,4,0,4,0.5
2013-14,Playoffs,202388,166,Donald Sloan,1610612754,IND,4,15,2,7,0.286,1,4,0.25,2,4,0.5,0,1,1,3,1,0,2,0,7,3,1.5,0.5,2013,14,1.75,1.5,5,2,7,0.14285714285714285
2013-14,Playoffs,101128,166,Francisco Garcia,1610612745,HOU,2,22,2,6,0.333,0,3,0.0,3,4,0.75,1,1,2,0,0,0,0,3,7,4,0.0,0.0,2013,14,3.5,,4,1,5,0.4
2013-14,Playoffs,201946,166,Tyler Hansbrough,1610612761,TOR,3,29,1,3,0.333,0,0,0.0,5,6,0.833,2,4,6,1,0,0,2,8,7,9,0.5,0.0,2013,14,2.3333333333333335,0.5,2,1,3,2.0
2013-14,Playoffs,201229,169,Anthony Tolliver,1610612766,CHA,4,21,1,2,0.5,1,2,0.5,3,3,1.0,1,3,4,1,0,0,0,2,6,10,0.0,0.0,2013,14,1.5,inf,1,0,1,4.0
2013-14,Playoffs,101236,169,Chuck Hayes,1610612761,TOR,5,38,2,8,0.25,0,0,0.0,2,2,1.0,4,4,8,2,3,0,1,5,6,12,2.0,3.0,2013,14,1.2,2.0,6,0,6,1.3333333333333333
2013-14,Playoffs,202334,169,Ed Davis,1610612763,MEM,7,25,3,10,0.3,0,0,0.0,0,1,0.0,8,7,15,0,1,3,2,2,6,15,0.0,0.5,2013,14,0.8571428571428571,0.0,7,1,8,1.875
2013-14,Playoffs,203471,172,Dennis Schroder,1610612737,ATL,2,7,2,2,1.0,1,1,1.0,0,0,0.0,0,2,2,0,0,0,0,1,5,7,0.0,0.0,2013,14,2.5,,0,0,0,inf
2013-14,Playoffs,202066,172,Garrett Temple,1610612764,WAS,10,9,2,2,1.0,1,1,1.0,0,0,0.0,0,0,0,0,0,0,1,5,5,4,0.0,0.0,2013,14,0.5,0.0,0,0,0,
2013-14,Playoffs,2584,172,Willie Green,1610612746,LAC,5,19,1,5,0.2,1,4,0.25,2,2,1.0,0,7,7,1,3,0,1,3,5,11,1.0,3.0,2013,14,1.0,1.0,4,0,4,1.75
2013-14,Playoffs,203468,175,CJ McCollum,1610612757,POR,6,24,1,11,0.091,0,5,0.0,2,2,1.0,0,1,1,0,0,0,1,2,4,-6,0.0,0.0,2013,14,0.6666666666666666,0.0,10,0,10,0.1
2013-14,Playoffs,201858,175,Cartier Martin,1610612737,ATL,3,15,2,3,0.667,0,0,0.0,0,0,0.0,1,2,3,0,2,0,1,2,4,7,0.0,2.0,2013,14,1.3333333333333333,0.0,1,0,1,3.0
2013-14,Playoffs,202730,175,Lavoy Allen,1610612754,IND,4,15,2,4,0.5,0,0,0.0,0,0,0.0,1,4,5,1,0,0,0,1,4,8,0.0,0.0,2013,14,1.0,inf,2,0,2,2.5
2013-14,Playoffs,203503,175,Tony Snell,1610612741,CHI,5,46,2,9,0.222,0,5,0.0,0,0,0.0,0,6,6,2,1,1,1,5,4,6,2.0,1.0,2013,14,0.8,2.0,7,0,7,0.8571428571428571
2013-14,Playoffs,200797,179,Ryan Hollins,1610612746,LAC,5,9,1,4,0.25,0,0,0.0,1,1,1.0,1,2,3,0,0,0,1,3,3,2,0.0,0.0,2013,14,0.6,0.0,3,0,3,1.0
2013-14,Playoffs,203268,180,Jorge Gutierrez,1610612751,BKN,2,3,0,0,0.0,0,0,0.0,2,4,0.5,1,0,1,0,0,0,0,0,2,1,0.0,0.0,2013,14,1.0,,0,2,2,0.5
2013-14,Playoffs,203490,180,Otto Porter Jr.,1610612764,WAS,3,6,1,3,0.333,0,1,0.0,0,0,0.0,0,0,0,0,0,0,0,0,2,0,0.0,0.0,2013,14,0.6666666666666666,,2,0,2,0.0
2013-14,Playoffs,203493,180,Reggie Bullock Jr.,1610612746,LAC,2,5,1,1,1.0,0,0,0.0,0,0,0.0,0,0,0,1,0,0,0,0,2,3,0.0,0.0,2013,14,1.0,inf,0,0,0,
2013-14,Playoffs,203479,183,Jamaal Franklin,1610612763,MEM,2,4,0,2,0.0,0,0,0.0,1,2,0.5,0,1,1,0,0,0,0,0,1,-1,0.0,0.0,2013,14,0.5,,2,1,3,0.3333333333333333
2013-14,Playoffs,200777,183,Joel Freeland,1610612757,POR,9,24,0,3,0.0,0,0,0.0,1,2,0.5,4,4,8,1,1,1,4,7,1,4,0.25,0.25,2013,14,0.1111111111111111,0.25,3,1,4,2.0
2013-14,Playoffs,203460,185,Andre Roberson,1610612760,OKC,2,9,0,3,0.0,0,0,0.0,0,0,0.0,0,2,2,0,0,0,0,0,0,-1,0.0,0.0,2013,14,0.0,,3,0,3,0.6666666666666666
2013-14,Playoffs,201948,185,Austin Daye,1610612759,SAS,1,6,0,2,0.0,0,0,0.0,0,0,0.0,0,1,1,0,0,0,0,0,0,-1,0.0,0.0,2013,14,0.0,,2,0,2,0.5
2013-14,Playoffs,203108,185,Bernard James,1610612742,DAL,2,8,0,0,0.0,0,0,0.0,0,0,0.0,1,0,1,0,1,0,0,0,0,2,0.0,0.0,2013,14,0.0,,0,0,0,inf
2013-14,Playoffs,201591,185,DJ White,1610612766,CHA,1,3,0,0,0.0,0,0,0.0,0,0,0.0,0,2,2,0,0,0,1,0,0,1,0.0,0.0,2013,14,0.0,0.0,0,0,0,inf
2013-14,Playoffs,2248,185,Earl Watson,1610612757,POR,4,14,0,1,0.0,0,1,0.0,0,0,0.0,0,1,1,1,0,0,1,1,0,0,1.0,0.0,2013,14,0.0,1.0,1,0,1,1.0
2013-14,Playoffs,201141,185,Greg Oden,1610612748,MIA,3,7,0,0,0.0,0,0,0.0,0,0,0.0,0,1,1,1,1,0,0,2,0,3,0.0,0.0,2013,14,0.0,inf,0,0,0,inf
2013-14,Playoffs,201934,185,Hasheem Thabeet,1610612760,OKC,2,7,0,0,0.0,0,0,0.0,0,0,0.0,0,0,0,0,0,0,0,4,0,0,0.0,0.0,2013,14,0.0,,0,0,0,
2013-14,Playoffs,2457,185,Jannero Pargo,1610612766,CHA,1,3,0,0,0.0,0,0,0.0,0,0,0.0,0,1,1,1,0,0,1,0,0,1,1.0,0.0,2013,14,0.0,1.0,0,0,0,inf
2013-14,Playoffs,202338,185,Kevin Seraphin,1610612764,WAS,4,6,0,3,0.0,0,0,0.0,0,0,0.0,1,1,2,0,0,0,1,1,0,-2,0.0,0.0,2013,14,0.0,0.0,3,0,3,0.6666666666666666
2013-14,Playoffs,202361,185,Landry Fields,1610612761,TOR,3,26,0,2,0.0,0,0,0.0,0,0,0.0,2,5,7,1,4,1,1,2,0,10,1.0,4.0,2013,14,0.0,1.0,2,0,2,3.5
2013-14,Playoffs,203086,185,Meyers Leonard,1610612757,POR,4,9,0,2,0.0,0,0,0.0,0,0,0.0,0,2,2,0,0,0,0,1,0,0,0.0,0.0,2013,14,0.0,,2,0,2,1.0
2013-14,Playoffs,203488,185,Mike Muscala,1610612737,ATL,2,5,0,2,0.0,0,0,0.0,0,0,0.0,0,0,0,0,0,0,0,0,0,-2,0.0,0.0,2013,14,0.0,,2,0,2,0.0
2013-14,Playoffs,201986,185,Nando De Colo,1610612761,TOR,1,4,0,0,0.0,0,0,0.0,0,0,0.0,0,1,1,0,0,0,0,2,0,1,0.0,0.0,2013,14,0.0,,0,0,0,inf
2013-14,Playoffs,1737,185,Nazr Mohammed,1610612741,CHI,2,5,0,1,0.0,0,0,0.0,0,0,0.0,1,1,2,0,0,0,0,3,0,1,0.0,0.0,2013,14,0.0,,1,0,1,2.0
2013-14,Playoffs,203136,185,Ognjen Kuzmic,1610612744,GSW,3,8,0,0,0.0,0,0,0.0,0,0,0.0,1,3,4,0,0,0,0,2,0,4,0.0,0.0,2013,14,0.0,,0,0,0,inf
2013-14,Playoffs,203499,185,Shane Larkin,1610612742,DAL,2,10,0,3,0.0,0,1,0.0,0,0,0.0,0,1,1,2,0,0,1,0,0,-1,2.0,0.0,2013,14,0.0,2.0,3,0,3,0.3333333333333333
2013-14,Playoffs,203524,185,Solomon Hill,1610612754,IND,1,1,0,0,0.0,0,0,0.0,0,0,0.0,0,0,0,0,0,0,0,0,0,0,0.0,0.0,2013,14,0.0,,0,0,0,
2013-14,Playoffs,200779,185,Steve Novak,1610612761,TOR,4,15,0,3,0.0,0,3,0.0,0,0,0.0,0,5,5,1,0,0,0,0,0,3,0.0,0.0,2013,14,0.0,inf,3,0,3,1.6666666666666667
2013-14,Playoffs,201964,185,Victor Claver,1610612757,POR,2,7,0,0,0.0,0,0,0.0,0,4,0.0,0,5,5,0,0,0,1,0,0,0,0.0,0.0,2013,14,0.0,0.0,0,4,4,1.25
2014-15,RegularSeason,201935,1,James Harden,1610612745,HOU,81,2981,647,1470,0.44,208,555,0.375,715,824,0.868,75,384,459,565,154,60,321,208,2217,2202,1.76,0.48,2014,15,27.37037037037037,1.7601246105919004,823,109,932,0.4924892703862661
2014-15,RegularSeason,201939,2,Stephen Curry,1610612744,GSW,80,2613,653,1341,0.487,286,646,0.443,308,337,0.914,56,285,341,619,163,16,249,158,1900,2073,2.49,0.66,2014,15,23.75,2.4859437751004014,688,29,717,0.4755927475592748
2014-15,RegularSeason,201566,3,Russell Westbrook,1610612760,OKC,67,2302,627,1471,0.426,86,288,0.299,546,654,0.835,124,364,488,574,140,14,293,184,1886,1857,1.96,0.48,2014,15,28.149253731343283,1.9590443686006827,844,108,952,0.5126050420168067
2014-15,RegularSeason,2544,4,LeBron James,1610612739,CLE,69,2493,624,1279,0.488,120,339,0.354,375,528,0.71,51,365,416,511,109,49,272,135,1743,1748,1.88,0.4,2014,15,25.26086956521739,1.8786764705882353,655,153,808,0.5148514851485149
2014-15,RegularSeason,203081,5,Damian Lillard,1610612757,POR,82,2925,590,1360,0.434,196,572,0.343,344,398,0.864,49,329,378,507,97,21,222,164,1720,1677,2.28,0.44,2014,15,20.975609756097562,2.2837837837837838,770,54,824,0.4587378640776699
2014-15,RegularSeason,202691,6,Klay Thompson,1610612744,GSW,77,2455,602,1299,0.463,239,545,0.439,225,256,0.879,27,220,247,222,87,60,149,122,1668,1407,1.49,0.58,2014,15,21.662337662337663,1.4899328859060403,697,31,728,0.3392857142857143
2014-15,RegularSeason,200746,7,LaMarcus Aldridge,1610612757,POR,71,2512,659,1415,0.466,37,105,0.352,306,362,0.845,177,549,726,124,48,68,122,125,1661,1693,1.02,0.39,2014,15,23.3943661971831,1.0163934426229508,756,56,812,0.8940886699507389
2014-15,RegularSeason,203076,8,Anthony Davis,1610612740,NOP,68,2455,642,1199,0.535,1,12,0.083,371,461,0.805,173,523,696,149,100,200,95,141,1656,2059,1.57,1.05,2014,15,24.352941176470587,1.568421052631579,557,90,647,1.0757341576506956
2014-15,RegularSeason,202681,9,Kyrie Irving,1610612739,CLE,75,2730,578,1235,0.468,157,378,0.415,315,365,0.863,55,182,237,389,114,20,186,146,1628,1495,2.09,0.61,2014,15,21.706666666666667,2.0913978494623655,657,50,707,0.3352192362093352
2014-15,RegularSeason,101108,10,Chris Paul,1610612746,LAC,82,2857,568,1170,0.485,139,349,0.398,289,321,0.9,52,324,376,838,156,15,190,203,1564,2125,4.41,0.82,2014,15,19.073170731707318,4.410526315789474,602,32,634,0.5930599369085173
2014-15,RegularSeason,101145,11,Monta Ellis,1610612742,DAL,80,2699,602,1354,0.445,81,284,0.285,228,303,0.752,34,156,190,329,148,25,198,197,1513,1180,1.66,0.75,2014,15,18.9125,1.6616161616161615,752,75,827,0.22974607013301088
2014-15,RegularSeason,201933,12,Blake Griffin,1610612746,LAC,67,2356,574,1144,0.502,10,25,0.4,311,427,0.728,126,382,508,354,63,35,152,196,1469,1591,2.33,0.41,2014,15,21.925373134328357,2.3289473684210527,570,116,686,0.7405247813411079
2014-15,RegularSeason,202330,13,Gordon Hayward,1610612762,UTA,76,2618,484,1087,0.445,120,330,0.364,375,462,0.812,54,319,373,313,108,30,206,131,1463,1391,1.52,0.52,2014,15,19.25,1.5194174757281553,603,87,690,0.5405797101449276
2014-15,RegularSeason,2200,14,Pau Gasol,1610612741,CHI,78,2681,570,1153,0.494,12,26,0.462,294,366,0.803,220,699,919,210,25,147,158,147,1446,1934,1.33,0.16,2014,15,18.53846153846154,1.3291139240506329,583,72,655,1.4030534351145039
2014-15,RegularSeason,200752,15,Rudy Gay,1610612758,SAC,68,2408,508,1116,0.455,79,220,0.359,337,393,0.858,98,301,399,250,71,41,183,157,1432,1346,1.37,0.39,2014,15,21.058823529411764,1.366120218579235,608,56,664,0.6009036144578314
2014-15,RegularSeason,202696,16,Nikola Vucevic,1610612753,ORL,74,2529,631,1206,0.523,2,6,0.333,164,218,0.752,238,572,810,147,54,54,148,220,1428,1716,0.99,0.36,2014,15,19.2972972972973,0.9932432432432432,575,54,629,1.287758346581876
2014-15,RegularSeason,202326,17,DeMarcus Cousins,1610612758,SAC,59,2013,498,1066,0.467,2,8,0.25,423,541,0.782,185,562,747,210,90,103,254,241,1421,1631,0.83,0.35,2014,15,24.084745762711865,0.8267716535433071,568,118,686,1.0889212827988337
2014-15,RegularSeason,201188,18,Marc Gasol,1610612763,MEM,81,2687,530,1072,0.494,3,17,0.176,350,440,0.795,115,515,630,307,70,131,176,208,1413,1743,1.74,0.4,2014,15,17.444444444444443,1.7443181818181819,542,90,632,0.9968354430379747
2014-15,RegularSeason,203952,19,Andrew Wiggins,1610612750,MIN,82,2969,497,1137,0.437,39,126,0.31,354,466,0.76,134,240,374,170,86,50,177,190,1387,1138,0.96,0.49,2014,15,16.914634146341463,0.96045197740113,640,112,752,0.4973404255319149
2014-15,RegularSeason,202322,19,John Wall,1610612764,WAS,79,2837,519,1166,0.445,65,217,0.3,284,362,0.785,36,330,366,792,138,45,304,180,1387,1699,2.6,0.45,2014,15,17.556962025316455,2.6052631578947367,647,78,725,0.5048275862068966
2014-15,RegularSeason,202339,21,Eric Bledsoe,1610612756,PHX,81,2800,468,1046,0.447,88,272,0.324,353,441,0.8,72,351,423,493,127,45,274,189,1377,1525,1.8,0.46,2014,15,17.0,1.7992700729927007,578,88,666,0.6351351351351351
2014-15,RegularSeason,1717,22,Dirk Nowitzki,1610612742,DAL,77,2282,487,1062,0.459,104,274,0.38,255,289,0.882,44,413,457,143,39,33,82,160,1333,1314,1.74,0.48,2014,15,17.31168831168831,1.7439024390243902,575,34,609,0.7504105090311987
2014-15,RegularSeason,2548,23,Dwyane Wade,1610612748,MIA,62,1971,509,1084,0.47,29,102,0.284,284,370,0.768,58,161,219,299,73,21,209,105,1331,1073,1.43,0.35,2014,15,21.467741935483872,1.430622009569378,575,86,661,0.3313161875945537
2014-15,RegularSeason,201936,24,Tyreke Evans,1610612740,NOP,79,2690,521,1165,0.447,69,227,0.304,202,291,0.694,82,334,416,521,100,37,246,198,1313,1408,2.12,0.41,2014,15,16.620253164556964,2.1178861788617884,644,89,733,0.567530695770805
2014-15,RegularSeason,202710,25,Jimmy Butler,1610612741,CHI,65,2513,421,912,0.462,73,193,0.378,386,463,0.834,114,265,379,212,114,36,93,108,1301,1381,2.28,1.23,2014,15,20.015384615384615,2.2795698924731185,491,77,568,0.6672535211267606
2014-15,RegularSeason,203506,26,Victor Oladipo,1610612753,ORL,72,2573,473,1086,0.436,84,248,0.339,262,320,0.819,51,251,302,295,120,19,204,187,1292,1153,1.45,0.59,2014,15,17.944444444444443,1.446078431372549,613,58,671,0.45007451564828616
2014-15,RegularSeason,200755,27,JJ Redick,1610612746,LAC,78,2409,447,938,0.477,200,458,0.437,183,203,0.901,22,145,167,137,39,8,95,134,1277,1022,1.44,0.41,2014,15,16.371794871794872,1.4421052631578948,491,20,511,0.3268101761252446
2014-15,RegularSeason,201609,28,Goran Dragic,1610612748,MIA,78,2640,502,1002,0.501,90,259,0.347,181,234,0.774,81,193,274,350,78,15,173,195,1275,1266,2.02,0.45,2014,15,16.346153846153847,2.023121387283237,500,53,553,0.49547920433996384
2014-15,RegularSeason,202693,29,Markieff Morris,1610612756,PHX,82,2581,512,1100,0.465,57,179,0.318,177,232,0.763,110,396,506,192,101,39,170,245,1258,1283,1.13,0.59,2014,15,15.341463414634147,1.1294117647058823,588,55,643,0.7869362363919129
2014-15,RegularSeason,200768,30,Kyle Lowry,1610612761,TOR,70,2414,430,1043,0.412,132,391,0.338,252,312,0.808,54,274,328,473,109,13,173,212,1244,1321,2.73,0.63,2014,15,17.771428571428572,2.7341040462427744,613,60,673,0.487369985141159
2014-15,RegularSeason,101150,31,Lou Williams,1610612761,TOR,80,2016,375,928,0.404,152,447,0.34,340,395,0.861,24,127,151,164,88,10,101,103,1242,946,1.62,0.87,2014,15,15.525,1.6237623762376239,553,55,608,0.24835526315789475
2014-15,RegularSeason,201572,32,Brook Lopez,1610612751,BKN,72,2100,506,987,0.513,1,10,0.1,223,274,0.814,214,321,535,50,43,126,104,206,1236,1354,0.48,0.41,2014,15,17.166666666666668,0.4807692307692308,481,51,532,1.005639097744361
2014-15,RegularSeason,201567,33,Kevin Love,1610612739,CLE,75,2532,413,952,0.434,144,392,0.367,258,321,0.804,142,589,731,168,51,39,122,140,1228,1493,1.38,0.42,2014,15,16.373333333333335,1.3770491803278688,539,63,602,1.2142857142857142
2014-15,RegularSeason,200794,34,Paul Millsap,1610612737,ATL,73,2390,443,930,0.476,77,216,0.356,255,337,0.757,139,431,570,223,130,69,166,201,1218,1475,1.34,0.78,2014,15,16.684931506849313,1.3433734939759037,487,82,569,1.0017574692442883
2014-15,RegularSeason,201942,35,DeMar DeRozan,1610612761,TOR,60,2100,409,990,0.413,25,88,0.284,361,434,0.832,41,236,277,210,73,11,137,122,1204,984,1.53,0.53,2014,15,20.066666666666666,1.532846715328467,581,73,654,0.4235474006116208
2014-15,RegularSeason,202324,36,Derrick Favors,1610612762,UTA,74,2280,482,918,0.525,1,6,0.167,222,332,0.669,196,411,607,112,60,123,121,210,1187,1422,0.93,0.5,2014,15,16.04054054054054,0.9256198347107438,436,110,546,1.1117216117216118
2014-15,RegularSeason,201145,37,Jeff Green,1610612763,MEM,78,2455,416,967,0.43,97,292,0.332,239,287,0.833,64,264,328,134,53,34,108,147,1168,1010,1.24,0.49,2014,15,14.974358974358974,1.2407407407407407,551,48,599,0.5475792988313857
2014-15,RegularSeason,202699,38,Tobias Harris,1610612753,ORL,68,2369,442,949,0.466,87,239,0.364,193,245,0.788,73,357,430,124,69,36,115,134,1164,1149,1.08,0.6,2014,15,17.11764705882353,1.0782608695652174,507,52,559,0.7692307692307693
2014-15,RegularSeason,202683,39,Enes Freedom,1610612760,OKC,75,2136,482,928,0.519,16,45,0.356,183,234,0.782,277,394,671,55,36,29,145,189,1163,1312,0.38,0.25,2014,15,15.506666666666666,0.3793103448275862,446,51,497,1.3501006036217305
2014-15,RegularSeason,201952,40,Jeff Teague,1610612737,ATL,73,2228,408,887,0.46,71,207,0.343,275,319,0.862,30,154,184,513,125,31,205,139,1162,1287,2.5,0.61,2014,15,15.917808219178083,2.502439024390244,479,44,523,0.35181644359464626
2014-15,RegularSeason,201143,41,Al Horford,1610612737,ATL,76,2318,519,965,0.538,11,36,0.306,107,141,0.759,131,413,544,244,68,98,100,121,1156,1530,2.44,0.68,2014,15,15.210526315789474,2.44,446,34,480,1.1333333333333333
2014-15,RegularSeason,2207,42,Joe Johnson,1610612751,BKN,80,2791,446,1025,0.435,121,337,0.359,141,176,0.801,53,331,384,292,59,14,137,120,1154,1152,2.13,0.43,2014,15,14.425,2.1313868613138687,579,35,614,0.6254071661237784
2014-15,RegularSeason,201951,43,Ty Lawson,1610612743,DEN,75,2665,404,926,0.436,70,205,0.341,265,363,0.73,42,192,234,720,92,9,185,128,1143,1393,3.89,0.5,2014,15,15.24,3.891891891891892,522,98,620,0.3774193548387097
2014-15,RegularSeason,2216,43,Zach Randolph,1610612763,MEM,71,2304,454,932,0.487,7,20,0.35,228,298,0.765,225,522,747,153,69,14,156,175,1143,1422,0.98,0.44,2014,15,16.098591549295776,0.9807692307692307,478,70,548,1.3631386861313868
2014-15,RegularSeason,203083,45,Andre Drummond,1610612765,DET,82,2502,494,961,0.514,0,2,0.0,142,365,0.389,437,667,1104,55,73,153,120,285,1130,1705,0.46,0.61,2014,15,13.78048780487805,0.4583333333333333,467,223,690,1.6
2014-15,RegularSeason,202704,46,Reggie Jackson,1610612765,DET,77,2268,432,996,0.434,72,241,0.299,181,218,0.83,56,271,327,462,62,9,186,167,1117,1190,2.48,0.33,2014,15,14.506493506493506,2.4838709677419355,564,37,601,0.5440931780366056
2014-15,RegularSeason,201144,47,Mike Conley,1610612763,MEM,70,2225,393,882,0.446,107,277,0.386,214,249,0.859,29,180,209,375,89,14,156,139,1107,1114,2.4,0.57,2014,15,15.814285714285715,2.4038461538461537,489,35,524,0.3988549618320611
2014-15,RegularSeason,202738,48,Isaiah Thomas,1610612738,BOS,67,1726,335,796,0.421,129,346,0.373,302,348,0.868,33,120,153,284,57,5,143,150,1101,950,1.99,0.4,2014,15,16.432835820895523,1.986013986013986,461,46,507,0.30177514792899407
2014-15,RegularSeason,202328,49,Greg Monroe,1610612765,DET,69,2137,423,853,0.496,0,0,0.0,252,336,0.75,229,475,704,142,78,34,149,148,1098,1393,0.95,0.52,2014,15,15.91304347826087,0.9530201342281879,430,84,514,1.3696498054474708
2014-15,RegularSeason,201163,50,Wilson Chandler,1610612743,DEN,78,2471,418,975,0.429,139,406,0.342,110,142,0.775,96,379,475,134,58,29,110,231,1085,1082,1.22,0.53,2014,15,13.91025641025641,1.2181818181818183,557,32,589,0.8064516129032258
2014-15,RegularSeason,2744,51,Al Jefferson,1610612766,CHA,65,1992,486,1010,0.481,2,5,0.4,108,165,0.655,99,449,548,113,47,84,68,139,1082,1225,1.66,0.69,2014,15,16.646153846153847,1.661764705882353,524,57,581,0.9432013769363167
2014-15,RegularSeason,202689,52,Kemba Walker,1610612766,CHA,62,2119,378,981,0.385,85,280,0.304,234,283,0.827,35,185,220,318,89,31,100,92,1075,981,3.18,0.89,2014,15,17.338709677419356,3.18,603,49,652,0.3374233128834356
2014-15,RegularSeason,202340,53,Avery Bradley,1610612738,BOS,77,2428,434,1013,0.428,124,352,0.352,79,100,0.79,46,195,241,135,82,15,109,177,1071,835,1.24,0.75,2014,15,13.909090909090908,1.238532110091743,579,21,600,0.40166666666666667
2014-15,RegularSeason,201152,53,Thaddeus Young,1610612751,BKN,76,2434,451,968,0.466,38,115,0.33,131,200,0.655,127,284,411,173,124,25,117,171,1071,1101,1.48,1.06,2014,15,14.092105263157896,1.4786324786324787,517,69,586,0.7013651877133106
2014-15,RegularSeason,202688,55,Brandon Knight,1610612756,PHX,63,2035,375,888,0.422,125,321,0.389,195,223,0.874,28,216,244,330,90,10,189,114,1070,1014,1.75,0.48,2014,15,16.984126984126984,1.746031746031746,513,28,541,0.4510166358595194
2014-15,RegularSeason,1495,55,Tim Duncan,1610612759,SAS,77,2227,419,819,0.512,2,7,0.286,230,311,0.74,170,534,704,230,63,151,131,165,1070,1606,1.76,0.48,2014,15,13.896103896103897,1.7557251908396947,400,81,481,1.4636174636174637
2014-15,RegularSeason,202695,57,Kawhi Leonard,1610612759,SAS,64,2033,394,822,0.479,67,192,0.349,202,252,0.802,85,376,461,161,148,48,97,128,1057,1300,1.66,1.53,2014,15,16.515625,1.6597938144329898,428,50,478,0.9644351464435147
2014-15,RegularSeason,203114,58,Khris Middleton,1610612749,MIL,79,2378,406,869,0.467,109,268,0.407,134,156,0.859,48,299,347,182,122,11,113,183,1055,1119,1.61,1.08,2014,15,13.354430379746836,1.6106194690265487,463,22,485,0.7154639175257732
2014-15,RegularSeason,2772,59,Trevor Ariza,1610612745,HOU,82,2930,366,910,0.402,194,555,0.35,122,143,0.853,77,382,459,209,152,17,141,186,1048,1179,1.48,1.08,2014,15,12.78048780487805,1.4822695035460993,544,21,565,0.8123893805309734
2014-15,RegularSeason,203484,60,Kentavious Caldwell-Pope,1610612765,DET,82,2587,390,972,0.401,153,444,0.345,110,158,0.696,46,209,255,109,93,18,94,161,1043,794,1.16,0.99,2014,15,12.71951219512195,1.1595744680851063,582,48,630,0.40476190476190477
2014-15,RegularSeason,202718,61,Chandler Parsons,1610612742,DAL,66,2186,383,829,0.462,132,347,0.38,139,193,0.72,64,259,323,161,69,19,96,140,1037,1013,1.68,0.72,2014,15,15.712121212121213,1.6770833333333333,446,54,500,0.646
2014-15,RegularSeason,201167,62,Arron Afflalo,1610612757,POR,78,2502,375,884,0.424,118,333,0.354,167,198,0.843,27,220,247,129,41,7,116,167,1035,803,1.11,0.35,2014,15,13.26923076923077,1.1120689655172413,509,31,540,0.45740740740740743
2014-15,RegularSeason,203507,63,Giannis Antetokounmpo,1610612749,MIL,81,2541,383,780,0.491,7,44,0.159,257,347,0.741,100,442,542,207,73,85,173,254,1030,1277,1.2,0.42,2014,15,12.716049382716049,1.1965317919075145,397,90,487,1.1129363449691991
2014-15,RegularSeason,2746,64,Josh Smith,1610612745,HOU,83,2301,414,987,0.419,72,228,0.316,127,255,0.498,152,378,530,277,87,116,206,228,1027,1130,1.34,0.42,2014,15,12.373493975903614,1.3446601941747574,573,128,701,0.7560627674750356
2014-15,RegularSeason,2037,65,Jamal Crawford,1610612746,LAC,64,1703,332,839,0.396,119,364,0.327,227,252,0.901,18,106,124,158,59,14,92,108,1010,741,1.72,0.64,2014,15,15.78125,1.7173913043478262,507,25,532,0.23308270676691728
2014-15,RegularSeason,2736,66,Luol Deng,1610612748,MIA,72,2421,369,787,0.469,78,220,0.355,191,251,0.761,103,273,376,139,65,22,108,109,1007,1023,1.29,0.6,2014,15,13.98611111111111,1.287037037037037,418,60,478,0.7866108786610879
2014-15,RegularSeason,101162,67,Marcin Gortat,1610612764,WAS,82,2453,439,775,0.566,0,3,0.0,123,175,0.703,180,537,717,97,49,110,100,191,1001,1486,0.97,0.49,2014,15,12.207317073170731,0.97,336,52,388,1.847938144329897
2014-15,RegularSeason,203463,68,Ben McLemore,1610612758,SAC,82,2670,363,831,0.437,140,391,0.358,130,160,0.813,31,210,241,140,77,19,138,219,996,837,1.01,0.56,2014,15,12.146341463414634,1.0144927536231885,468,30,498,0.4839357429718876
2014-15,RegularSeason,2225,69,Tony Parker,1610612759,SAS,68,1953,404,832,0.486,38,89,0.427,130,166,0.783,15,114,129,335,44,2,146,108,976,876,2.29,0.3,2014,15,14.352941176470589,2.2945205479452055,428,36,464,0.27801724137931033
2014-15,RegularSeason,203504,70,Trey Burke,1610612762,UTA,76,2288,370,1005,0.368,124,390,0.318,109,145,0.752,31,173,204,328,65,15,124,119,973,790,2.65,0.52,2014,15,12.802631578947368,2.6451612903225805,635,36,671,0.30402384500745155
2014-15,RegularSeason,201945,71,Gerald Henderson,1610612766,CHA,80,2315,370,847,0.437,45,136,0.331,184,217,0.848,36,237,273,206,51,22,110,135,969,901,1.87,0.46,2014,15,12.1125,1.8727272727272728,477,33,510,0.5352941176470588
2014-15,RegularSeason,2546,72,Carmelo Anthony,1610612752,NYK,40,1428,358,806,0.444,61,179,0.341,189,237,0.797,72,192,264,122,40,17,89,87,966,824,1.37,0.45,2014,15,24.15,1.3707865168539326,448,48,496,0.532258064516129
2014-15,RegularSeason,203487,72,Michael Carter-Williams,1610612749,MIL,66,2150,364,919,0.396,36,153,0.235,202,291,0.694,64,289,353,442,111,30,253,167,966,1005,1.75,0.44,2014,15,14.636363636363637,1.7470355731225296,555,89,644,0.5481366459627329
2014-15,RegularSeason,2590,74,Mo Williams,1610612766,CHA,68,1980,341,860,0.397,119,348,0.342,163,187,0.872,22,152,174,424,46,14,172,162,964,907,2.46,0.27,2014,15,14.176470588235293,2.4651162790697674,519,24,543,0.32044198895027626
2014-15,RegularSeason,202685,75,Jonas Valanciunas,1610612761,TOR,80,2096,373,652,0.572,0,1,0.0,217,276,0.786,215,478,693,39,33,95,109,222,963,1376,0.36,0.3,2014,15,12.0375,0.3577981651376147,279,59,338,2.0502958579881656
2014-15,RegularSeason,203078,76,Bradley Beal,1610612764,WAS,63,2107,363,851,0.427,106,259,0.409,130,166,0.783,57,184,241,194,76,18,123,136,962,844,1.58,0.62,2014,15,15.26984126984127,1.5772357723577235,488,36,524,0.4599236641221374
2014-15,RegularSeason,101127,77,Jarrett Jack,1610612751,BKN,80,2241,359,817,0.439,39,146,0.267,200,227,0.881,19,226,245,373,75,13,191,143,957,987,1.95,0.39,2014,15,11.9625,1.9528795811518325,458,27,485,0.5051546391752577
2014-15,RegularSeason,202083,78,Wesley Matthews,1610612757,POR,60,2024,337,752,0.448,173,445,0.389,109,145,0.752,38,184,222,139,77,10,81,132,956,872,1.72,0.95,2014,15,15.933333333333334,1.7160493827160495,415,36,451,0.49223946784922396
2014-15,RegularSeason,201166,79,Aaron Brooks,1610612741,CHI,82,1885,344,817,0.421,121,313,0.387,145,174,0.833,32,134,166,261,54,15,157,189,954,791,1.66,0.34,2014,15,11.634146341463415,1.6624203821656052,473,29,502,0.33067729083665337
2014-15,RegularSeason,201980,80,Danny Green,1610612759,SAS,81,2312,322,738,0.436,191,457,0.418,111,127,0.874,54,289,343,158,101,87,93,163,946,1110,1.7,1.09,2014,15,11.679012345679013,1.6989247311827957,416,16,432,0.7939814814814815
2014-15,RegularSeason,201599,80,DeAndre Jordan,1610612746,LAC,82,2820,379,534,0.71,1,4,0.25,187,471,0.397,397,829,1226,61,81,183,109,245,946,1949,0.56,0.74,2014,15,11.536585365853659,0.5596330275229358,155,284,439,2.792710706150342
2014-15,RegularSeason,202702,80,Kenneth Faried,1610612743,DEN,75,2086,373,736,0.507,1,8,0.125,199,288,0.691,242,426,668,89,62,57,118,211,946,1252,0.75,0.53,2014,15,12.613333333333333,0.7542372881355932,363,89,452,1.4778761061946903
2014-15,RegularSeason,203496,83,Robert Covington,1610612755,PHI,70,1956,299,756,0.396,167,446,0.374,178,217,0.82,65,251,316,105,97,31,128,189,943,868,0.82,0.76,2014,15,13.471428571428572,0.8203125,457,39,496,0.6370967741935484
2014-15,RegularSeason,101139,84,CJ Miles,1610612754,IND,70,1841,329,827,0.398,154,446,0.345,130,161,0.807,18,196,214,75,60,26,73,132,942,715,1.03,0.82,2014,15,13.457142857142857,1.0273972602739727,498,31,529,0.4045368620037807
2014-15,RegularSeason,203079,85,Dion Waiters,1610612760,OKC,80,2208,375,946,0.396,73,246,0.297,117,172,0.68,41,151,192,163,90,21,113,155,940,667,1.44,0.8,2014,15,11.75,1.4424778761061947,571,55,626,0.30670926517571884
2014-15,RegularSeason,2547,86,Chris Bosh,1610612748,MIA,44,1556,343,745,0.46,63,168,0.375,179,232,0.772,46,264,310,95,41,25,95,69,928,849,1.0,0.43,2014,15,21.09090909090909,1.0,402,53,455,0.6813186813186813
2014-15,RegularSeason,203110,87,Draymond Green,1610612744,GSW,79,2490,339,765,0.443,111,329,0.337,132,200,0.66,114,533,647,291,123,99,133,253,921,1454,2.19,0.93,2014,15,11.658227848101266,2.18796992481203,426,68,494,1.3097165991902835
2014-15,RegularSeason,201147,88,Corey Brewer,1610612745,HOU,80,2087,343,805,0.426,63,235,0.268,168,226,0.743,80,217,297,173,114,19,131,173,917,869,1.32,0.87,2014,15,11.4625,1.3206106870229009,462,58,520,0.5711538461538461
2014-15,RegularSeason,201586,88,Serge Ibaka,1610612760,OKC,64,2116,374,786,0.476,77,205,0.376,92,110,0.836,135,364,499,55,30,155,97,194,917,1129,0.57,0.31,2014,15,14.328125,0.5670103092783505,412,18,430,1.1604651162790698
2014-15,RegularSeason,2594,90,Kyle Korver,1610612737,ATL,75,2418,292,600,0.487,221,449,0.492,106,118,0.898,15,289,304,196,52,42,107,140,911,1078,1.83,0.49,2014,15,12.146666666666667,1.8317757009345794,308,12,320,0.95
2014-15,RegularSeason,201565,91,Derrick Rose,1610612741,CHI,51,1530,338,835,0.405,76,271,0.28,152,187,0.813,35,126,161,251,36,16,161,63,904,675,1.56,0.22,2014,15,17.725490196078432,1.5590062111801242,497,35,532,0.3026315789473684
2014-15,RegularSeason,201155,92,Rodney Stuckey,1610612754,IND,71,1874,332,754,0.44,55,141,0.39,177,216,0.819,36,212,248,219,56,10,118,131,896,850,1.86,0.47,2014,15,12.619718309859154,1.8559322033898304,422,39,461,0.5379609544468547
2014-15,RegularSeason,101114,93,Deron Williams,1610612751,BKN,68,2114,298,771,0.387,87,237,0.367,201,241,0.834,29,208,237,448,64,17,154,157,884,983,2.91,0.42,2014,15,13.0,2.909090909090909,473,40,513,0.4619883040935672
2014-15,RegularSeason,101123,93,Gerald Green,1610612756,PHX,74,1446,324,778,0.416,137,387,0.354,99,120,0.825,33,153,186,91,42,12,104,145,884,636,0.88,0.4,2014,15,11.945945945945946,0.875,454,21,475,0.391578947368421
2014-15,RegularSeason,201960,95,DeMarre Carroll,1610612737,ATL,70,2189,318,653,0.487,120,304,0.395,127,181,0.702,99,273,372,118,94,17,75,154,883,1020,1.57,1.25,2014,15,12.614285714285714,1.5733333333333333,335,54,389,0.9562982005141388
2014-15,RegularSeason,1718,96,Paul Pierce,1610612764,WAS,73,1914,293,656,0.447,118,303,0.389,164,210,0.781,45,249,294,144,46,24,92,160,868,875,1.56,0.5,2014,15,11.89041095890411,1.565217391304348,363,46,409,0.7188264058679706
2014-15,RegularSeason,101138,97,Brandon Bass,1610612738,BOS,82,1929,344,683,0.504,9,32,0.281,169,214,0.79,139,259,398,104,41,32,83,140,866,974,1.25,0.49,2014,15,10.560975609756097,1.2530120481927711,339,45,384,1.0364583333333333
2014-15,RegularSeason,202700,98,Donatas Motiejunas,1610612745,HOU,71,2037,353,700,0.504,49,133,0.368,100,166,0.602,137,284,421,130,56,34,123,203,855,960,1.06,0.46,2014,15,12.04225352112676,1.056910569105691,347,66,413,1.0193704600484261
2014-15,RegularSeason,2747,99,JR Smith,1610612739,CLE,70,2079,315,755,0.417,163,426,0.383,54,72,0.75,30,188,218,195,82,22,97,163,847,809,2.01,0.84,2014,15,12.1,2.0103092783505154,440,18,458,0.4759825327510917
2014-15,RegularSeason,202694,100,Marcus Morris Sr.,1610612756,PHX,81,2045,331,763,0.434,112,313,0.358,71,113,0.628,73,312,385,133,63,16,73,188,845,895,1.82,0.86,2014,15,10.432098765432098,1.821917808219178,432,42,474,0.8122362869198312
2014-15,RegularSeason,201941,101,Jordan Hill,1610612747,LAL,70,1874,357,777,0.459,3,11,0.273,124,168,0.738,174,382,556,103,34,52,106,164,841,1016,0.97,0.32,2014,15,12.014285714285714,0.9716981132075472,420,44,464,1.1982758620689655
2014-15,RegularSeason,2430,102,Carlos Boozer,1610612747,LAL,71,1692,371,743,0.499,0,0,0.0,94,150,0.627,111,371,482,95,41,12,92,184,836,946,1.03,0.45,2014,15,11.774647887323944,1.0326086956521738,372,56,428,1.1261682242990654
2014-15,RegularSeason,202703,103,Nikola Mirotic,1610612741,CHI,82,1654,253,624,0.405,99,313,0.316,228,284,0.803,63,341,404,97,54,54,89,172,833,926,1.09,0.61,2014,15,10.158536585365853,1.0898876404494382,371,56,427,0.9461358313817331
2014-15,RegularSeason,201583,103,Ryan Anderson,1610612740,NOP,61,1675,291,729,0.399,122,359,0.34,129,151,0.854,108,187,295,55,33,20,62,113,833,714,0.89,0.53,2014,15,13.655737704918034,0.8870967741935484,438,22,460,0.6413043478260869
2014-15,RegularSeason,203092,103,Tyler Zeller,1610612738,BOS,82,1731,340,619,0.549,0,0,0.0,153,186,0.823,146,319,465,113,18,52,76,205,833,1093,1.49,0.24,2014,15,10.158536585365853,1.486842105263158,279,33,312,1.4903846153846154
2014-15,RegularSeason,202391,106,Jeremy Lin,1610612747,LAL,74,1907,277,654,0.424,65,176,0.369,213,268,0.795,26,170,196,339,82,32,166,189,832,883,2.04,0.49,2014,15,11.243243243243244,2.0421686746987953,377,55,432,0.4537037037037037
2014-15,RegularSeason,203084,107,Harrison Barnes,1610612744,GSW,82,2318,316,656,0.482,87,215,0.405,108,150,0.72,117,336,453,116,61,19,71,146,827,1023,1.63,0.86,2014,15,10.085365853658537,1.6338028169014085,340,42,382,1.1858638743455496
2014-15,RegularSeason,201569,108,Eric Gordon,1610612740,NOP,61,2018,285,694,0.411,141,315,0.448,107,133,0.805,28,131,159,229,50,14,122,145,818,713,1.88,0.41,2014,15,13.40983606557377,1.8770491803278688,409,26,435,0.36551724137931035
2014-15,RegularSeason,201596,109,Mario Chalmers,1610612748,MIA,80,2368,267,663,0.403,73,248,0.294,206,266,0.774,24,182,206,307,122,10,173,251,813,829,1.77,0.7,2014,15,10.1625,1.7745664739884393,396,60,456,0.4517543859649123
2014-15,RegularSeason,203082,110,Terrence Ross,1610612761,TOR,82,2092,309,753,0.41,145,390,0.372,44,56,0.786,32,194,226,86,53,25,69,136,807,672,1.25,0.77,2014,15,9.841463414634147,1.2463768115942029,444,12,456,0.4956140350877193
2014-15,RegularSeason,201564,111,O.J. Mayo,1610612749,MIL,71,1697,296,701,0.422,99,277,0.357,115,139,0.827,30,157,187,197,57,18,128,165,806,708,1.54,0.45,2014,15,11.352112676056338,1.5390625,405,24,429,0.4358974358974359
2014-15,RegularSeason,203501,112,Tim Hardaway Jr.,1610612752,NYK,70,1681,279,717,0.389,121,354,0.342,125,156,0.801,12,144,156,127,20,14,82,119,804,570,1.55,0.24,2014,15,11.485714285714286,1.548780487804878,438,31,469,0.3326226012793177
2014-15,RegularSeason,201579,113,Roy Hibbert,1610612754,IND,76,1926,317,710,0.446,0,2,0.0,168,204,0.824,156,384,540,84,18,125,107,216,802,1033,0.79,0.17,2014,15,10.552631578947368,0.7850467289719626,393,36,429,1.2587412587412588
2014-15,RegularSeason,201578,114,Marreese Speights,1610612744,GSW,76,1207,318,646,0.492,5,18,0.278,150,178,0.843,109,216,325,72,20,34,82,189,791,804,0.88,0.24,2014,15,10.407894736842104,0.8780487804878049,328,28,356,0.9129213483146067
2014-15,RegularSeason,201627,115,Anthony Morrow,1610612760,OKC,74,1806,285,615,0.463,141,325,0.434,79,89,0.888,40,155,195,60,54,11,38,135,790,732,1.58,1.42,2014,15,10.675675675675675,1.5789473684210527,330,10,340,0.5735294117647058
2014-15,RegularSeason,202389,116,Timofey Mozgov,1610612739,CLE,81,2046,314,566,0.555,2,6,0.333,155,216,0.718,203,388,591,55,33,97,116,227,785,1132,0.47,0.28,2014,15,9.691358024691358,0.47413793103448276,252,61,313,1.8881789137380192
2014-15,RegularSeason,977,117,Kobe Bryant,1610612747,LAL,35,1207,266,713,0.373,54,184,0.293,196,241,0.813,26,173,199,197,47,7,128,65,782,612,1.54,0.37,2014,15,22.34285714285714,1.5390625,447,45,492,0.40447154471544716
2014-15,RegularSeason,202323,118,Evan Turner,1610612738,BOS,82,2260,320,746,0.429,33,119,0.277,106,141,0.752,40,377,417,449,83,19,198,180,779,1088,2.27,0.42,2014,15,9.5,2.2676767676767677,426,35,461,0.9045553145336226
2014-15,RegularSeason,2755,118,Kevin Martin,1610612750,MIN,39,1302,267,625,0.427,75,191,0.393,170,193,0.881,19,123,142,89,33,1,76,76,779,587,1.17,0.43,2014,15,19.974358974358974,1.1710526315789473,358,23,381,0.37270341207349084
2014-15,RegularSeason,203897,120,Zach LaVine,1610612750,MIN,77,1902,286,677,0.422,57,167,0.341,149,177,0.842,27,187,214,276,54,10,193,158,778,720,1.43,0.28,2014,15,10.103896103896103,1.4300518134715026,391,28,419,0.5107398568019093
2014-15,RegularSeason,201584,121,Courtney Lee,1610612763,MEM,77,2354,288,643,0.448,90,224,0.402,111,129,0.86,21,157,178,151,75,12,78,129,777,742,1.94,0.96,2014,15,10.090909090909092,1.935897435897436,355,18,373,0.4772117962466488
2014-15,RegularSeason,201571,121,D.J. Augustin,1610612760,OKC,82,1964,258,647,0.399,83,246,0.337,178,205,0.868,20,141,161,353,49,3,145,93,777,782,2.43,0.34,2014,15,9.475609756097562,2.43448275862069,389,27,416,0.3870192307692308
2014-15,RegularSeason,202349,123,Greivis Vasquez,1610612761,TOR,82,1991,296,725,0.408,133,351,0.379,50,66,0.758,22,194,216,302,46,10,119,177,775,785,2.54,0.39,2014,15,9.451219512195122,2.53781512605042,429,16,445,0.4853932584269663
2014-15,RegularSeason,2199,124,Tyson Chandler,1610612742,DAL,75,2286,293,440,0.666,0,0,0.0,185,257,0.72,294,570,864,84,42,91,105,169,771,1528,0.8,0.4,2014,15,10.28,0.8,147,72,219,3.9452054794520546
2014-15,RegularSeason,203096,125,Jared Sullinger,1610612738,BOS,58,1566,311,708,0.439,52,184,0.283,96,129,0.744,147,294,441,134,44,42,78,153,770,923,1.72,0.56,2014,15,13.275862068965518,1.7179487179487178,397,33,430,1.0255813953488373
2014-15,RegularSeason,2561,126,David West,1610612754,IND,66,1895,323,686,0.471,4,20,0.2,119,161,0.739,108,341,449,223,48,48,120,160,769,1012,1.86,0.4,2014,15,11.651515151515152,1.8583333333333334,363,42,405,1.108641975308642
2014-15,RegularSeason,203471,127,Dennis Schroder,1610612737,ATL,77,1516,284,665,0.427,52,148,0.351,148,179,0.827,29,135,164,317,49,4,150,127,768,740,2.11,0.33,2014,15,9.974025974025974,2.1133333333333333,381,31,412,0.39805825242718446
2014-15,RegularSeason,2440,128,Matt Barnes,1610612746,LAC,76,2271,277,624,0.444,136,376,0.362,74,95,0.779,51,251,302,114,67,50,87,240,764,842,1.31,0.77,2014,15,10.052631578947368,1.3103448275862069,347,21,368,0.8206521739130435
2014-15,RegularSeason,2449,129,Luis Scola,1610612754,IND,81,1659,300,642,0.467,5,20,0.25,158,226,0.699,138,388,526,105,47,18,94,192,763,955,1.12,0.5,2014,15,9.419753086419753,1.1170212765957446,342,68,410,1.2829268292682927
2014-15,RegularSeason,202325,130,Wesley Johnson,1610612747,LAL,76,2245,286,691,0.414,91,259,0.351,90,112,0.804,67,252,319,124,59,45,87,162,753,786,1.43,0.68,2014,15,9.907894736842104,1.4252873563218391,405,22,427,0.747072599531616
2014-15,RegularSeason,203457,131,Nerlens Noel,1610612755,PHI,75,2311,302,653,0.462,0,0,0.0,140,230,0.609,185,426,611,128,133,142,146,208,744,1171,0.88,0.91,2014,15,9.92,0.8767123287671232,351,90,441,1.3854875283446713
2014-15,RegularSeason,1938,132,Manu Ginobili,1610612759,SAS,70,1587,251,589,0.426,89,258,0.345,147,204,0.721,28,183,211,293,67,20,154,138,738,780,1.9,0.43,2014,15,10.542857142857143,1.9025974025974026,338,57,395,0.5341772151898734
2014-15,RegularSeason,2403,133,Nene,1610612764,WAS,67,1694,307,601,0.511,1,5,0.2,122,202,0.604,84,261,345,123,66,22,124,180,737,795,0.99,0.53,2014,15,11.0,0.9919354838709677,294,80,374,0.9224598930481284
2014-15,RegularSeason,201568,134,Danilo Gallinari,1610612743,DEN,59,1426,228,568,0.401,107,301,0.355,171,191,0.895,31,187,218,83,47,20,57,94,734,685,1.46,0.82,2014,15,12.440677966101696,1.456140350877193,340,20,360,0.6055555555555555
2014-15,RegularSeason,203901,135,Elfrid Payton,1610612753,ORL,82,2489,301,708,0.425,11,42,0.262,118,214,0.551,107,242,349,533,142,20,203,193,731,1069,2.63,0.7,2014,15,8.914634146341463,2.625615763546798,407,96,503,0.6938369781312127
2014-15,RegularSeason,203524,136,Solomon Hill,1610612754,IND,82,2381,251,634,0.396,68,208,0.327,159,193,0.824,70,244,314,184,66,18,115,177,729,779,1.6,0.57,2014,15,8.890243902439025,1.6,383,34,417,0.7529976019184652
2014-15,RegularSeason,201954,137,Darren Collison,1610612758,SAC,45,1565,260,550,0.473,60,161,0.373,145,184,0.788,19,124,143,252,67,14,112,95,725,760,2.25,0.6,2014,15,16.11111111111111,2.25,290,39,329,0.43465045592705165
2014-15,RegularSeason,203486,138,Mason Plumlee,1610612751,BKN,82,1743,280,489,0.573,0,3,0.0,157,317,0.495,175,337,512,74,65,63,106,207,717,956,0.7,0.61,2014,15,8.74390243902439,0.6981132075471698,209,160,369,1.3875338753387534
2014-15,RegularSeason,200782,139,P.J. Tucker,1610612756,PHX,78,2383,261,596,0.438,87,252,0.345,104,143,0.727,114,388,502,122,107,23,96,179,713,997,1.27,1.11,2014,15,9.14102564102564,1.2708333333333333,335,39,374,1.3422459893048129
2014-15,RegularSeason,203476,140,Gorgui Dieng,1610612750,MIN,73,2193,259,512,0.506,1,6,0.167,191,244,0.783,223,386,609,146,71,126,126,188,710,1230,1.16,0.56,2014,15,9.726027397260275,1.1587301587301588,253,53,306,1.9901960784313726
2014-15,RegularSeason,2564,141,Boris Diaw,1610612759,SAS,81,1984,291,632,0.46,54,169,0.32,72,93,0.774,78,270,348,233,36,23,126,148,708,860,1.85,0.29,2014,15,8.74074074074074,1.8492063492063493,341,21,362,0.9613259668508287
2014-15,RegularSeason,203903,142,Jordan Clarkson,1610612747,LAL,59,1476,267,596,0.448,38,121,0.314,131,158,0.829,56,135,191,206,51,12,96,109,703,711,2.15,0.53,2014,15,11.915254237288135,2.1458333333333335,329,27,356,0.5365168539325843
2014-15,RegularSeason,202711,143,Bojan Bogdanovic,1610612751,BKN,78,1854,261,576,0.453,91,256,0.355,87,106,0.821,50,163,213,68,34,9,78,104,700,612,0.87,0.44,2014,15,8.974358974358974,0.8717948717948718,315,19,334,0.6377245508982036
2014-15,RegularSeason,203095,144,Evan Fournier,1610612753,ORL,58,1661,253,575,0.44,85,225,0.378,107,147,0.728,28,125,153,120,40,2,82,116,698,569,1.46,0.49,2014,15,12.03448275862069,1.4634146341463414,322,40,362,0.42265193370165743
2014-15,RegularSeason,101161,145,Amir Johnson,1610612761,TOR,75,1979,298,519,0.574,19,46,0.413,79,129,0.612,159,297,456,117,44,59,110,225,694,989,1.06,0.4,2014,15,9.253333333333334,1.0636363636363637,221,50,271,1.6826568265682658
2014-15,RegularSeason,202684,146,Tristan Thompson,1610612739,CLE,82,2194,267,488,0.547,0,0,0.0,159,248,0.641,274,383,657,39,34,61,83,189,693,1091,0.47,0.41,2014,15,8.451219512195122,0.46987951807228917,221,89,310,2.1193548387096772
2014-15,RegularSeason,201588,147,George Hill,1610612754,IND,43,1267,255,535,0.477,69,193,0.358,113,143,0.79,25,154,179,220,44,14,69,111,692,770,3.19,0.64,2014,15,16.093023255813954,3.1884057971014492,280,30,310,0.5774193548387097
2014-15,RegularSeason,201142,148,Kevin Durant,1610612760,OKC,27,913,238,467,0.51,64,159,0.403,146,171,0.854,16,162,178,110,24,25,74,40,686,695,1.49,0.32,2014,15,25.40740740740741,1.4864864864864864,229,25,254,0.7007874015748031
2014-15,RegularSeason,203497,148,Rudy Gobert,1610612762,UTA,82,2158,258,427,0.604,0,2,0.0,170,273,0.623,265,510,775,109,64,189,111,175,686,1440,0.98,0.58,2014,15,8.365853658536585,0.9819819819819819,169,103,272,2.849264705882353
2014-15,RegularSeason,2405,150,Amar'e Stoudemire,1610612742,DAL,59,1244,273,490,0.557,0,4,0.0,134,186,0.72,110,219,329,45,29,38,78,161,680,774,0.58,0.37,2014,15,11.525423728813559,0.5769230769230769,217,52,269,1.2230483271375465
2014-15,RegularSeason,101141,151,Ersan Ilyasova,1610612749,MIL,58,1319,263,557,0.472,74,190,0.389,69,107,0.645,80,197,277,56,36,19,45,149,669,680,1.24,0.8,2014,15,11.53448275862069,1.2444444444444445,294,38,332,0.8343373493975904
2014-15,RegularSeason,2734,152,Devin Harris,1610612742,DAL,76,1685,219,524,0.418,95,266,0.357,132,162,0.815,13,122,135,237,78,14,85,147,665,709,2.79,0.92,2014,15,8.75,2.788235294117647,305,30,335,0.40298507462686567
2014-15,RegularSeason,201587,153,Nicolas Batum,1610612757,POR,71,2380,240,600,0.4,100,309,0.324,84,98,0.857,62,354,416,341,78,40,132,106,664,1033,2.58,0.59,2014,15,9.352112676056338,2.5833333333333335,360,14,374,1.1122994652406417
2014-15,RegularSeason,201975,154,Jodie Meeks,1610612765,DET,60,1462,222,534,0.416,74,212,0.349,145,160,0.906,12,92,104,79,59,6,57,76,663,527,1.39,1.03,2014,15,11.05,1.3859649122807018,312,15,327,0.3180428134556575
2014-15,RegularSeason,201601,155,Luc Mbah a Moute,1610612755,PHI,67,1916,251,636,0.395,62,202,0.307,96,163,0.589,82,246,328,106,81,21,99,104,660,645,1.07,0.82,2014,15,9.850746268656716,1.0707070707070707,385,67,452,0.7256637168141593
2014-15,RegularSeason,202334,156,Ed Davis,1610612747,LAL,79,1840,282,469,0.601,0,0,0.0,92,189,0.487,230,370,600,94,49,98,58,202,656,1155,1.62,0.84,2014,15,8.30379746835443,1.6206896551724137,187,97,284,2.112676056338028
2014-15,RegularSeason,201160,156,Jason Smith,1610612752,NYK,82,1785,257,592,0.434,15,42,0.357,127,153,0.83,98,226,324,140,32,44,104,205,656,731,1.35,0.31,2014,15,8.0,1.3461538461538463,335,26,361,0.8975069252077562
2014-15,RegularSeason,203482,156,Kelly Olynyk,1610612738,BOS,64,1424,251,528,0.475,61,175,0.349,93,136,0.684,92,211,303,109,64,39,98,213,656,753,1.11,0.65,2014,15,10.25,1.1122448979591837,277,43,320,0.946875
2014-15,RegularSeason,201961,159,Wayne Ellington,1610612747,LAL,65,1675,254,617,0.412,90,243,0.37,52,64,0.813,31,179,210,105,33,2,50,77,650,575,2.1,0.66,2014,15,10.0,2.1,363,12,375,0.56
2014-15,RegularSeason,202335,160,Patrick Patterson,1610612761,TOR,81,2156,240,535,0.449,105,283,0.371,63,80,0.788,127,306,433,155,60,44,54,149,648,974,2.87,1.11,2014,15,8.0,2.8703703703703702,295,17,312,1.3878205128205128
2014-15,RegularSeason,2730,161,Dwight Howard,1610612745,HOU,41,1223,251,423,0.593,1,2,0.5,143,271,0.528,110,321,431,50,28,53,115,137,646,793,0.43,0.24,2014,15,15.75609756097561,0.43478260869565216,172,128,300,1.4366666666666668
2014-15,RegularSeason,201959,162,Taj Gibson,1610612741,CHI,62,1692,254,506,0.502,0,0,0.0,132,184,0.717,162,234,396,71,36,75,77,162,640,837,0.92,0.47,2014,15,10.32258064516129,0.922077922077922,252,52,304,1.3026315789473684
2014-15,RegularSeason,2549,163,Chris Kaman,1610612757,POR,74,1398,283,549,0.515,0,0,0.0,72,102,0.706,149,335,484,65,18,54,108,140,638,855,0.6,0.17,2014,15,8.621621621621621,0.6018518518518519,266,30,296,1.635135135135135
2014-15,RegularSeason,201943,164,Brandon Jennings,1610612765,DET,41,1173,218,543,0.401,76,211,0.36,120,143,0.839,21,83,104,272,44,4,90,64,632,618,3.02,0.49,2014,15,15.414634146341463,3.022222222222222,325,23,348,0.2988505747126437
2014-15,RegularSeason,203109,165,Jae Crowder,1610612738,BOS,82,1647,229,545,0.42,61,208,0.293,109,141,0.773,72,221,293,94,72,25,49,137,628,715,1.92,1.47,2014,15,7.658536585365853,1.9183673469387754,316,32,348,0.8419540229885057
2014-15,RegularSeason,203138,166,Hollis Thompson,1610612755,PHI,71,1776,224,543,0.413,115,287,0.401,63,89,0.708,53,145,198,85,57,26,66,141,626,581,1.29,0.86,2014,15,8.816901408450704,1.2878787878787878,319,26,345,0.5739130434782609
2014-15,RegularSeason,202682,167,Derrick Williams,1610612758,SAC,74,1462,217,485,0.447,49,156,0.314,134,196,0.684,41,161,202,50,34,4,56,67,617,521,0.89,0.61,2014,15,8.337837837837839,0.8928571428571429,268,62,330,0.6121212121212121
2014-15,RegularSeason,200765,168,Rajon Rondo,1610612742,DAL,68,2019,275,645,0.426,27,86,0.314,31,78,0.397,73,300,373,538,91,7,210,153,608,990,2.56,0.43,2014,15,8.941176470588236,2.5619047619047617,370,47,417,0.894484412470024
2014-15,RegularSeason,2585,169,Zaza Pachulia,1610612749,MIL,73,1730,240,529,0.454,0,3,0.0,126,160,0.788,197,303,500,178,80,21,133,170,606,929,1.34,0.6,2014,15,8.301369863013699,1.3383458646616542,289,34,323,1.5479876160990713
2014-15,RegularSeason,2757,170,Beno Udrih,1610612763,MEM,79,1494,246,505,0.487,26,97,0.268,87,102,0.853,20,123,143,220,46,8,89,88,605,659,2.47,0.52,2014,15,7.658227848101266,2.4719101123595504,259,15,274,0.5218978102189781
2014-15,RegularSeason,2738,171,Andre Iguodala,1610612744,GSW,77,2069,231,496,0.466,74,212,0.349,68,114,0.596,44,213,257,228,89,25,88,100,604,804,2.59,1.01,2014,15,7.8441558441558445,2.590909090909091,265,46,311,0.8263665594855305
2014-15,RegularSeason,201573,172,Jerryd Bayless,1610612749,MIL,77,1717,220,516,0.426,37,120,0.308,121,137,0.883,22,189,211,233,59,12,133,163,598,668,1.75,0.44,2014,15,7.766233766233766,1.7518796992481203,296,16,312,0.6762820512820513
2014-15,RegularSeason,203077,172,Michael Kidd-Gilchrist,1610612766,CHA,55,1587,224,482,0.465,0,0,0.0,150,214,0.701,109,307,416,77,30,38,63,115,598,774,1.22,0.48,2014,15,10.872727272727273,1.2222222222222223,258,64,322,1.2919254658385093
2014-15,RegularSeason,2399,174,Mike Dunleavy,1610612741,CHI,63,1838,209,481,0.435,107,263,0.407,70,87,0.805,28,220,248,114,39,21,60,123,595,668,1.9,0.65,2014,15,9.444444444444445,1.9,272,17,289,0.8581314878892734
2014-15,RegularSeason,201956,175,Omri Casspi,1610612758,SAC,67,1416,209,427,0.489,35,87,0.402,140,191,0.733,54,206,260,102,31,9,88,107,593,638,1.16,0.35,2014,15,8.850746268656716,1.1590909090909092,218,51,269,0.966542750929368
2014-15,RegularSeason,201950,176,Jrue Holiday,1610612740,NOP,40,1303,238,534,0.446,51,135,0.378,65,76,0.855,32,103,135,274,63,23,91,110,592,689,3.01,0.69,2014,15,14.8,3.010989010989011,296,11,307,0.43973941368078173
2014-15,RegularSeason,203156,177,Henry Sims,1610612755,PHI,73,1399,238,502,0.474,4,22,0.182,106,137,0.774,121,238,359,79,39,30,99,135,586,699,0.8,0.39,2014,15,8.027397260273972,0.797979797979798,264,31,295,1.2169491525423728
2014-15,RegularSeason,200826,178,J.J. Barea,1610612742,DAL,77,1362,225,536,0.42,54,167,0.323,76,94,0.809,23,111,134,263,33,1,70,104,580,612,3.76,0.47,2014,15,7.532467532467533,3.757142857142857,311,18,329,0.4072948328267477
2014-15,RegularSeason,2446,178,Rasual Butler,1610612764,WAS,75,1505,218,517,0.422,91,235,0.387,53,67,0.791,27,170,197,63,29,22,48,98,580,530,1.31,0.6,2014,15,7.733333333333333,1.3125,299,14,313,0.6293929712460063
2014-15,RegularSeason,101107,180,Marvin Williams,1610612766,CHA,78,2035,210,495,0.424,95,265,0.358,62,87,0.713,58,328,386,100,69,36,60,146,577,798,1.67,1.15,2014,15,7.397435897435898,1.6666666666666667,285,25,310,1.2451612903225806
2014-15,RegularSeason,202708,181,Norris Cole,1610612740,NOP,75,1831,230,558,0.412,55,176,0.313,58,81,0.716,13,146,159,255,57,15,99,124,573,609,2.58,0.58,2014,15,7.64,2.5757575757575757,328,23,351,0.452991452991453
2014-15,RegularSeason,201228,182,C.J. Watson,1610612754,IND,57,1422,181,417,0.434,70,175,0.4,138,167,0.826,18,145,163,208,57,9,100,107,570,642,2.08,0.57,2014,15,10.0,2.08,236,29,265,0.6150943396226415
2014-15,RegularSeason,201158,183,Marco Belinelli,1610612759,SAS,62,1388,199,470,0.423,86,230,0.374,84,99,0.848,26,131,157,94,31,3,61,85,568,506,1.54,0.51,2014,15,9.161290322580646,1.540983606557377,271,15,286,0.548951048951049
2014-15,RegularSeason,201976,183,Patrick Beverley,1610612745,HOU,56,1727,204,532,0.383,115,323,0.356,45,60,0.75,67,170,237,192,59,23,83,182,568,653,2.31,0.71,2014,15,10.142857142857142,2.3132530120481927,328,15,343,0.6909620991253644
2014-15,RegularSeason,202344,185,Trevor Booker,1610612762,UTA,79,1564,226,464,0.487,29,84,0.345,86,148,0.581,139,258,397,83,43,41,88,144,567,743,0.94,0.49,2014,15,7.177215189873418,0.9431818181818182,238,62,300,1.3233333333333333
2014-15,RegularSeason,201577,186,Robin Lopez,1610612757,POR,59,1638,234,437,0.535,0,1,0.0,98,127,0.772,190,204,394,55,16,84,73,122,566,810,0.75,0.22,2014,15,9.59322033898305,0.7534246575342466,203,29,232,1.6982758620689655
2014-15,RegularSeason,202355,187,Hassan Whiteside,1610612748,MIA,48,1142,243,387,0.628,0,0,0.0,78,156,0.5,145,337,482,6,27,123,58,129,564,922,0.1,0.47,2014,15,11.75,0.10344827586206896,144,78,222,2.171171171171171
2014-15,RegularSeason,201156,188,Nick Young,1610612747,LAL,42,1000,174,476,0.366,83,225,0.369,132,148,0.892,17,79,96,41,23,11,44,83,563,372,0.93,0.52,2014,15,13.404761904761905,0.9318181818181818,302,16,318,0.3018867924528302
2014-15,RegularSeason,201600,189,Ömer Aşik,1610612740,NOP,76,1982,213,412,0.517,0,0,0.0,131,225,0.582,244,504,748,72,29,54,95,144,557,1072,0.76,0.3,2014,15,7.328947368421052,0.7578947368421053,199,94,293,2.5529010238907848
2014-15,RegularSeason,201949,190,James Johnson,1610612761,TOR,70,1370,238,404,0.589,11,51,0.216,67,102,0.657,61,196,257,95,54,70,79,155,554,750,1.2,0.68,2014,15,7.914285714285715,1.2025316455696202,166,35,201,1.2786069651741294
2014-15,RegularSeason,201581,191,JJ Hickson,1610612743,DEN,73,1411,218,459,0.475,0,2,0.0,116,201,0.577,150,302,452,57,36,35,96,136,552,710,0.59,0.38,2014,15,7.561643835616438,0.59375,241,85,326,1.3865030674846626
2014-15,RegularSeason,101112,192,Channing Frye,1610612753,ORL,75,1870,191,487,0.392,136,346,0.393,31,35,0.886,27,266,293,94,47,39,78,191,549,644,1.21,0.6,2014,15,7.32,1.205128205128205,296,4,300,0.9766666666666667
2014-15,RegularSeason,101187,193,Alan Anderson,1610612751,BKN,74,1744,195,440,0.443,73,210,0.348,82,101,0.812,31,173,204,83,56,5,60,148,545,569,1.38,0.93,2014,15,7.364864864864865,1.3833333333333333,245,19,264,0.7727272727272727
2014-15,RegularSeason,201148,194,Brandan Wright,1610612756,PHX,75,1449,233,363,0.642,0,3,0.0,78,112,0.696,128,193,321,41,50,94,34,102,544,852,1.21,1.47,2014,15,7.253333333333333,1.2058823529411764,130,34,164,1.9573170731707317
2014-15,RegularSeason,202390,195,Gary Neal,1610612750,MIN,54,1192,188,503,0.374,50,164,0.305,117,135,0.867,14,115,129,100,23,1,65,88,543,398,1.54,0.35,2014,15,10.055555555555555,1.5384615384615385,315,18,333,0.38738738738738737
2014-15,RegularSeason,1891,196,Jason Terry,1610612745,HOU,77,1641,188,446,0.422,126,323,0.39,39,48,0.813,15,106,121,147,66,19,74,116,541,553,1.99,0.89,2014,15,7.025974025974026,1.9864864864864864,258,9,267,0.45318352059925093
2014-15,RegularSeason,2754,197,Tony Allen,1610612763,MEM,63,1648,225,455,0.495,10,29,0.345,79,126,0.627,103,177,280,86,129,30,86,166,539,701,1.0,1.5,2014,15,8.555555555555555,1.0,230,47,277,1.0108303249097472
2014-15,RegularSeason,202347,198,Quincy Pondexter,1610612740,NOP,75,1793,188,447,0.421,91,244,0.373,71,96,0.74,53,142,195,94,19,24,51,150,538,535,1.84,0.37,2014,15,7.173333333333333,1.8431372549019607,259,25,284,0.6866197183098591
2014-15,RegularSeason,203500,199,Steven Adams,1610612760,OKC,70,1771,217,399,0.544,0,2,0.0,103,205,0.502,199,324,523,66,38,86,99,222,537,867,0.67,0.38,2014,15,7.671428571428572,0.6666666666666666,182,102,284,1.841549295774648
2014-15,RegularSeason,202709,200,Cory Joseph,1610612759,SAS,79,1444,207,411,0.504,16,44,0.364,105,143,0.734,44,148,192,188,46,17,67,105,535,669,2.81,0.69,2014,15,6.772151898734177,2.8059701492537314,204,38,242,0.7933884297520661
2014-15,RegularSeason,204038,201,Langston Galloway,1610612752,NYK,45,1457,204,511,0.399,62,176,0.352,63,78,0.808,37,153,190,150,52,12,61,129,533,554,2.46,0.85,2014,15,11.844444444444445,2.459016393442623,307,15,322,0.5900621118012422
2014-15,RegularSeason,203085,202,Austin Rivers,1610612746,LAC,76,1563,203,496,0.409,39,131,0.298,85,126,0.675,27,125,152,155,48,14,65,146,530,500,2.38,0.74,2014,15,6.973684210526316,2.3846153846153846,293,41,334,0.4550898203592814
2014-15,RegularSeason,203118,203,Mike Scott,1610612737,ATL,68,1123,201,453,0.444,66,192,0.344,61,77,0.792,45,154,199,75,25,3,39,83,529,524,1.92,0.64,2014,15,7.779411764705882,1.9230769230769231,252,16,268,0.7425373134328358
2014-15,RegularSeason,2749,204,Jameer Nelson,1610612743,DEN,63,1406,205,504,0.407,89,258,0.345,24,36,0.667,33,113,146,253,47,6,109,136,523,555,2.32,0.43,2014,15,8.301587301587302,2.3211009174311927,299,12,311,0.4694533762057878
2014-15,RegularSeason,203935,204,Marcus Smart,1610612738,BOS,67,1808,175,477,0.367,91,272,0.335,82,127,0.646,61,161,222,208,99,18,90,176,523,633,2.31,1.1,2014,15,7.8059701492537314,2.311111111111111,302,45,347,0.6397694524495677
2014-15,RegularSeason,202338,206,Kevin Seraphin,1610612764,WAS,79,1235,231,450,0.513,0,2,0.0,58,82,0.707,87,201,288,59,10,59,98,197,520,595,0.6,0.1,2014,15,6.582278481012659,0.6020408163265306,219,24,243,1.1851851851851851
2014-15,RegularSeason,201162,207,Jared Dudley,1610612749,MIL,72,1717,198,423,0.468,74,192,0.385,48,67,0.716,45,175,220,130,72,11,62,113,518,645,2.1,1.16,2014,15,7.194444444444445,2.096774193548387,225,19,244,0.9016393442622951
2014-15,RegularSeason,203498,208,Shabazz Muhammad,1610612750,MIN,38,866,194,397,0.489,20,51,0.392,104,145,0.717,63,91,154,44,18,7,35,49,512,456,1.26,0.51,2014,15,13.473684210526315,1.2571428571428571,203,41,244,0.6311475409836066
2014-15,RegularSeason,2743,209,Kris Humphries,1610612764,WAS,64,1345,211,446,0.473,0,7,0.0,87,117,0.744,118,298,416,57,34,25,46,130,509,730,1.24,0.74,2014,15,7.953125,1.2391304347826086,235,30,265,1.569811320754717
2014-15,RegularSeason,203100,210,Tony Wroten,1610612755,PHI,30,895,175,434,0.403,37,142,0.261,120,180,0.667,22,64,86,157,48,8,113,72,507,374,1.39,0.42,2014,15,16.9,1.3893805309734513,259,60,319,0.26959247648902823
2014-15,RegularSeason,201171,211,Carl Landry,1610612758,SAC,70,1192,190,369,0.515,0,0,0.0,123,150,0.82,99,169,268,26,15,17,54,132,503,569,0.48,0.28,2014,15,7.185714285714286,0.48148148148148145,179,27,206,1.3009708737864079
2014-15,RegularSeason,203492,211,Ray McCallum,1610612758,SAC,68,1436,206,470,0.438,34,111,0.306,57,84,0.679,52,128,180,188,45,11,85,92,503,551,2.21,0.53,2014,15,7.397058823529412,2.211764705882353,264,27,291,0.6185567010309279
2014-15,RegularSeason,202362,213,Lance Stephenson,1610612766,CHA,61,1573,207,550,0.376,18,105,0.171,69,110,0.627,39,238,277,240,38,8,128,134,501,552,1.88,0.3,2014,15,8.21311475409836,1.875,343,41,384,0.7213541666666666
2014-15,RegularSeason,202697,214,Iman Shumpert,1610612739,CLE,62,1545,193,471,0.41,67,196,0.342,43,64,0.672,55,169,224,135,81,16,91,138,496,562,1.48,0.89,2014,15,8.0,1.4835164835164836,278,21,299,0.7491638795986622
2014-15,RegularSeason,201574,215,Jason Thompson,1610612758,SAC,81,1991,201,428,0.47,0,1,0.0,89,143,0.622,139,391,530,85,33,57,84,239,491,831,1.01,0.39,2014,15,6.061728395061729,1.0119047619047619,227,54,281,1.886120996441281
2014-15,RegularSeason,203909,216,KJ McDaniels,1610612745,HOU,62,1352,172,434,0.396,43,150,0.287,100,133,0.752,65,135,200,72,44,70,105,126,487,473,0.69,0.42,2014,15,7.854838709677419,0.6857142857142857,262,33,295,0.6779661016949152
2014-15,RegularSeason,201149,217,Joakim Noah,1610612741,CHI,67,2049,190,427,0.445,0,2,0.0,105,174,0.603,219,427,646,312,48,74,123,203,485,1136,2.54,0.39,2014,15,7.2388059701492535,2.5365853658536586,237,69,306,2.111111111111111
2014-15,RegularSeason,201229,218,Anthony Tolliver,1610612765,DET,76,1433,161,393,0.41,106,290,0.366,54,69,0.783,51,185,236,59,24,16,51,137,482,519,1.16,0.47,2014,15,6.342105263157895,1.1568627450980393,232,15,247,0.9554655870445344
2014-15,RegularSeason,203148,219,Brian Roberts,1610612766,CHA,72,1330,176,452,0.389,62,193,0.321,66,74,0.892,13,96,109,162,33,6,57,75,480,449,2.84,0.58,2014,15,6.666666666666667,2.8421052631578947,276,8,284,0.38380281690140844
2014-15,RegularSeason,202713,219,Kyle Singler,1610612760,OKC,80,1744,172,446,0.386,96,241,0.398,40,52,0.769,33,161,194,85,47,21,55,153,480,486,1.54,0.85,2014,15,6.0,1.5454545454545454,274,12,286,0.6783216783216783
2014-15,RegularSeason,203469,221,Cody Zeller,1610612766,CHA,62,1487,172,373,0.461,1,1,1.0,127,164,0.774,97,265,362,100,34,49,62,156,472,717,1.61,0.55,2014,15,7.612903225806452,1.6129032258064515,201,37,238,1.5210084033613445
2014-15,RegularSeason,203089,222,John Henson,1610612749,MIL,67,1228,196,346,0.566,0,0,0.0,78,137,0.569,124,188,312,59,28,135,87,152,470,708,0.68,0.32,2014,15,7.014925373134329,0.6781609195402298,150,59,209,1.492822966507177
2014-15,RegularSeason,203499,222,Shane Larkin,1610612752,NYK,76,1865,187,432,0.433,35,116,0.302,61,78,0.782,29,147,176,226,93,9,83,150,470,629,2.72,1.12,2014,15,6.184210526315789,2.7228915662650603,245,17,262,0.6717557251908397
2014-15,RegularSeason,2571,224,Leandro Barbosa,1610612744,GSW,66,982,183,386,0.474,43,112,0.384,58,74,0.784,23,68,91,99,41,8,44,87,467,443,2.25,0.93,2014,15,7.075757575757576,2.25,203,16,219,0.4155251141552511
2014-15,RegularSeason,203382,225,Aron Baynes,1610612759,SAS,70,1122,185,327,0.566,1,4,0.25,90,104,0.865,109,209,318,35,16,22,65,162,461,631,0.54,0.25,2014,15,6.585714285714285,0.5384615384615384,142,14,156,2.0384615384615383
2014-15,RegularSeason,2733,225,Shaun Livingston,1610612744,GSW,78,1468,198,396,0.5,0,2,0.0,65,91,0.714,43,140,183,259,49,20,102,110,461,646,2.54,0.48,2014,15,5.910256410256411,2.5392156862745097,198,26,224,0.8169642857142857
2014-15,RegularSeason,2406,227,Caron Butler,1610612765,DET,78,1623,161,396,0.407,83,219,0.379,55,61,0.902,21,175,196,79,43,4,49,120,460,492,1.61,0.88,2014,15,5.897435897435898,1.6122448979591837,235,6,241,0.8132780082987552
2014-15,RegularSeason,201978,228,Chase Budinger,1610612750,MIN,67,1286,169,390,0.433,52,143,0.364,67,81,0.827,33,165,198,64,44,10,49,72,457,489,1.31,0.9,2014,15,6.82089552238806,1.3061224489795917,221,14,235,0.8425531914893617
2014-15,RegularSeason,201973,229,Jonas Jerebko,1610612738,BOS,75,1230,169,379,0.446,54,140,0.386,56,66,0.848,93,189,282,71,46,18,44,135,448,601,1.61,1.04,2014,15,5.973333333333334,1.6136363636363635,210,10,220,1.2818181818181817
2014-15,RegularSeason,203490,230,Otto Porter Jr.,1610612764,WAS,74,1432,176,391,0.45,35,104,0.337,58,79,0.734,70,151,221,65,44,30,52,97,445,517,1.25,0.85,2014,15,6.013513513513513,1.25,215,21,236,0.9364406779661016
2014-15,RegularSeason,201582,231,Alexis Ajinca,1610612740,NOP,68,957,181,329,0.55,0,0,0.0,81,99,0.818,104,211,315,47,21,51,69,151,443,642,0.68,0.3,2014,15,6.514705882352941,0.6811594202898551,148,18,166,1.8975903614457832
2014-15,RegularSeason,202498,231,Lance Thomas,1610612752,NYK,62,1491,182,442,0.412,7,22,0.318,72,99,0.727,65,130,195,69,37,8,74,101,443,391,0.93,0.5,2014,15,7.145161290322581,0.9324324324324325,260,27,287,0.6794425087108014
2014-15,RegularSeason,200751,233,Randy Foye,1610612743,DEN,50,1087,148,402,0.368,94,263,0.357,45,55,0.818,9,76,85,119,34,11,60,97,435,360,1.98,0.57,2014,15,8.7,1.9833333333333334,254,10,264,0.32196969696969696
2014-15,RegularSeason,203503,233,Tony Snell,1610612741,CHI,72,1412,159,371,0.429,73,197,0.371,44,55,0.8,31,145,176,62,32,11,48,86,435,445,1.29,0.67,2014,15,6.041666666666667,1.2916666666666667,212,11,223,0.7892376681614349
2014-15,RegularSeason,203144,235,Alexey Shved,1610612752,NYK,42,767,133,335,0.397,47,139,0.338,121,150,0.807,23,76,99,106,30,6,48,48,434,396,2.21,0.63,2014,15,10.333333333333334,2.2083333333333335,202,29,231,0.42857142857142855
2014-15,RegularSeason,2419,235,Tayshaun Prince,1610612765,DET,58,1397,177,402,0.44,31,67,0.463,49,65,0.754,52,158,210,93,29,16,35,55,434,506,2.66,0.83,2014,15,7.482758620689655,2.657142857142857,225,16,241,0.8713692946058091
2014-15,RegularSeason,203918,237,Rodney Hood,1610612762,UTA,50,1064,155,374,0.414,62,170,0.365,61,80,0.763,9,108,117,83,30,12,45,119,433,392,1.84,0.67,2014,15,8.66,1.8444444444444446,219,19,238,0.49159663865546216
2014-15,RegularSeason,203458,238,Alex Len,1610612756,PHX,69,1518,179,353,0.507,1,3,0.333,73,104,0.702,142,312,454,32,34,105,74,213,432,778,0.43,0.46,2014,15,6.260869565217392,0.43243243243243246,174,31,205,2.2146341463414636
2014-15,RegularSeason,203477,238,Isaiah Canaan,1610612755,PHI,47,938,146,378,0.386,91,246,0.37,49,60,0.817,18,69,87,98,29,3,62,83,432,344,1.58,0.47,2014,15,9.191489361702128,1.5806451612903225,232,11,243,0.35802469135802467
2014-15,RegularSeason,2210,238,Richard Jefferson,1610612742,DAL,74,1244,144,324,0.444,66,155,0.426,78,114,0.684,25,158,183,61,32,11,52,115,432,451,1.17,0.61,2014,15,5.837837837837838,1.1730769230769231,180,36,216,0.8472222222222222
2014-15,RegularSeason,200745,241,Andrea Bargnani,1610612752,NYK,29,785,164,361,0.454,15,41,0.366,87,107,0.813,32,95,127,46,2,27,42,53,430,373,1.09,0.05,2014,15,14.827586206896552,1.0952380952380953,197,20,217,0.5852534562211982
2014-15,RegularSeason,201168,242,Tiago Splitter,1610612759,SAS,52,1030,169,303,0.558,0,0,0.0,90,120,0.75,91,161,252,78,35,37,60,103,428,606,1.3,0.58,2014,15,8.23076923076923,1.3,134,30,164,1.5365853658536586
2014-15,RegularSeason,203994,243,Jusuf Nurkic,1610612743,DEN,62,1103,171,383,0.446,0,2,0.0,84,132,0.636,125,257,382,50,52,68,86,207,426,632,0.58,0.6,2014,15,6.870967741935484,0.5813953488372093,212,48,260,1.4692307692307693
2014-15,RegularSeason,201150,244,Spencer Hawes,1610612746,LAC,73,1274,163,415,0.393,55,176,0.313,44,68,0.647,30,228,258,88,24,53,61,173,425,511,1.44,0.39,2014,15,5.821917808219178,1.4426229508196722,252,24,276,0.9347826086956522
2014-15,RegularSeason,203468,245,CJ McCollum,1610612757,POR,62,973,159,365,0.436,55,139,0.396,51,73,0.699,14,77,91,64,43,8,48,81,424,354,1.33,0.9,2014,15,6.838709677419355,1.3333333333333333,206,22,228,0.3991228070175439
2014-15,RegularSeason,101106,246,Andrew Bogut,1610612744,GSW,67,1583,200,355,0.563,0,0,0.0,22,42,0.524,141,402,543,180,39,113,106,188,422,1016,1.7,0.37,2014,15,6.298507462686567,1.6981132075471699,155,20,175,3.1028571428571428
2014-15,RegularSeason,201585,247,Kosta Koufos,1610612763,MEM,81,1348,182,358,0.508,0,0,0.0,55,85,0.647,121,305,426,37,29,63,69,148,419,699,0.54,0.42,2014,15,5.172839506172839,0.5362318840579711,176,30,206,2.0679611650485437
2014-15,RegularSeason,202329,248,Al-Farouq Aminu,1610612742,DAL,74,1366,147,357,0.412,34,124,0.274,84,118,0.712,114,228,342,59,70,62,55,137,412,646,1.07,1.27,2014,15,5.5675675675675675,1.0727272727272728,210,34,244,1.401639344262295
2014-15,RegularSeason,203924,249,Jerami Grant,1610612755,PHI,65,1377,124,352,0.352,49,156,0.314,114,193,0.591,49,149,198,79,40,68,85,144,411,404,0.93,0.47,2014,15,6.323076923076923,0.9294117647058824,228,79,307,0.6449511400651465
2014-15,RegularSeason,101111,250,Charlie Villanueva,1610612742,DAL,64,678,150,362,0.414,83,221,0.376,20,35,0.571,30,119,149,19,15,22,28,64,403,353,0.68,0.54,2014,15,6.296875,0.6785714285714286,212,15,227,0.6563876651982379
2014-15,RegularSeason,201196,251,Ramon Sessions,1610612764,WAS,64,1188,125,334,0.374,19,60,0.317,133,173,0.769,23,121,144,182,29,0,86,73,402,422,2.12,0.34,2014,15,6.28125,2.116279069767442,209,40,249,0.5783132530120482
2014-15,RegularSeason,203112,252,Quincy Acy,1610612752,NYK,68,1287,152,331,0.459,18,60,0.3,76,97,0.784,79,222,301,68,27,22,60,147,398,556,1.13,0.45,2014,15,5.852941176470588,1.1333333333333333,179,21,200,1.505
2014-15,RegularSeason,203115,253,Will Barton,1610612743,DEN,58,984,150,353,0.425,23,85,0.271,74,94,0.787,26,136,162,81,48,19,61,70,397,423,1.33,0.79,2014,15,6.844827586206897,1.3278688524590163,203,20,223,0.726457399103139
2014-15,RegularSeason,204060,254,Joe Ingles,1610612762,UTA,79,1673,147,354,0.415,72,202,0.356,30,40,0.75,22,153,175,182,72,10,98,124,396,520,1.86,0.73,2014,15,5.012658227848101,1.8571428571428572,207,10,217,0.8064516129032258
2014-15,RegularSeason,203957,255,Dante Exum,1610612762,UTA,82,1817,145,416,0.349,83,264,0.314,20,32,0.625,27,104,131,198,41,14,118,147,393,376,1.68,0.35,2014,15,4.7926829268292686,1.6779661016949152,271,12,283,0.4628975265017668
2014-15,RegularSeason,202388,256,Donald Sloan,1610612754,IND,53,1107,145,355,0.408,41,131,0.313,60,77,0.779,12,131,143,190,23,0,65,47,391,455,2.92,0.35,2014,15,7.377358490566038,2.923076923076923,210,17,227,0.6299559471365639
2014-15,RegularSeason,203145,257,Kent Bazemore,1610612737,ATL,75,1324,141,331,0.426,48,132,0.364,60,100,0.6,21,201,222,78,52,33,73,127,390,472,1.07,0.71,2014,15,5.2,1.0684931506849316,190,40,230,0.9652173913043478
2014-15,RegularSeason,101135,258,David Lee,1610612744,GSW,49,904,160,313,0.511,0,2,0.0,68,104,0.654,81,176,257,85,31,26,49,83,388,549,1.74,0.63,2014,15,7.918367346938775,1.7346938775510203,153,36,189,1.3597883597883598
2014-15,RegularSeason,203960,259,JaKarr Sampson,1610612755,PHI,74,1131,146,346,0.422,31,127,0.244,63,94,0.67,35,128,163,77,38,26,76,135,386,383,1.01,0.5,2014,15,5.216216216216216,1.013157894736842,200,31,231,0.7056277056277056
2014-15,RegularSeason,201593,259,Nikola Pekovic,1610612750,MIN,31,815,139,328,0.424,0,0,0.0,108,129,0.837,89,145,234,27,19,12,42,59,386,426,0.64,0.45,2014,15,12.451612903225806,0.6428571428571429,189,21,210,1.1142857142857143
2014-15,RegularSeason,203093,259,Terrence Jones,1610612745,HOU,33,889,158,299,0.528,13,37,0.351,57,94,0.606,78,142,220,36,18,59,37,78,386,504,0.97,0.49,2014,15,11.696969696969697,0.972972972972973,141,37,178,1.2359550561797752
2014-15,RegularSeason,1713,262,Vince Carter,1610612763,MEM,66,1091,135,406,0.333,69,232,0.297,45,57,0.789,27,106,133,79,43,14,43,102,384,327,1.84,1.0,2014,15,5.818181818181818,1.8372093023255813,271,12,283,0.46996466431095407
2014-15,RegularSeason,201589,263,Darrell Arthur,1610612743,DEN,58,988,155,384,0.404,26,110,0.236,46,59,0.78,53,118,171,57,48,26,47,146,382,395,1.21,1.02,2014,15,6.586206896551724,1.2127659574468086,229,13,242,0.7066115702479339
2014-15,RegularSeason,101181,263,Jose Calderon,1610612752,NYK,42,1270,147,354,0.415,59,142,0.415,29,32,0.906,19,105,124,198,31,0,75,76,382,450,2.64,0.41,2014,15,9.095238095238095,2.64,207,3,210,0.5904761904761905
2014-15,RegularSeason,201977,265,Marcus Thornton,1610612756,PHX,48,721,140,345,0.406,54,143,0.378,46,56,0.821,23,63,86,36,27,7,27,38,380,294,1.33,1.0,2014,15,7.916666666666667,1.3333333333333333,205,10,215,0.4
2014-15,RegularSeason,204028,266,Tarik Black,1610612747,LAL,63,1195,157,273,0.575,0,1,0.0,65,118,0.551,142,226,368,42,19,24,48,158,379,615,0.88,0.4,2014,15,6.015873015873016,0.875,116,53,169,2.1775147928994083
2014-15,RegularSeason,2550,267,Kirk Hinrich,1610612741,CHI,66,1610,142,381,0.373,58,168,0.345,35,50,0.7,20,101,121,148,46,14,73,144,377,379,2.03,0.63,2014,15,5.712121212121212,2.0273972602739727,239,15,254,0.4763779527559055
2014-15,RegularSeason,202692,268,Alec Burks,1610612762,UTA,27,899,121,300,0.403,26,68,0.382,106,129,0.822,19,95,114,82,17,5,52,64,374,338,1.58,0.33,2014,15,13.851851851851851,1.5769230769230769,179,23,202,0.5643564356435643
2014-15,RegularSeason,203544,269,Pero Antic,1610612737,ATL,63,1037,108,296,0.365,52,173,0.301,88,123,0.715,58,131,189,49,18,14,49,132,356,354,1.0,0.37,2014,15,5.650793650793651,1.0,188,35,223,0.8475336322869955
2014-15,RegularSeason,1889,270,Andre Miller,1610612758,SAC,81,1253,145,290,0.5,7,34,0.206,58,77,0.753,37,116,153,284,32,6,104,103,355,562,2.73,0.31,2014,15,4.382716049382716,2.730769230769231,145,19,164,0.9329268292682927
2014-15,RegularSeason,201988,271,Patty Mills,1610612759,SAS,51,801,128,336,0.381,62,182,0.341,33,40,0.825,21,54,75,87,28,2,35,58,351,293,2.49,0.8,2014,15,6.882352941176471,2.4857142857142858,208,7,215,0.3488372093023256
2014-15,RegularSeason,2581,272,Steve Blake,1610612757,POR,81,1529,122,327,0.373,77,219,0.352,29,41,0.707,16,121,137,288,41,5,104,118,350,500,2.77,0.39,2014,15,4.320987654320987,2.769230769230769,205,12,217,0.631336405529954
2014-15,RegularSeason,2732,273,Ben Gordon,1610612753,ORL,56,790,129,295,0.437,35,97,0.361,56,67,0.836,6,57,63,50,14,1,55,60,349,245,0.91,0.26,2014,15,6.232142857142857,0.9090909090909091,166,11,177,0.3559322033898305
2014-15,RegularSeason,200761,274,Shawne Williams,1610612765,DET,63,1087,121,300,0.403,64,178,0.36,35,40,0.875,36,130,166,44,25,21,30,135,341,383,1.47,0.83,2014,15,5.412698412698413,1.4666666666666666,179,5,184,0.9021739130434783
2014-15,RegularSeason,201967,275,Dante Cunningham,1610612740,NOP,66,1652,155,339,0.457,1,10,0.1,29,47,0.617,70,186,256,50,46,37,35,101,340,492,1.43,1.31,2014,15,5.151515151515151,1.4285714285714286,184,18,202,1.2673267326732673
2014-15,RegularSeason,203141,276,Mirza Teletovic,1610612751,BKN,40,892,122,319,0.382,62,193,0.321,33,46,0.717,27,167,194,46,14,16,53,74,339,346,0.87,0.26,2014,15,8.475,0.8679245283018868,197,13,210,0.9238095238095239
2014-15,RegularSeason,202332,277,Cole Aldrich,1610612752,NYK,61,976,144,301,0.478,0,0,0.0,50,64,0.781,101,237,338,75,37,65,59,122,338,623,1.27,0.63,2014,15,5.540983606557377,1.271186440677966,157,14,171,1.976608187134503
2014-15,RegularSeason,202397,277,Ish Smith,1610612755,PHI,55,831,143,367,0.39,18,60,0.3,34,57,0.596,15,85,100,180,36,6,78,50,338,335,2.31,0.46,2014,15,6.1454545454545455,2.3076923076923075,224,23,247,0.4048582995951417
2014-15,RegularSeason,203527,279,Ryan Kelly,1610612747,LAL,52,1233,104,309,0.337,45,134,0.336,79,95,0.832,13,133,146,92,30,24,37,118,332,366,2.49,0.81,2014,15,6.384615384615385,2.4864864864864864,205,16,221,0.6606334841628959
2014-15,RegularSeason,203086,280,Meyers Leonard,1610612757,POR,55,847,125,245,0.51,47,112,0.42,30,32,0.938,46,204,250,32,10,14,39,113,327,472,0.82,0.26,2014,15,5.945454545454545,0.8205128205128205,120,2,122,2.0491803278688523
2014-15,RegularSeason,204014,281,Damjan Rudez,1610612754,IND,68,1047,119,263,0.452,69,170,0.406,16,23,0.696,8,39,47,53,16,5,47,79,323,246,1.13,0.34,2014,15,4.75,1.127659574468085,144,7,151,0.31125827814569534
2014-15,RegularSeason,708,281,Kevin Garnett,1610612750,MIN,47,952,143,306,0.467,1,7,0.143,36,45,0.8,48,263,311,77,46,17,46,109,323,556,1.67,1.0,2014,15,6.872340425531915,1.673913043478261,163,9,172,1.808139534883721
2014-15,RegularSeason,2365,283,Chris Andersen,1610612748,MIA,60,1132,120,207,0.58,4,13,0.308,76,114,0.667,76,223,299,43,26,61,40,88,320,584,1.07,0.65,2014,15,5.333333333333333,1.075,87,38,125,2.392
2014-15,RegularSeason,203521,284,Matthew Dellavedova,1610612739,CLE,67,1380,111,307,0.362,68,167,0.407,29,38,0.763,37,89,126,204,24,2,61,152,319,409,3.34,0.39,2014,15,4.7611940298507465,3.3442622950819674,196,9,205,0.6146341463414634
2014-15,RegularSeason,203917,284,Nik Stauskas,1610612758,SAC,73,1127,108,296,0.365,48,149,0.322,55,64,0.859,11,77,88,67,20,17,40,92,319,274,1.68,0.5,2014,15,4.36986301369863,1.675,188,9,197,0.4467005076142132
2014-15,RegularSeason,202730,286,Lavoy Allen,1610612754,IND,63,1070,141,299,0.472,0,0,0.0,33,47,0.702,123,200,323,73,15,42,40,102,315,556,1.82,0.38,2014,15,5.0,1.825,158,14,172,1.877906976744186
2014-15,RegularSeason,203516,287,James Ennis III,1610612748,MIA,62,1051,101,247,0.409,31,95,0.326,79,94,0.84,51,125,176,48,25,17,39,89,312,378,1.23,0.64,2014,15,5.032258064516129,1.2307692307692308,146,15,161,1.093167701863354
2014-15,RegularSeason,203142,288,Chris Copeland,1610612754,IND,50,828,112,310,0.361,52,167,0.311,33,45,0.733,23,88,111,51,11,11,59,78,309,224,0.86,0.19,2014,15,6.18,0.864406779661017,198,12,210,0.5285714285714286
2014-15,RegularSeason,203953,289,Jabari Parker,1610612749,MIL,25,738,129,263,0.49,4,16,0.25,46,66,0.697,50,88,138,42,31,5,47,42,308,323,0.89,0.66,2014,15,12.32,0.8936170212765957,134,20,154,0.8961038961038961
2014-15,RegularSeason,203080,289,Thomas Robinson,1610612755,PHI,54,798,126,260,0.485,0,2,0.0,56,106,0.528,95,208,303,33,32,20,59,104,308,453,0.56,0.54,2014,15,5.703703703703703,0.559322033898305,134,50,184,1.6467391304347827
2014-15,RegularSeason,203135,291,Robert Sacre,1610612747,LAL,67,1133,126,306,0.412,0,1,0.0,55,82,0.671,89,144,233,55,28,43,36,121,307,423,1.53,0.78,2014,15,4.582089552238806,1.5277777777777777,180,27,207,1.1256038647342994
2014-15,RegularSeason,2584,292,Willie Green,1610612753,ORL,52,951,118,306,0.386,42,121,0.347,28,34,0.824,14,65,79,68,26,5,48,81,306,242,1.42,0.54,2014,15,5.884615384615385,1.4166666666666667,188,6,194,0.4072164948453608
2014-15,RegularSeason,202687,293,Bismack Biyombo,1610612766,CHA,64,1243,101,186,0.543,0,0,0.0,102,175,0.583,159,248,407,16,18,99,52,140,304,634,0.31,0.35,2014,15,4.75,0.3076923076923077,85,73,158,2.5759493670886076
2014-15,RegularSeason,202714,294,Shelvin Mack,1610612737,ATL,55,833,117,292,0.401,40,127,0.315,25,31,0.806,8,71,79,155,30,2,49,32,299,335,3.16,0.61,2014,15,5.4363636363636365,3.163265306122449,175,6,181,0.43646408839779005
2014-15,RegularSeason,203461,295,Anthony Bennett,1610612750,MIN,57,894,125,297,0.421,7,23,0.304,41,64,0.641,52,164,216,48,27,16,36,87,298,374,1.33,0.75,2014,15,5.228070175438597,1.3333333333333333,172,23,195,1.1076923076923078
2014-15,RegularSeason,203087,296,Jeremy Lamb,1610612760,OKC,47,633,104,250,0.416,38,111,0.342,49,55,0.891,8,99,107,44,21,6,27,52,295,294,1.63,0.78,2014,15,6.276595744680851,1.6296296296296295,146,6,152,0.7039473684210527
2014-15,RegularSeason,201175,297,Glen Davis,1610612746,LAC,74,904,117,255,0.459,0,4,0.0,60,95,0.632,43,126,169,39,41,21,39,132,294,352,1.0,1.05,2014,15,3.972972972972973,1.0,138,35,173,0.976878612716763
2014-15,RegularSeason,203124,297,Kyle O'Quinn,1610612753,ORL,51,824,119,242,0.492,12,43,0.279,44,57,0.772,46,153,199,59,31,39,55,110,294,431,1.07,0.56,2014,15,5.764705882352941,1.0727272727272728,123,13,136,1.463235294117647
2014-15,RegularSeason,203101,297,Miles Plumlee,1610612749,MIL,73,1194,136,254,0.535,0,0,0.0,22,46,0.478,112,208,320,34,41,66,51,111,294,562,0.67,0.8,2014,15,4.027397260273973,0.6666666666666666,118,24,142,2.2535211267605635
2014-15,RegularSeason,202720,300,Jon Leuer,1610612763,MEM,63,824,121,273,0.443,7,29,0.241,37,59,0.627,50,157,207,46,17,9,35,86,286,356,1.31,0.49,2014,15,4.5396825396825395,1.3142857142857143,152,22,174,1.1896551724137931
2014-15,RegularSeason,200757,301,Thabo Sefolosha,1610612737,ATL,52,976,104,249,0.418,25,78,0.321,45,58,0.776,53,170,223,75,53,21,38,67,278,454,1.97,1.4,2014,15,5.346153846153846,1.9736842105263157,145,13,158,1.4113924050632911
2014-15,RegularSeason,2400,302,Drew Gooden,1610612764,WAS,51,864,110,276,0.399,23,59,0.39,34,44,0.773,72,151,223,49,21,9,28,91,277,375,1.75,0.75,2014,15,5.431372549019608,1.75,166,10,176,1.2670454545454546
2014-15,RegularSeason,1890,303,Shawn Marion,1610612739,CLE,57,1101,119,267,0.446,12,46,0.261,26,34,0.765,64,138,202,51,27,27,33,58,276,394,1.54,0.82,2014,15,4.842105263157895,1.5454545454545454,148,8,156,1.294871794871795
2014-15,RegularSeason,203143,304,Pablo Prigioni,1610612745,HOU,67,1197,91,228,0.399,57,166,0.343,35,41,0.854,30,89,119,171,79,1,62,88,274,439,2.76,1.27,2014,15,4.08955223880597,2.7580645161290325,137,6,143,0.8321678321678322
2014-15,RegularSeason,2555,305,Nick Collison,1610612760,OKC,66,1101,106,253,0.419,16,60,0.267,45,65,0.692,90,160,250,90,35,25,45,156,273,461,2.0,0.78,2014,15,4.136363636363637,2.0,147,20,167,1.4970059880239521
2014-15,RegularSeason,201946,306,Tyler Hansbrough,1610612761,TOR,74,1058,86,165,0.521,1,7,0.143,97,139,0.698,106,159,265,21,30,15,20,141,270,460,1.05,1.5,2014,15,3.6486486486486487,1.05,79,42,121,2.190082644628099
2014-15,RegularSeason,101133,307,Ian Mahinmi,1610612754,IND,61,1146,117,212,0.552,0,0,0.0,31,102,0.304,105,251,356,33,30,46,59,172,265,505,0.56,0.51,2014,15,4.344262295081967,0.559322033898305,95,71,166,2.144578313253012
2014-15,RegularSeason,2588,308,Matt Bonner,1610612759,SAS,72,935,94,230,0.409,46,126,0.365,30,37,0.811,29,86,115,47,10,12,11,65,264,294,4.27,0.91,2014,15,3.6666666666666665,4.2727272727272725,136,7,143,0.8041958041958042
2014-15,RegularSeason,203894,309,Shabazz Napier,1610612748,MIA,51,1012,87,228,0.382,43,118,0.364,44,56,0.786,17,96,113,130,40,4,81,76,261,314,1.6,0.49,2014,15,5.117647058823529,1.6049382716049383,141,12,153,0.738562091503268
2014-15,RegularSeason,2617,309,Udonis Haslem,1610612748,MIA,62,995,107,239,0.448,2,10,0.2,45,64,0.703,71,187,258,46,21,13,41,113,261,407,1.12,0.51,2014,15,4.209677419354839,1.1219512195121952,132,19,151,1.7086092715231789
2014-15,RegularSeason,200811,311,Lou Amundson,1610612752,NYK,53,937,109,255,0.427,0,1,0.0,41,87,0.471,94,174,268,70,22,52,62,126,259,417,1.13,0.35,2014,15,4.886792452830188,1.1290322580645162,146,46,192,1.3958333333333333
2014-15,RegularSeason,202337,312,Luke Babbitt,1610612740,NOP,63,830,92,192,0.479,59,115,0.513,13,19,0.684,12,99,111,24,17,11,26,63,256,287,0.92,0.65,2014,15,4.063492063492063,0.9230769230769231,100,6,106,1.0471698113207548
2014-15,RegularSeason,2760,313,Anderson Varejao,1610612739,CLE,26,636,111,200,0.555,0,2,0.0,33,45,0.733,57,113,170,35,19,16,35,58,255,359,1.0,0.54,2014,15,9.807692307692308,1.0,89,12,101,1.683168316831683
2014-15,RegularSeason,203200,314,Justin Holiday,1610612744,GSW,59,657,91,235,0.387,35,109,0.321,37,45,0.822,12,61,73,48,40,12,29,54,254,246,1.66,1.38,2014,15,4.305084745762712,1.6551724137931034,144,8,152,0.48026315789473684
2014-15,RegularSeason,203798,314,PJ Hairston,1610612766,CHA,45,687,87,269,0.323,49,163,0.301,31,36,0.861,22,70,92,21,21,13,22,61,254,192,0.95,0.95,2014,15,5.644444444444445,0.9545454545454546,182,5,187,0.4919786096256685
2014-15,RegularSeason,2592,316,James Jones,1610612739,CLE,57,669,74,201,0.368,63,175,0.36,39,46,0.848,9,53,62,24,13,8,13,67,250,210,1.85,1.0,2014,15,4.385964912280702,1.8461538461538463,127,7,134,0.4626865671641791
2014-15,RegularSeason,202407,317,Elijah Millsap,1610612762,UTA,47,924,81,238,0.34,28,90,0.311,58,86,0.674,28,122,150,58,56,16,67,124,248,276,0.87,0.84,2014,15,5.276595744680851,0.8656716417910447,157,28,185,0.8108108108108109
2014-15,RegularSeason,2570,318,Kendrick Perkins,1610612739,CLE,68,1148,102,227,0.449,0,1,0.0,42,83,0.506,91,229,320,51,16,42,95,162,246,414,0.54,0.17,2014,15,3.6176470588235294,0.5368421052631579,125,41,166,1.927710843373494
2014-15,RegularSeason,203933,319,T.J. Warren,1610612756,PHX,40,614,113,214,0.528,5,21,0.238,14,19,0.737,41,44,85,25,18,9,27,51,245,249,0.93,0.67,2014,15,6.125,0.9259259259259259,101,5,106,0.8018867924528302
2014-15,RegularSeason,203932,320,Aaron Gordon,1610612753,ORL,47,797,93,208,0.447,13,48,0.271,44,61,0.721,46,123,169,33,21,22,38,83,243,318,0.87,0.55,2014,15,5.170212765957447,0.868421052631579,115,17,132,1.2803030303030303
2014-15,RegularSeason,201979,320,Nick Calathes,1610612763,MEM,58,838,104,247,0.421,11,43,0.256,24,45,0.533,19,87,106,146,63,5,61,100,243,338,2.39,1.03,2014,15,4.189655172413793,2.3934426229508197,143,21,164,0.6463414634146342
2014-15,RegularSeason,202087,322,Alonzo Gee,1610612757,POR,54,661,87,186,0.468,13,35,0.371,54,77,0.701,37,57,94,25,35,7,33,58,241,247,0.76,1.06,2014,15,4.462962962962963,0.7575757575757576,99,23,122,0.7704918032786885
2014-15,RegularSeason,101126,323,Nate Robinson,1610612743,DEN,42,591,88,255,0.345,31,112,0.277,31,46,0.674,17,33,50,97,20,3,30,76,238,196,3.23,0.67,2014,15,5.666666666666667,3.2333333333333334,167,15,182,0.27472527472527475
2014-15,RegularSeason,2045,324,Hedo Turkoglu,1610612746,LAC,62,705,83,188,0.441,60,139,0.432,6,11,0.545,5,94,99,37,19,7,29,66,232,255,1.28,0.66,2014,15,3.7419354838709675,1.2758620689655173,105,5,110,0.9
2014-15,RegularSeason,203462,325,Archie Goodwin,1610612756,PHX,41,535,79,201,0.393,12,41,0.293,61,83,0.735,27,47,74,44,18,9,48,55,231,184,0.92,0.38,2014,15,5.634146341463414,0.9166666666666666,122,22,144,0.5138888888888888
2014-15,RegularSeason,203460,326,Andre Roberson,1610612760,OKC,67,1286,92,201,0.458,21,85,0.247,23,48,0.479,60,195,255,70,53,29,46,141,228,455,1.52,1.15,2014,15,3.4029850746268657,1.5217391304347827,109,25,134,1.9029850746268657
2014-15,RegularSeason,203913,327,Jabari Brown,1610612747,LAL,19,568,70,170,0.412,23,62,0.371,64,85,0.753,3,33,36,40,12,2,32,33,227,164,1.25,0.38,2014,15,11.947368421052632,1.25,100,21,121,0.2975206611570248
2014-15,RegularSeason,201937,328,Ricky Rubio,1610612750,MIN,22,692,78,219,0.356,13,51,0.255,57,71,0.803,19,106,125,193,38,1,64,59,226,364,3.02,0.59,2014,15,10.272727272727273,3.015625,141,14,155,0.8064516129032258
2014-15,RegularSeason,101179,329,Ronnie Price,1610612747,LAL,43,982,77,223,0.345,31,109,0.284,36,45,0.8,19,50,69,165,67,4,52,118,221,319,3.17,1.29,2014,15,5.1395348837209305,3.173076923076923,146,9,155,0.44516129032258067
2014-15,RegularSeason,2748,330,Dorell Wright,1610612757,POR,48,593,72,190,0.379,41,108,0.38,34,42,0.81,14,97,111,41,20,11,18,55,219,258,2.28,1.11,2014,15,4.5625,2.2777777777777777,118,8,126,0.8809523809523809
2014-15,RegularSeason,203120,330,Justin Hamilton,1610612750,MIN,41,713,85,178,0.478,10,31,0.323,39,47,0.83,57,77,134,36,27,30,26,70,219,319,1.39,1.04,2014,15,5.341463414634147,1.3846153846153846,93,8,101,1.3267326732673268
2014-15,RegularSeason,203473,332,Dewayne Dedmon,1610612753,ORL,59,845,91,162,0.562,0,1,0.0,34,64,0.531,118,177,295,9,16,50,51,141,216,434,0.18,0.31,2014,15,3.6610169491525424,0.17647058823529413,71,30,101,2.9207920792079207
2014-15,RegularSeason,203900,332,Markel Brown,1610612751,BKN,47,781,76,210,0.362,17,64,0.266,47,57,0.825,16,91,107,39,31,12,27,57,216,234,1.44,1.15,2014,15,4.595744680851064,1.4444444444444444,134,10,144,0.7430555555555556
2014-15,RegularSeason,203940,334,Adreian Payne,1610612750,MIN,32,740,91,220,0.414,1,9,0.111,30,46,0.652,48,114,162,30,19,9,44,88,213,244,0.68,0.43,2014,15,6.65625,0.6818181818181818,129,16,145,1.1172413793103448
2014-15,RegularSeason,201563,335,Michael Beasley,1610612748,MIA,24,505,92,212,0.434,8,34,0.235,20,26,0.769,12,77,89,32,15,13,37,66,212,198,0.86,0.41,2014,15,8.833333333333334,0.8648648648648649,120,6,126,0.7063492063492064
2014-15,RegularSeason,203921,336,Cleanthony Early,1610612752,NYK,39,647,76,214,0.355,22,84,0.262,36,48,0.75,22,75,97,36,24,12,40,57,210,189,0.9,0.6,2014,15,5.384615384615385,0.9,138,12,150,0.6466666666666666
2014-15,RegularSeason,202066,337,Garrett Temple,1610612764,WAS,52,736,68,170,0.4,33,88,0.375,35,48,0.729,24,66,90,56,42,9,34,76,204,252,1.65,1.24,2014,15,3.923076923076923,1.6470588235294117,102,13,115,0.782608695652174
2014-15,RegularSeason,101131,338,Jason Maxiell,1610612766,CHA,61,878,81,192,0.422,0,0,0.0,41,71,0.577,86,117,203,19,18,44,29,96,203,317,0.66,0.62,2014,15,3.3278688524590163,0.6551724137931034,111,30,141,1.4397163120567376
2014-15,RegularSeason,203105,339,Festus Ezeli,1610612744,GSW,46,504,76,139,0.547,0,0,0.0,49,78,0.628,60,95,155,9,7,42,32,77,201,290,0.28,0.22,2014,15,4.369565217391305,0.28125,63,29,92,1.684782608695652
2014-15,RegularSeason,203956,339,Mitch McGary,1610612760,OKC,32,485,88,165,0.533,0,2,0.0,25,40,0.625,53,112,165,14,16,16,31,72,201,289,0.45,0.52,2014,15,6.28125,0.45161290322580644,77,15,92,1.7934782608695652
2014-15,RegularSeason,204037,341,Travis Wear,1610612752,NYK,51,672,84,209,0.402,11,30,0.367,20,26,0.769,31,75,106,40,15,11,35,55,199,205,1.14,0.43,2014,15,3.9019607843137254,1.1428571428571428,125,6,131,0.8091603053435115
2014-15,RegularSeason,203133,342,Robbie Hummel,1610612750,MIN,45,742,79,172,0.459,16,51,0.314,24,29,0.828,31,103,134,27,16,9,18,86,198,268,1.5,0.89,2014,15,4.4,1.5,93,5,98,1.3673469387755102
2014-15,RegularSeason,203488,343,Mike Muscala,1610612737,ATL,40,502,83,151,0.55,9,22,0.409,22,25,0.88,52,67,119,25,16,19,21,52,197,284,1.19,0.76,2014,15,4.925,1.1904761904761905,68,3,71,1.676056338028169
2014-15,RegularSeason,202336,344,Larry Sanders,1610612749,MIL,27,586,86,172,0.5,0,0,0.0,24,48,0.5,67,99,166,23,26,39,28,104,196,312,0.82,0.93,2014,15,7.2592592592592595,0.8214285714285714,86,24,110,1.509090909090909
2014-15,RegularSeason,203094,345,Andrew Nicholson,1610612753,ORL,40,492,83,190,0.437,13,41,0.317,15,25,0.6,17,65,82,22,6,12,24,51,194,175,0.92,0.25,2014,15,4.85,0.9166666666666666,107,10,117,0.7008547008547008
2014-15,RegularSeason,204020,346,Tyler Johnson,1610612748,MIA,32,603,70,167,0.419,18,48,0.375,32,47,0.681,14,67,81,42,33,9,30,42,190,213,1.4,1.1,2014,15,5.9375,1.4,97,15,112,0.7232142857142857
2014-15,RegularSeason,101122,347,Danny Granger,1610612756,PHX,30,613,65,162,0.401,30,84,0.357,28,37,0.757,20,60,80,17,13,6,24,67,188,174,0.71,0.54,2014,15,6.266666666666667,0.7083333333333334,97,9,106,0.7547169811320755
2014-15,RegularSeason,203914,347,Gary Harris,1610612743,DEN,55,719,66,217,0.304,21,103,0.204,35,47,0.745,21,43,64,29,39,7,38,71,188,126,0.76,1.03,2014,15,3.418181818181818,0.7631578947368421,151,12,163,0.39263803680981596
2014-15,RegularSeason,2557,347,Luke Ridnour,1610612753,ORL,47,683,75,176,0.426,20,63,0.317,18,21,0.857,8,60,68,96,20,4,38,67,188,234,2.53,0.53,2014,15,4.0,2.526315789473684,101,3,104,0.6538461538461539
2014-15,RegularSeason,201595,350,Joey Dorsey,1610612745,HOU,69,854,80,145,0.552,0,1,0.0,24,83,0.289,103,176,279,25,40,25,41,157,184,388,0.61,0.98,2014,15,2.6666666666666665,0.6097560975609756,65,59,124,2.25
2014-15,RegularSeason,203103,350,Perry Jones III,1610612760,OKC,43,631,73,184,0.397,14,60,0.233,24,37,0.649,6,70,76,18,17,8,24,50,184,155,0.75,0.71,2014,15,4.27906976744186,0.75,111,13,124,0.6129032258064516
2014-15,RegularSeason,203928,352,Cory Jefferson,1610612751,BKN,50,531,75,167,0.449,2,15,0.133,31,54,0.574,47,98,145,16,10,21,20,61,183,240,0.8,0.5,2014,15,3.66,0.8,92,23,115,1.2608695652173914
2014-15,RegularSeason,203123,353,Kostas Papanikolaou,1610612745,HOU,43,795,69,197,0.35,31,106,0.292,13,18,0.722,39,79,118,85,29,13,55,71,182,239,1.54,0.53,2014,15,4.232558139534884,1.5454545454545454,128,5,133,0.8872180451127819
2014-15,RegularSeason,202690,354,Jimmer Fredette,1610612740,NOP,50,509,63,166,0.38,9,48,0.188,43,45,0.956,8,32,40,58,15,2,33,43,178,155,1.76,0.46,2014,15,3.56,1.7575757575757576,103,2,105,0.38095238095238093
2014-15,RegularSeason,203515,355,Phil Pressey,1610612738,BOS,50,600,64,174,0.368,16,65,0.246,33,49,0.673,13,67,80,117,30,6,41,54,177,243,2.85,0.73,2014,15,3.54,2.8536585365853657,110,16,126,0.6349206349206349
2014-15,RegularSeason,2501,356,Reggie Evans,1610612758,SAC,47,764,58,137,0.423,0,2,0.0,60,97,0.619,97,202,299,32,22,5,45,91,176,373,0.71,0.49,2014,15,3.74468085106383,0.7111111111111111,79,37,116,2.5775862068965516
2014-15,RegularSeason,203584,356,Troy Daniels,1610612766,CHA,47,397,61,165,0.37,43,118,0.364,11,13,0.846,8,25,33,22,6,1,20,40,176,112,1.1,0.3,2014,15,3.74468085106383,1.1,104,2,106,0.3113207547169811
2014-15,RegularSeason,201611,358,Henry Walker,1610612748,MIA,24,628,58,168,0.345,45,132,0.341,14,18,0.778,7,75,82,29,24,9,24,76,175,181,1.21,1.0,2014,15,7.291666666666667,1.2083333333333333,110,4,114,0.7192982456140351
2014-15,RegularSeason,2202,359,Jason Richardson,1610612755,PHI,19,416,62,178,0.348,31,96,0.323,17,22,0.773,13,53,66,38,13,3,16,28,172,155,2.38,0.81,2014,15,9.052631578947368,2.375,116,5,121,0.5454545454545454
2014-15,RegularSeason,200777,360,Joel Freeland,1610612757,POR,48,617,74,151,0.49,0,0,0.0,21,25,0.84,62,129,191,16,9,23,23,93,169,304,0.7,0.39,2014,15,3.5208333333333335,0.6956521739130435,77,4,81,2.3580246913580245
2014-15,RegularSeason,203459,361,Allen Crabbe,1610612757,POR,51,683,63,153,0.412,30,85,0.353,12,16,0.75,7,66,73,39,19,15,15,74,168,205,2.6,1.27,2014,15,3.2941176470588234,2.6,90,4,94,0.776595744680851
2014-15,RegularSeason,200770,362,Jordan Farmar,1610612746,LAC,36,529,61,158,0.386,35,97,0.361,10,11,0.909,8,34,42,67,20,5,32,52,167,171,2.09,0.63,2014,15,4.638888888888889,2.09375,97,1,98,0.42857142857142855
2014-15,RegularSeason,203187,363,Chris Johnson,1610612762,UTA,29,527,62,154,0.403,28,95,0.295,14,16,0.875,8,47,55,15,26,7,15,44,166,160,1.0,1.73,2014,15,5.724137931034483,1.0,92,2,94,0.5851063829787234
2014-15,RegularSeason,203090,364,Maurice Harkless,1610612753,ORL,45,674,63,158,0.399,10,56,0.179,22,41,0.537,38,68,106,25,32,9,27,66,158,189,0.93,1.19,2014,15,3.511111111111111,0.9259259259259259,95,19,114,0.9298245614035088
2014-15,RegularSeason,203508,365,Sergey Karasev,1610612751,BKN,33,555,54,134,0.403,16,54,0.296,29,38,0.763,22,44,66,46,23,1,24,45,153,176,1.92,0.96,2014,15,4.636363636363637,1.9166666666666667,80,9,89,0.7415730337078652
2014-15,RegularSeason,202734,366,E'Twaun Moore,1610612741,CHI,56,504,62,139,0.446,13,38,0.342,12,20,0.6,12,34,46,33,20,6,14,45,149,155,2.36,1.43,2014,15,2.6607142857142856,2.357142857142857,77,8,85,0.5411764705882353
2014-15,RegularSeason,203475,367,Erick Green,1610612743,DEN,43,410,61,162,0.377,14,47,0.298,10,12,0.833,7,24,31,39,12,0,14,26,146,111,2.79,0.86,2014,15,3.395348837209302,2.7857142857142856,101,2,103,0.30097087378640774
2014-15,RegularSeason,203915,368,Spencer Dinwiddie,1610612765,DET,34,455,51,169,0.302,12,65,0.185,31,34,0.912,4,44,48,104,19,6,33,53,145,168,3.15,0.58,2014,15,4.264705882352941,3.1515151515151514,118,3,121,0.39669421487603307
2014-15,RegularSeason,203561,369,Brandon Davies,1610612755,PHI,27,423,55,137,0.401,8,34,0.235,24,37,0.649,38,45,83,30,18,7,29,59,142,156,1.03,0.62,2014,15,5.2592592592592595,1.0344827586206897,82,13,95,0.8736842105263158
2014-15,RegularSeason,202366,370,Jerome Jordan,1610612751,BKN,44,383,50,94,0.532,0,0,0.0,38,44,0.864,52,53,105,13,8,15,22,58,138,207,0.59,0.36,2014,15,3.1363636363636362,0.5909090909090909,44,6,50,2.1
2014-15,RegularSeason,201965,371,Jeff Ayres,1610612759,SAS,51,383,55,95,0.579,0,0,0.0,27,36,0.75,37,80,117,14,8,8,26,60,137,209,0.54,0.31,2014,15,2.6862745098039214,0.5384615384615384,40,9,49,2.3877551020408165
2014-15,RegularSeason,200797,371,Ryan Hollins,1610612758,SAC,46,441,53,82,0.646,0,0,0.0,31,54,0.574,36,67,103,14,6,19,25,65,137,202,0.56,0.24,2014,15,2.9782608695652173,0.56,29,23,52,1.9807692307692308
2014-15,RegularSeason,203925,373,Joe Harris,1610612739,CLE,51,493,48,120,0.4,31,84,0.369,9,15,0.6,7,34,41,26,7,2,27,62,136,107,0.96,0.26,2014,15,2.6666666666666665,0.9629629629629629,72,6,78,0.5256410256410257
2014-15,RegularSeason,203098,374,John Jenkins,1610612737,ATL,24,297,49,99,0.495,21,52,0.404,16,19,0.842,2,37,39,13,10,0,8,15,135,136,1.63,1.25,2014,15,5.625,1.625,50,3,53,0.7358490566037735
2014-15,RegularSeason,2742,375,Sebastian Telfair,1610612760,OKC,16,327,46,125,0.368,18,60,0.3,24,34,0.706,2,28,30,45,10,0,18,29,134,112,2.5,0.56,2014,15,8.375,2.5,79,10,89,0.33707865168539325
2014-15,RegularSeason,201985,376,AJ Price,1610612739,CLE,26,324,51,137,0.372,15,57,0.263,16,24,0.667,6,26,32,46,7,0,14,15,133,110,3.29,0.5,2014,15,5.115384615384615,3.2857142857142856,86,8,94,0.3404255319148936
2014-15,RegularSeason,201948,377,Austin Daye,1610612737,ATL,34,344,50,141,0.355,24,71,0.338,5,6,0.833,10,65,75,17,12,5,23,39,129,123,0.74,0.52,2014,15,3.7941176470588234,0.7391304347826086,91,1,92,0.8152173913043478
2014-15,RegularSeason,2223,378,Samuel Dalembert,1610612752,NYK,32,544,57,130,0.438,0,0,0.0,14,20,0.7,53,115,168,29,14,41,39,70,128,262,0.74,0.36,2014,15,4.0,0.7435897435897436,73,6,79,2.1265822784810124
2014-15,RegularSeason,203106,379,Jeffery Taylor,1610612766,CHA,29,430,45,114,0.395,11,36,0.306,26,41,0.634,14,39,53,22,12,1,19,36,127,112,1.16,0.63,2014,15,4.379310344827586,1.1578947368421053,69,15,84,0.6309523809523809
2014-15,RegularSeason,203485,380,Lorenzo Brown,1610612750,MIN,29,549,52,122,0.426,6,28,0.214,12,19,0.632,14,56,70,90,28,6,30,49,122,209,3.0,0.93,2014,15,4.206896551724138,3.0,70,7,77,0.9090909090909091
2014-15,RegularSeason,203898,381,Tyler Ennis,1610612749,MIL,33,411,52,144,0.361,12,43,0.279,5,7,0.714,7,28,35,73,18,5,42,36,121,116,1.74,0.43,2014,15,3.6666666666666665,1.7380952380952381,92,2,94,0.3723404255319149
2014-15,RegularSeason,203088,382,Kendall Marshall,1610612749,MIL,28,417,46,101,0.455,18,46,0.391,8,9,0.889,2,26,28,86,21,0,35,26,118,162,2.46,0.6,2014,15,4.214285714285714,2.4571428571428573,55,1,56,0.5
2014-15,RegularSeason,203926,383,Doug McDermott,1610612741,CHI,36,321,43,107,0.402,13,41,0.317,10,15,0.667,6,37,43,6,4,1,17,29,109,77,0.35,0.23,2014,15,3.0277777777777777,0.35294117647058826,64,5,69,0.6231884057971014
2014-15,RegularSeason,2034,383,Mike Miller,1610612739,CLE,52,701,37,114,0.325,32,98,0.327,3,4,0.75,4,87,91,46,14,4,23,74,109,163,2.0,0.61,2014,15,2.0961538461538463,2.0,77,1,78,1.1666666666666667
2014-15,RegularSeason,101109,385,Raymond Felton,1610612742,DAL,29,281,43,106,0.406,10,34,0.294,12,15,0.8,2,24,26,41,11,4,18,17,108,106,2.28,0.61,2014,15,3.7241379310344827,2.2777777777777777,63,3,66,0.3939393939393939
2014-15,RegularSeason,201580,386,JaVale McGee,1610612743,DEN,23,256,42,79,0.532,0,0,0.0,22,33,0.667,18,43,61,3,2,20,18,30,106,126,0.17,0.11,2014,15,4.608695652173913,0.16666666666666666,37,11,48,1.2708333333333333
2014-15,RegularSeason,101110,386,Martell Webster,1610612764,WAS,32,352,24,91,0.264,10,43,0.233,48,64,0.75,10,36,46,17,7,1,22,24,106,72,0.77,0.32,2014,15,3.3125,0.7727272727272727,67,16,83,0.5542168674698795
2014-15,RegularSeason,203540,388,Gigi Datome,1610612738,BOS,21,209,43,89,0.483,18,40,0.45,1,1,1.0,3,26,29,9,2,7,9,15,105,97,1.0,0.22,2014,15,5.0,1.0,46,0,46,0.6304347826086957
2014-15,RegularSeason,203923,388,James Young,1610612738,BOS,31,332,36,102,0.353,17,66,0.258,16,29,0.552,9,33,42,13,8,2,5,22,105,86,2.6,1.6,2014,15,3.3870967741935485,2.6,66,13,79,0.5316455696202531
2014-15,RegularSeason,203948,390,Johnny O'Bryant III,1610612749,MIL,34,368,44,120,0.367,0,0,0.0,12,27,0.444,26,38,64,17,5,4,25,44,100,74,0.68,0.2,2014,15,2.9411764705882355,0.68,76,15,91,0.7032967032967034
2014-15,RegularSeason,203481,391,Jeff Withey,1610612740,NOP,37,259,32,64,0.5,0,0,0.0,34,50,0.68,23,41,64,11,4,18,12,26,98,135,0.92,0.33,2014,15,2.6486486486486487,0.9166666666666666,32,16,48,1.3333333333333333
2014-15,RegularSeason,101249,391,John Lucas III,1610612765,DET,21,272,42,104,0.404,9,29,0.31,5,5,1.0,4,12,16,60,8,0,16,18,98,104,3.75,0.5,2014,15,4.666666666666667,3.75,62,0,62,0.25806451612903225
2014-15,RegularSeason,1882,393,Elton Brand,1610612737,ATL,36,486,42,95,0.442,0,1,0.0,12,23,0.522,28,72,100,22,17,25,18,54,96,178,1.22,0.94,2014,15,2.6666666666666665,1.2222222222222223,53,11,64,1.5625
2014-15,RegularSeason,203919,394,Jordan Adams,1610612763,MEM,30,248,35,86,0.407,10,25,0.4,14,23,0.609,9,19,28,16,16,7,14,24,94,87,1.14,1.14,2014,15,3.1333333333333333,1.1428571428571428,51,9,60,0.4666666666666667
2014-15,RegularSeason,203128,395,Furkan Aldemir,1610612755,PHI,41,540,40,78,0.513,0,5,0.0,13,27,0.481,78,98,176,28,17,16,17,96,93,261,1.65,1.0,2014,15,2.268292682926829,1.6470588235294117,38,14,52,3.3846153846153846
2014-15,RegularSeason,203530,395,Joffrey Lauvergne,1610612743,DEN,24,268,36,89,0.404,3,16,0.188,18,28,0.643,27,50,77,13,8,10,22,43,93,116,0.59,0.36,2014,15,3.875,0.5909090909090909,53,10,63,1.2222222222222223
2014-15,RegularSeason,203939,397,Dwight Powell,1610612742,DAL,29,236,31,67,0.463,3,11,0.273,25,33,0.758,18,32,50,9,9,6,11,40,90,109,0.82,0.82,2014,15,3.103448275862069,0.8181818181818182,36,8,44,1.1363636363636365
2014-15,RegularSeason,202379,397,Jeremy Evans,1610612762,UTA,38,266,32,58,0.552,2,5,0.4,24,29,0.828,26,45,71,13,11,12,5,29,90,161,2.6,2.2,2014,15,2.3684210526315788,2.6,26,5,31,2.2903225806451615
2014-15,RegularSeason,203495,397,Ricky Ledo,1610612752,NYK,17,244,32,96,0.333,10,27,0.37,16,22,0.727,16,20,36,19,6,1,26,21,90,56,0.73,0.23,2014,15,5.294117647058823,0.7307692307692307,64,6,70,0.5142857142857142
2014-15,RegularSeason,201202,400,Joel Anthony,1610612765,DET,49,406,36,62,0.581,0,0,0.0,15,22,0.682,32,61,93,5,12,49,12,55,87,201,0.42,1.0,2014,15,1.7755102040816326,0.4166666666666667,26,7,33,2.8181818181818183
2014-15,RegularSeason,202721,401,Darius Morris,1610612751,BKN,38,299,36,106,0.34,7,33,0.212,4,9,0.444,7,20,27,48,9,0,21,20,83,71,2.29,0.43,2014,15,2.1842105263157894,2.2857142857142856,70,5,75,0.36
2014-15,RegularSeason,203943,401,Noah Vonleh,1610612766,CHA,25,259,30,76,0.395,5,13,0.385,18,26,0.692,28,58,86,4,4,9,11,20,83,121,0.36,0.36,2014,15,3.32,0.36363636363636365,46,8,54,1.5925925925925926
2014-15,RegularSeason,203955,403,Bryce Cotton,1610612762,UTA,15,159,29,69,0.42,7,20,0.35,15,18,0.833,3,15,18,15,4,0,12,6,80,62,1.25,0.33,2014,15,5.333333333333333,1.25,40,3,43,0.4186046511627907
2014-15,RegularSeason,202962,403,Greg Smith,1610612742,DAL,42,363,30,49,0.612,0,0,0.0,20,39,0.513,26,53,79,9,7,11,11,53,80,137,0.82,0.64,2014,15,1.9047619047619047,0.8181818181818182,19,19,38,2.0789473684210527
2014-15,RegularSeason,203937,405,Kyle Anderson,1610612759,SAS,33,358,31,89,0.348,3,11,0.273,9,14,0.643,5,67,72,28,15,7,10,28,74,123,2.8,1.5,2014,15,2.242424242424242,2.8,58,5,63,1.1428571428571428
2014-15,RegularSeason,203910,405,Nick Johnson,1610612745,HOU,28,262,26,75,0.347,5,21,0.238,17,25,0.68,13,26,39,11,7,3,19,34,74,58,0.58,0.37,2014,15,2.642857142857143,0.5789473684210527,49,8,57,0.6842105263157895
2014-15,RegularSeason,203922,407,Glenn Robinson III,1610612755,PHI,35,261,26,67,0.388,5,19,0.263,16,24,0.667,15,24,39,11,6,1,11,15,73,70,1.0,0.55,2014,15,2.085714285714286,1.0,41,8,49,0.7959183673469388
2014-15,RegularSeason,201177,408,Josh McRoberts,1610612748,MIA,17,296,28,53,0.528,8,19,0.421,8,13,0.615,7,38,45,33,12,3,22,41,72,113,1.5,0.55,2014,15,4.235294117647059,1.5,25,5,30,1.5
2014-15,RegularSeason,203493,409,Reggie Bullock Jr.,1610612756,PHX,36,338,24,70,0.343,15,46,0.326,6,9,0.667,1,49,50,8,10,4,8,19,69,84,1.0,1.25,2014,15,1.9166666666666667,1.0,46,3,49,1.0204081632653061
2014-15,RegularSeason,200779,410,Steve Novak,1610612760,OKC,35,197,22,56,0.393,19,48,0.396,0,2,0.0,2,20,22,11,0,2,5,23,63,57,2.2,0.0,2014,15,1.8,2.2,34,2,36,0.6111111111111112
2014-15,RegularSeason,203210,411,JaMychal Green,1610612763,MEM,24,164,27,47,0.574,0,6,0.0,8,10,0.8,19,26,45,4,5,5,14,25,62,85,0.29,0.36,2014,15,2.5833333333333335,0.2857142857142857,20,2,22,2.0454545454545454
2014-15,RegularSeason,203949,411,James Michael McAdoo,1610612744,GSW,15,137,24,44,0.545,0,0,0.0,14,25,0.56,15,22,37,2,5,9,6,21,62,78,0.33,0.83,2014,15,4.133333333333334,0.3333333333333333,20,11,31,1.1935483870967742
2014-15,RegularSeason,202399,413,Jeff Adrien,1610612745,HOU,17,215,19,44,0.432,0,0,0.0,22,38,0.579,23,54,77,15,4,9,9,30,60,115,1.67,0.44,2014,15,3.5294117647058822,1.6666666666666667,25,16,41,1.8780487804878048
2014-15,RegularSeason,203546,414,Ian Clark,1610612743,DEN,30,192,19,55,0.345,10,30,0.333,9,9,1.0,4,12,16,12,9,3,9,20,57,52,1.33,1.0,2014,15,1.9,1.3333333333333333,36,0,36,0.4444444444444444
2014-15,RegularSeason,203950,414,Jarnell Stokes,1610612763,MEM,19,126,21,37,0.568,0,0,0.0,15,28,0.536,16,18,34,4,5,5,7,25,57,69,0.57,0.71,2014,15,3.0,0.5714285714285714,16,13,29,1.1724137931034482
2014-15,RegularSeason,203963,414,Shayne Whittington,1610612754,IND,20,108,19,42,0.452,1,6,0.167,18,23,0.783,10,19,29,6,5,2,5,18,57,66,1.2,1.0,2014,15,2.85,1.2,23,5,28,1.0357142857142858
2014-15,RegularSeason,204025,414,Tim Frazier,1610612757,POR,11,240,21,61,0.344,5,17,0.294,10,21,0.476,6,22,28,60,8,0,25,26,57,77,2.4,0.32,2014,15,5.181818181818182,2.4,40,11,51,0.5490196078431373
2014-15,RegularSeason,201971,418,DeJuan Blair,1610612764,WAS,29,180,26,57,0.456,0,0,0.0,4,6,0.667,16,40,56,3,7,1,13,41,56,77,0.23,0.54,2014,15,1.9310344827586208,0.23076923076923078,31,2,33,1.696969696969697
2014-15,RegularSeason,203268,419,Jorge Gutierrez,1610612749,MIL,20,174,22,41,0.537,0,3,0.0,9,13,0.692,5,20,25,22,6,0,12,25,53,71,1.83,0.5,2014,15,2.65,1.8333333333333333,19,4,23,1.0869565217391304
2014-15,RegularSeason,202331,419,Paul George,1610612754,IND,6,91,18,49,0.367,9,22,0.409,8,11,0.727,4,18,22,6,5,1,12,11,53,41,0.5,0.42,2014,15,8.833333333333334,0.5,31,3,34,0.6470588235294118
2014-15,RegularSeason,202779,421,Dwight Buycks,1610612747,LAL,6,123,18,40,0.45,7,11,0.636,9,10,0.9,2,10,12,14,3,0,12,3,52,46,1.17,0.25,2014,15,8.666666666666666,1.1666666666666667,22,1,23,0.5217391304347826
2014-15,RegularSeason,201962,422,Toney Douglas,1610612740,NOP,12,177,19,51,0.373,5,18,0.278,8,13,0.615,2,20,22,24,11,4,10,20,51,65,2.4,1.1,2014,15,4.25,2.4,32,5,37,0.5945945945945946
2014-15,RegularSeason,101236,423,Chuck Hayes,1610612761,TOR,29,255,22,46,0.478,0,0,0.0,6,11,0.545,18,33,51,20,10,4,8,37,50,98,2.5,1.25,2014,15,1.7241379310344827,2.5,24,5,29,1.7586206896551724
2014-15,RegularSeason,202361,424,Landry Fields,1610612761,TOR,26,216,20,41,0.488,1,2,0.5,5,6,0.833,10,16,26,15,11,0,8,9,46,68,1.88,1.38,2014,15,1.7692307692307692,1.875,21,1,22,1.1818181818181819
2014-15,RegularSeason,203580,424,Larry Drew II,1610612755,PHI,12,219,20,58,0.345,4,26,0.154,2,3,0.667,1,14,15,45,6,0,25,13,46,48,1.8,0.24,2014,15,3.8333333333333335,1.8,38,1,39,0.38461538461538464
2014-15,RegularSeason,101128,426,Francisco Garcia,1610612745,HOU,14,200,17,63,0.27,10,45,0.222,1,4,0.25,3,14,17,15,9,5,10,20,45,32,1.5,0.9,2014,15,3.2142857142857144,1.5,46,3,49,0.3469387755102041
2014-15,RegularSeason,202952,426,Malcolm Thomas,1610612755,PHI,17,194,18,40,0.45,0,7,0.0,9,13,0.692,16,40,56,7,3,1,13,17,45,73,0.54,0.23,2014,15,2.6470588235294117,0.5384615384615384,22,4,26,2.1538461538461537
2014-15,RegularSeason,203108,428,Bernard James,1610612742,DAL,16,158,12,27,0.444,0,0,0.0,20,23,0.87,18,21,39,4,2,15,6,17,44,80,0.67,0.33,2014,15,2.75,0.6666666666666666,15,3,18,2.1666666666666665
2014-15,RegularSeason,2422,429,John Salmons,1610612740,NOP,21,270,16,48,0.333,8,26,0.308,2,4,0.5,4,17,21,13,9,4,5,25,42,50,2.6,1.8,2014,15,2.0,2.6,32,2,34,0.6176470588235294
2014-15,RegularSeason,203489,429,Nate Wolters,1610612749,MIL,21,247,20,57,0.351,0,7,0.0,2,6,0.333,8,26,34,21,8,2,13,18,42,53,1.61,0.61,2014,15,2.0,1.6153846153846154,37,4,41,0.8292682926829268
2014-15,RegularSeason,203912,431,C.J. Wilcox,1610612746,LAC,21,101,16,38,0.421,7,19,0.368,2,2,1.0,1,6,7,8,3,1,10,7,41,28,0.8,0.3,2014,15,1.9523809523809523,0.8,22,0,22,0.3181818181818182
2014-15,RegularSeason,2457,431,Jannero Pargo,1610612766,CHA,9,73,15,35,0.429,9,22,0.409,2,2,1.0,0,3,3,8,0,0,3,8,41,29,2.67,0.0,2014,15,4.555555555555555,2.6666666666666665,20,0,20,0.15
2014-15,RegularSeason,202706,433,Jordan Hamilton,1610612746,LAC,14,122,14,35,0.4,10,21,0.476,0,0,0.0,2,14,16,7,2,0,4,14,38,38,1.75,0.5,2014,15,2.7142857142857144,1.75,21,0,21,0.7619047619047619
2014-15,RegularSeason,203906,434,Devyn Marble,1610612753,ORL,16,208,14,44,0.318,4,22,0.182,5,16,0.313,5,26,31,17,9,2,9,14,37,46,1.89,1.0,2014,15,2.3125,1.8888888888888888,30,11,41,0.7560975609756098
2014-15,RegularSeason,202343,434,Elliot Williams,1610612755,PHI,13,119,14,37,0.378,8,18,0.444,1,4,0.25,0,8,8,12,4,0,4,12,37,31,3.0,1.0,2014,15,2.8461538461538463,3.0,23,3,26,0.3076923076923077
2014-15,RegularSeason,202130,434,Reggie Williams,1610612759,SAS,20,105,15,39,0.385,3,19,0.158,4,4,1.0,5,12,17,10,1,0,2,12,37,39,5.0,0.5,2014,15,1.85,5.0,24,0,24,0.7083333333333334
2014-15,RegularSeason,201858,437,Cartier Martin,1610612765,DET,23,198,15,53,0.283,6,33,0.182,0,0,0.0,0,20,20,11,3,1,5,20,36,28,2.2,0.6,2014,15,1.565217391304348,2.2,38,0,38,0.5263157894736842
2014-15,RegularSeason,2217,438,Brendan Haywood,1610612739,CLE,22,119,14,30,0.467,0,0,0.0,7,13,0.538,6,23,29,2,2,10,10,17,35,46,0.2,0.2,2014,15,1.5909090909090908,0.2,16,6,22,1.3181818181818181
2014-15,RegularSeason,2222,438,Gerald Wallace,1610612738,BOS,32,286,14,34,0.412,1,3,0.333,6,15,0.4,17,40,57,11,15,4,18,19,35,75,0.61,0.83,2014,15,1.09375,0.6111111111111112,20,9,29,1.9655172413793103
2014-15,RegularSeason,203099,438,Jared Cunningham,1610612746,LAC,19,89,12,33,0.364,4,13,0.308,7,13,0.538,1,8,9,10,3,0,7,12,35,23,1.43,0.43,2014,15,1.8421052631578947,1.4285714285714286,21,6,27,0.3333333333333333
2014-15,RegularSeason,203991,441,Clint Capela,1610612745,HOU,12,90,14,29,0.483,0,0,0.0,4,23,0.174,10,26,36,2,1,9,5,14,32,41,0.4,0.2,2014,15,2.6666666666666665,0.4,15,19,34,1.0588235294117647
2014-15,RegularSeason,2853,441,Earl Barron,1610612756,PHX,16,143,12,39,0.308,2,4,0.5,6,12,0.5,14,14,28,5,4,2,5,26,32,33,1.0,0.8,2014,15,2.0,1.0,27,6,33,0.8484848484848485
2014-15,RegularSeason,201575,443,Brandon Rush,1610612744,GSW,33,271,11,54,0.204,3,27,0.111,5,11,0.455,4,37,41,12,5,12,11,27,30,40,1.09,0.46,2014,15,0.9090909090909091,1.0909090909090908,43,6,49,0.8367346938775511
2014-15,RegularSeason,203893,443,Russ Smith,1610612763,MEM,12,65,8,25,0.32,2,11,0.182,12,13,0.923,1,5,6,8,3,0,12,13,30,17,0.67,0.25,2014,15,2.5,0.6666666666666666,17,1,18,0.3333333333333333
2014-15,RegularSeason,202327,445,Ekpe Udoh,1610612746,LAC,33,128,11,24,0.458,0,0,0.0,7,9,0.778,7,19,26,8,8,7,7,20,29,56,1.14,1.14,2014,15,0.8787878787878788,1.1428571428571428,13,2,15,1.7333333333333334
2014-15,RegularSeason,203113,445,Quincy Miller,1610612765,DET,10,120,9,38,0.237,3,18,0.167,8,11,0.727,4,16,20,8,7,5,5,9,29,32,1.6,1.4,2014,15,2.9,1.6,29,3,32,0.625
2014-15,RegularSeason,204054,447,Zoran Dragic,1610612748,MIA,16,75,11,30,0.367,3,14,0.214,3,5,0.6,5,3,8,5,2,0,5,6,28,17,1.0,0.4,2014,15,1.75,1.0,19,2,21,0.38095238095238093
2014-15,RegularSeason,202620,448,Arinze Onuaku,1610612750,MIN,6,68,12,14,0.857,0,0,0.0,3,8,0.375,7,14,21,4,1,3,2,6,27,47,2.0,0.5,2014,15,4.5,2.0,2,5,7,3.0
2014-15,RegularSeason,201947,448,Earl Clark,1610612751,BKN,10,93,11,30,0.367,4,14,0.286,1,4,0.25,1,22,23,3,3,4,6,12,27,32,0.5,0.5,2014,15,2.7,0.5,19,3,22,1.0454545454545454
2014-15,RegularSeason,204022,448,Jack Cooley,1610612762,UTA,16,87,9,22,0.409,0,0,0.0,9,21,0.429,10,15,25,1,6,3,3,23,27,34,0.33,2.0,2014,15,1.6875,0.3333333333333333,13,12,25,1.0
2014-15,RegularSeason,1737,448,Nazr Mohammed,1610612741,CHI,23,128,13,30,0.433,0,0,0.0,1,3,0.333,11,27,38,3,4,5,7,16,27,51,0.43,0.57,2014,15,1.173913043478261,0.42857142857142855,17,2,19,2.0
2014-15,RegularSeason,101183,452,Shavlik Randolph,1610612756,PHX,21,126,9,35,0.257,0,5,0.0,6,12,0.5,16,22,38,4,5,3,3,16,24,39,1.33,1.67,2014,15,1.1428571428571428,1.3333333333333333,26,6,32,1.1875
2014-15,RegularSeason,201964,452,Victor Claver,1610612757,POR,10,76,9,20,0.45,6,11,0.545,0,0,0.0,3,17,20,1,1,1,4,12,24,32,0.25,0.25,2014,15,2.4,0.25,11,0,11,1.8181818181818181
2014-15,RegularSeason,203930,454,Sean Kilpatrick,1610612750,MIN,4,72,7,20,0.35,4,13,0.308,4,4,1.0,1,5,6,4,3,0,2,3,22,20,2.0,1.5,2014,15,5.5,2.0,13,0,13,0.46153846153846156
2014-15,RegularSeason,203505,454,Vander Blue,1610612747,LAL,2,74,9,30,0.3,2,10,0.2,2,5,0.4,2,7,9,8,3,0,6,4,22,12,1.33,0.5,2014,15,11.0,1.3333333333333333,21,3,24,0.375
2014-15,RegularSeason,101198,454,Will Bynum,1610612764,WAS,7,67,10,31,0.323,0,9,0.0,2,4,0.5,2,4,6,18,1,1,8,9,22,17,2.25,0.13,2014,15,3.142857142857143,2.25,21,2,23,0.2608695652173913
2014-15,RegularSeason,2563,457,Dahntay Jones,1610612746,LAC,33,123,6,21,0.286,0,4,0.0,9,11,0.818,1,10,11,2,3,0,1,23,21,19,2.0,3.0,2014,15,0.6363636363636364,2.0,15,2,17,0.6470588235294118
2014-15,RegularSeason,2030,458,Kenyon Martin,1610612749,MIL,11,104,9,22,0.409,0,0,0.0,2,2,1.0,6,13,19,5,5,6,3,13,20,39,1.67,1.67,2014,15,1.8181818181818181,1.6666666666666667,13,0,13,1.4615384615384615
2014-15,RegularSeason,203136,458,Ognjen Kuzmic,1610612744,GSW,16,72,8,12,0.667,0,0,0.0,4,4,1.0,7,10,17,6,2,1,5,13,20,37,1.2,0.4,2014,15,1.25,1.2,4,0,4,4.25
2014-15,RegularSeason,200769,458,Shannon Brown,1610612748,MIA,5,89,7,19,0.368,3,7,0.429,3,4,0.75,0,1,1,3,4,0,4,8,20,11,0.75,1.0,2014,15,4.0,0.75,12,1,13,0.07692307692307693
2014-15,RegularSeason,202333,458,Xavier Henry,1610612747,LAL,9,86,3,13,0.231,0,0,0.0,14,24,0.583,2,2,4,3,3,0,3,6,20,7,1.0,1.0,2014,15,2.2222222222222223,1.0,10,10,20,0.2
2014-15,RegularSeason,201604,462,Chris Douglas-Roberts,1610612746,LAC,12,103,5,21,0.238,1,7,0.143,8,8,1.0,1,11,12,4,1,0,0,14,19,20,0.0,0.0,2014,15,1.5833333333333333,inf,16,0,16,0.75
2014-15,RegularSeason,201991,463,Lester Hudson,1610612746,LAC,5,56,6,14,0.429,3,6,0.5,3,4,0.75,1,7,8,5,6,1,3,4,18,26,1.67,2.0,2014,15,3.6,1.6666666666666667,8,1,9,0.8888888888888888
2014-15,RegularSeason,204079,464,Drew Gordon,1610612755,PHI,9,71,8,19,0.421,0,3,0.0,1,2,0.5,7,11,18,2,1,0,8,7,17,18,0.25,0.13,2014,15,1.8888888888888888,0.25,11,1,12,1.5
2014-15,RegularSeason,203511,465,Grant Jerrett,1610612762,UTA,8,51,7,26,0.269,1,15,0.067,1,1,1.0,2,7,9,3,2,2,3,11,16,10,1.0,0.67,2014,15,2.0,1.0,19,0,19,0.47368421052631576
2014-15,RegularSeason,203805,466,Will Cherry,1610612761,TOR,8,69,5,19,0.263,2,9,0.222,3,6,0.5,1,4,5,8,6,1,4,10,15,14,2.0,1.5,2014,15,1.875,2.0,14,3,17,0.29411764705882354
2014-15,RegularSeason,201880,467,Greg Stiemsma,1610612761,TOR,17,66,6,8,0.75,0,0,0.0,2,4,0.5,9,6,15,3,2,0,7,15,14,23,0.43,0.29,2014,15,0.8235294117647058,0.42857142857142855,2,2,4,3.75
2014-15,RegularSeason,203318,468,Glen Rice,1610612764,WAS,5,43,3,15,0.2,1,7,0.143,4,6,0.667,2,2,4,2,0,0,2,11,11,1,1.0,0.0,2014,15,2.2,1.0,12,2,14,0.2857142857142857
2014-15,RegularSeason,203998,469,Bruno Caboclo,1610612761,TOR,8,23,4,12,0.333,2,3,0.667,0,0,0.0,1,1,2,0,0,1,4,3,10,1,0.0,0.0,2014,15,1.25,0.0,8,0,8,0.25
2014-15,RegularSeason,203946,469,Cameron Bairstow,1610612741,CHI,18,64,3,14,0.214,0,0,0.0,4,5,0.8,6,2,8,1,2,1,3,8,10,7,0.33,0.67,2014,15,0.5555555555555556,0.3333333333333333,11,1,12,0.6666666666666666
2014-15,RegularSeason,202077,471,Jerel McNeal,1610612756,PHX,6,36,3,11,0.273,1,2,0.5,2,2,1.0,0,3,3,2,3,1,5,5,9,5,0.4,0.6,2014,15,1.5,0.4,8,0,8,0.375
2014-15,RegularSeason,204065,472,David Stockton,1610612758,SAC,3,33,2,6,0.333,1,2,0.5,3,6,0.5,0,2,2,9,2,0,4,1,8,10,2.25,0.5,2014,15,2.6666666666666665,2.25,4,3,7,0.2857142857142857
2014-15,RegularSeason,203545,472,Miroslav Raduljica,1610612750,MIN,5,23,3,8,0.375,0,0,0.0,2,2,1.0,2,3,5,0,1,0,2,8,8,7,0.0,0.5,2014,15,1.6,0.0,5,0,5,1.0
2014-15,RegularSeason,203539,474,Gal Mekel,1610612742,DAL,4,43,3,20,0.15,0,3,0.0,0,0,0.0,0,1,1,13,2,0,2,1,6,3,6.5,1.0,2014,15,1.5,6.5,17,0,17,0.058823529411764705
2014-15,RegularSeason,203512,474,Lucas Nogueira,1610612761,TOR,6,23,2,8,0.25,0,0,0.0,2,4,0.5,2,9,11,1,2,0,2,6,6,10,0.5,1.0,2014,15,1.0,0.5,6,2,8,1.375
2014-15,RegularSeason,203565,474,Patrick Christopher,1610612763,MEM,4,29,3,12,0.25,0,4,0.0,0,0,0.0,2,4,6,0,1,0,1,6,6,3,0.0,1.0,2014,15,1.5,0.0,9,0,9,0.6666666666666666
2014-15,RegularSeason,203315,474,Toure' Murry,1610612762,UTA,5,18,2,5,0.4,0,0,0.0,2,2,1.0,1,0,1,1,1,0,4,2,6,2,0.25,0.25,2014,15,1.2,0.25,3,0,3,0.3333333333333333
2014-15,RegularSeason,203945,478,Alex Kirk,1610612739,CLE,5,14,1,4,0.25,0,0,0.0,2,2,1.0,1,0,1,1,0,0,0,1,4,3,0.0,0.0,2014,15,0.8,inf,3,0,3,0.3333333333333333
2014-15,RegularSeason,200748,478,Tyrus Thomas,1610612763,MEM,2,7,1,1,1.0,0,0,0.0,2,2,1.0,0,0,0,1,0,0,0,0,4,5,0.0,0.0,2014,15,2.0,inf,0,0,0,
2014-15,RegularSeason,203958,480,Andre Dawkins,1610612748,MIA,4,22,1,6,0.167,1,6,0.167,0,0,0.0,0,2,2,1,0,0,1,3,3,0,1.0,0.0,2014,15,0.75,1.0,5,0,5,0.4
2014-15,RegularSeason,1905,480,Andrei Kirilenko,1610612751,BKN,7,36,0,5,0.0,0,0,0.0,3,4,0.75,2,6,8,1,1,0,1,1,3,6,1.0,1.0,2014,15,0.42857142857142855,1.0,5,1,6,1.3333333333333333
2014-15,RegularSeason,203479,480,Jamaal Franklin,1610612743,DEN,3,13,1,2,0.5,1,2,0.5,0,0,0.0,1,1,2,3,0,1,3,4,3,5,1.0,0.0,2014,15,1.0,1.0,1,0,1,2.0
2014-15,RegularSeason,203121,483,Darius Miller,1610612740,NOP,5,43,1,7,0.143,0,1,0.0,0,0,0.0,0,1,1,2,1,0,1,8,2,-1,2.0,1.0,2014,15,0.4,2.0,6,0,6,0.16666666666666666
2014-15,RegularSeason,203961,483,Eric Moreland,1610612758,SAC,3,2,1,1,1.0,0,0,0.0,0,0,0.0,0,1,1,0,0,0,0,1,2,3,0.0,0.0,2014,15,0.6666666666666666,,0,0,0,inf
2014-15,RegularSeason,203944,483,Julius Randle,1610612747,LAL,1,14,1,3,0.333,0,0,0.0,0,2,0.0,0,0,0,0,0,0,1,1,2,-3,0.0,0.0,2014,15,2.0,0.0,2,2,4,0.0
2014-15,RegularSeason,204021,483,Sim Bhullar,1610612758,SAC,3,3,1,2,0.5,0,0,0.0,0,0,0.0,0,1,1,1,0,1,0,0,2,4,0.0,0.0,2014,15,0.6666666666666666,inf,1,0,1,1.0
2014-15,RegularSeason,204033,487,David Wear,1610612758,SAC,2,7,0,2,0.0,0,1,0.0,0,0,0.0,2,0,2,1,0,0,0,1,0,1,0.0,0.0,2014,15,0.0,inf,2,0,2,1.0
2014-15,RegularSeason,203968,487,Jerrelle Benimon,1610612743,DEN,2,3,0,0,0.0,0,0,0.0,0,0,0.0,1,2,3,0,0,0,1,0,0,2,0.0,0.0,2014,15,0.0,0.0,0,0,0,inf
2014-15,RegularSeason,203564,487,Kalin Lucas,1610612763,MEM,1,6,0,1,0.0,0,0,0.0,0,0,0.0,0,0,0,0,1,0,0,1,0,0,0.0,0.0,2014,15,0.0,,1,0,1,0.0
2014-15,RegularSeason,202723,487,Malcolm Lee,1610612755,PHI,1,2,0,1,0.0,0,0,0.0,0,0,0.0,0,0,0,0,0,0,0,0,0,-1,0.0,0.0,2014,15,0.0,,1,0,1,0.0
2014-15,RegularSeason,101142,487,Ronny Turiaf,1610612750,MIN,2,19,0,0,0.0,0,0,0.0,0,0,0.0,0,1,1,2,0,0,0,0,0,3,0.0,0.0,2014,15,0.0,inf,0,0,0,inf
2014-15,RegularSeason,203552,487,Seth Curry,1610612756,PHX,2,8,0,3,0.0,0,1,0.0,0,0,0.0,0,2,2,1,0,0,0,2,0,0,0.0,0.0,2014,15,0.0,inf,3,0,3,0.6666666666666666
2014-15,Playoffs,2544,1,LeBron James,1610612739,CLE,20,844,227,544,0.417,25,110,0.227,122,167,0.731,37,189,226,169,33,21,82,58,601,606,2.06,0.4,2014,15,30.05,2.0609756097560976,317,45,362,0.6243093922651933
2014-15,Playoffs,201939,2,Stephen Curry,1610612744,GSW,21,826,200,439,0.456,98,232,0.422,96,115,0.835,20,85,105,134,39,3,82,47,594,535,1.63,0.48,2014,15,28.285714285714285,1.6341463414634145,239,19,258,0.4069767441860465
2014-15,Playoffs,201935,3,James Harden,1610612745,HOU,17,636,129,294,0.439,41,107,0.383,163,178,0.916,12,85,97,128,28,7,77,49,462,465,1.66,0.36,2014,15,27.176470588235293,1.6623376623376624,165,15,180,0.5388888888888889
2014-15,Playoffs,202691,4,Klay Thompson,1610612744,GSW,21,761,149,334,0.446,57,146,0.39,36,45,0.8,9,72,81,54,16,19,41,64,391,326,1.32,0.39,2014,15,18.61904761904762,1.3170731707317074,185,9,194,0.4175257731958763
2014-15,Playoffs,201933,5,Blake Griffin,1610612746,LAC,14,557,140,274,0.511,1,7,0.143,76,106,0.717,38,140,178,86,14,14,45,43,357,440,1.91,0.31,2014,15,25.5,1.9111111111111112,134,30,164,1.0853658536585367
2014-15,Playoffs,203110,6,Draymond Green,1610612744,GSW,21,784,100,240,0.417,24,91,0.264,64,87,0.736,46,166,212,109,38,25,58,89,288,451,1.88,0.66,2014,15,13.714285714285714,1.8793103448275863,140,23,163,1.3006134969325154
2014-15,Playoffs,2730,7,Dwight Howard,1610612745,HOU,17,574,105,182,0.577,0,0,0.0,68,165,0.412,62,176,238,20,23,39,37,60,278,387,0.54,0.62,2014,15,16.352941176470587,0.5405405405405406,77,97,174,1.367816091954023
2014-15,Playoffs,202710,8,Jimmy Butler,1610612741,CHI,12,506,94,213,0.441,28,72,0.389,59,72,0.819,18,49,67,38,29,9,21,27,275,265,1.81,1.38,2014,15,22.916666666666668,1.8095238095238095,119,13,132,0.5075757575757576
2014-15,Playoffs,201952,9,Jeff Teague,1610612737,ATL,16,529,98,239,0.41,21,65,0.323,52,60,0.867,10,41,51,107,24,7,43,34,269,266,2.49,0.56,2014,15,16.8125,2.488372093023256,141,8,149,0.3422818791946309
2014-15,Playoffs,101108,10,Chris Paul,1610612746,LAC,12,445,95,189,0.503,27,65,0.415,48,51,0.941,7,46,53,105,22,3,26,37,265,325,4.04,0.85,2014,15,22.083333333333332,4.038461538461538,94,3,97,0.5463917525773195
2014-15,Playoffs,202681,11,Kyrie Irving,1610612739,CLE,13,464,81,185,0.438,27,60,0.45,58,69,0.841,10,37,47,50,17,11,20,29,247,237,2.5,0.85,2014,15,19.0,2.5,104,11,115,0.40869565217391307
2014-15,Playoffs,201565,12,Derrick Rose,1610612741,CHI,12,454,93,235,0.396,23,66,0.348,35,39,0.897,13,45,58,78,14,6,38,22,244,216,2.05,0.37,2014,15,20.333333333333332,2.0526315789473686,142,4,146,0.3972602739726027
2014-15,Playoffs,200794,13,Paul Millsap,1610612737,ATL,16,566,85,209,0.407,15,49,0.306,58,78,0.744,36,103,139,55,25,14,34,52,243,298,1.62,0.73,2014,15,15.1875,1.6176470588235294,124,20,144,0.9652777777777778
2014-15,Playoffs,203078,14,Bradley Beal,1610612764,WAS,10,418,81,200,0.405,23,63,0.365,49,59,0.831,14,41,55,46,16,7,26,19,234,203,1.77,0.61,2014,15,23.4,1.7692307692307692,119,10,129,0.4263565891472868
2014-15,Playoffs,201960,15,DeMarre Carroll,1610612737,ATL,16,558,86,177,0.486,29,72,0.403,32,41,0.78,26,71,97,32,18,5,15,36,233,270,2.13,1.2,2014,15,14.5625,2.1333333333333333,91,9,100,0.97
2014-15,Playoffs,201143,16,Al Horford,1610612737,ATL,16,522,107,211,0.507,2,9,0.222,15,20,0.75,40,98,138,59,13,23,25,34,231,330,2.36,0.52,2014,15,14.4375,2.36,104,5,109,1.2660550458715596
2014-15,Playoffs,2747,16,JR Smith,1610612739,CLE,18,560,83,206,0.403,51,142,0.359,14,20,0.7,9,76,85,22,17,10,15,54,231,221,1.47,1.13,2014,15,12.833333333333334,1.4666666666666666,123,6,129,0.6589147286821705
2014-15,Playoffs,2746,18,Josh Smith,1610612745,HOU,17,396,85,194,0.438,27,71,0.38,32,74,0.432,26,70,96,46,9,17,38,41,229,208,1.21,0.24,2014,15,13.470588235294118,1.2105263157894737,109,42,151,0.6357615894039735
2014-15,Playoffs,2772,19,Trevor Ariza,1610612745,HOU,17,655,75,176,0.426,36,96,0.375,38,42,0.905,18,91,109,44,30,2,23,51,224,281,1.91,1.3,2014,15,13.176470588235293,1.9130434782608696,101,4,105,1.0380952380952382
2014-15,Playoffs,203084,20,Harrison Barnes,1610612744,GSW,21,681,88,200,0.44,22,62,0.355,25,34,0.735,45,65,110,32,17,11,22,45,223,250,1.46,0.77,2014,15,10.619047619047619,1.4545454545454546,112,9,121,0.9090909090909091
2014-15,Playoffs,2738,21,Andre Iguodala,1610612744,GSW,21,635,81,171,0.474,29,82,0.354,27,65,0.415,16,78,94,75,25,7,14,42,218,277,5.36,1.79,2014,15,10.380952380952381,5.357142857142857,90,38,128,0.734375
2014-15,Playoffs,201188,22,Marc Gasol,1610612763,MEM,11,416,71,180,0.394,0,2,0.0,75,88,0.852,19,94,113,49,10,19,16,33,217,270,3.06,0.63,2014,15,19.727272727272727,3.0625,109,13,122,0.9262295081967213
2014-15,Playoffs,202389,23,Timofey Mozgov,1610612739,CLE,20,529,74,148,0.5,0,0,0.0,64,81,0.79,57,89,146,13,8,36,37,57,212,287,0.35,0.22,2014,15,10.6,0.35135135135135137,74,17,91,1.6043956043956045
2014-15,Playoffs,200755,24,JJ Redick,1610612746,LAC,14,540,70,161,0.435,35,88,0.398,33,35,0.943,0,30,30,24,10,5,26,36,208,158,0.92,0.39,2014,15,14.857142857142858,0.9230769230769231,91,2,93,0.3225806451612903
2014-15,Playoffs,202684,25,Tristan Thompson,1610612739,CLE,20,727,72,129,0.558,0,0,0.0,48,82,0.585,88,128,216,9,5,24,15,50,192,340,0.6,0.33,2014,15,9.6,0.6,57,34,91,2.3736263736263736
2014-15,Playoffs,201147,26,Corey Brewer,1610612745,HOU,17,428,72,167,0.431,12,42,0.286,35,55,0.636,11,36,47,19,11,4,15,48,191,142,1.27,0.73,2014,15,11.235294117647058,1.2666666666666666,95,20,115,0.40869565217391307
2014-15,Playoffs,201599,27,DeAndre Jordan,1610612746,LAC,14,482,58,81,0.716,0,0,0.0,67,157,0.427,49,138,187,16,16,33,17,42,183,305,0.94,0.94,2014,15,13.071428571428571,0.9411764705882353,23,90,113,1.654867256637168
2014-15,Playoffs,202697,28,Iman Shumpert,1610612739,CLE,20,695,59,164,0.36,33,93,0.355,30,40,0.75,23,75,98,23,25,16,13,50,181,215,1.77,1.92,2014,15,9.05,1.7692307692307692,105,10,115,0.8521739130434782
2014-15,Playoffs,2037,29,Jamal Crawford,1610612746,LAC,14,379,67,186,0.36,18,74,0.243,26,30,0.867,6,24,30,27,13,3,17,34,178,111,1.59,0.77,2014,15,12.714285714285714,1.588235294117647,119,4,123,0.24390243902439024
2014-15,Playoffs,203093,30,Terrence Jones,1610612745,HOU,17,401,67,159,0.421,3,19,0.158,36,54,0.667,29,52,81,17,8,12,16,31,173,165,1.06,0.5,2014,15,10.176470588235293,1.0625,92,18,110,0.7363636363636363
2014-15,Playoffs,2216,31,Zach Randolph,1610612763,MEM,11,382,71,168,0.423,1,5,0.2,29,33,0.879,32,61,93,23,6,0,23,37,172,170,1.0,0.26,2014,15,15.636363636363637,1.0,97,4,101,0.9207920792079208
2014-15,Playoffs,1891,32,Jason Terry,1610612745,HOU,17,487,57,134,0.425,29,82,0.354,13,16,0.813,6,32,38,48,15,2,20,46,156,159,2.4,0.75,2014,15,9.176470588235293,2.4,77,3,80,0.475
2014-15,Playoffs,2594,32,Kyle Korver,1610612737,ATL,14,526,52,133,0.391,39,110,0.355,13,16,0.813,1,69,70,33,20,15,21,27,156,189,1.57,0.95,2014,15,11.142857142857142,1.5714285714285714,81,3,84,0.8333333333333334
2014-15,Playoffs,201584,34,Courtney Lee,1610612763,MEM,11,367,55,100,0.55,14,30,0.467,22,23,0.957,3,25,28,24,12,0,13,24,146,151,1.85,0.92,2014,15,13.272727272727273,1.8461538461538463,45,1,46,0.6086956521739131
2014-15,Playoffs,1718,34,Paul Pierce,1610612764,WAS,10,298,48,99,0.485,33,63,0.524,17,20,0.85,0,42,42,9,6,7,10,33,146,146,0.9,0.6,2014,15,14.6,0.9,51,3,54,0.7777777777777778
2014-15,Playoffs,203471,36,Dennis Schroder,1610612737,ATL,16,290,56,145,0.386,8,34,0.235,24,28,0.857,5,24,29,62,9,0,27,28,144,124,2.3,0.33,2014,15,9.0,2.2962962962962963,89,4,93,0.3118279569892473
2014-15,Playoffs,2200,36,Pau Gasol,1610612741,CHI,10,317,56,115,0.487,0,4,0.0,32,42,0.762,17,77,94,31,5,21,21,18,144,205,1.48,0.24,2014,15,14.4,1.4761904761904763,59,10,69,1.3623188405797102
2014-15,Playoffs,203521,38,Matthew Dellavedova,1610612739,CLE,20,497,47,136,0.346,24,76,0.316,25,32,0.781,10,31,41,53,9,0,35,52,143,115,1.51,0.26,2014,15,7.15,1.5142857142857142,89,7,96,0.4270833333333333
2014-15,Playoffs,202695,39,Kawhi Leonard,1610612759,SAS,7,250,52,109,0.477,11,26,0.423,27,35,0.771,13,39,52,18,8,4,15,18,142,144,1.2,0.53,2014,15,20.285714285714285,1.2,57,8,65,0.8
2014-15,Playoffs,2399,40,Mike Dunleavy,1610612741,CHI,12,389,43,88,0.489,27,56,0.482,18,19,0.947,7,41,48,31,10,5,15,31,131,164,2.07,0.67,2014,15,10.916666666666666,2.066666666666667,45,1,46,1.0434782608695652
2014-15,Playoffs,101145,41,Monta Ellis,1610612742,DAL,5,197,52,111,0.468,11,30,0.367,15,20,0.75,4,12,16,26,10,3,16,18,130,105,1.63,0.63,2014,15,26.0,1.625,59,5,64,0.25
2014-15,Playoffs,203076,42,Anthony Davis,1610612740,NOP,4,172,47,87,0.54,0,2,0.0,32,36,0.889,9,35,44,8,5,12,13,12,126,138,0.61,0.39,2014,15,31.5,0.6153846153846154,40,4,44,1.0
2014-15,Playoffs,1495,43,Tim Duncan,1610612759,SAS,7,250,53,90,0.589,0,1,0.0,19,34,0.559,19,59,78,23,9,10,7,26,125,186,3.29,1.29,2014,15,17.857142857142858,3.2857142857142856,37,15,52,1.5
2014-15,Playoffs,101162,44,Marcin Gortat,1610612764,WAS,10,307,54,86,0.628,0,0,0.0,16,24,0.667,27,61,88,22,6,11,16,29,124,195,1.38,0.38,2014,15,12.4,1.375,32,8,40,2.2
2014-15,Playoffs,202322,45,John Wall,1610612764,WAS,7,273,43,110,0.391,3,17,0.176,33,39,0.846,5,28,33,83,10,10,27,13,122,158,3.07,0.37,2014,15,17.428571428571427,3.074074074074074,67,6,73,0.4520547945205479
2014-15,Playoffs,201572,46,Brook Lopez,1610612751,BKN,6,234,43,87,0.494,0,0,0.0,33,40,0.825,20,34,54,5,4,13,6,18,119,138,0.83,0.67,2014,15,19.833333333333332,0.8333333333333334,44,7,51,1.0588235294117647
2014-15,Playoffs,203085,47,Austin Rivers,1610612746,LAC,14,250,46,105,0.438,13,35,0.371,12,19,0.632,6,18,24,16,10,4,12,28,117,93,1.33,0.83,2014,15,8.357142857142858,1.3333333333333333,59,7,66,0.36363636363636365
2014-15,Playoffs,201144,48,Mike Conley,1610612763,MEM,8,243,41,96,0.427,10,33,0.303,23,28,0.821,0,9,9,40,11,0,12,10,115,103,3.33,0.92,2014,15,14.375,3.3333333333333335,55,5,60,0.15
2014-15,Playoffs,200746,49,LaMarcus Aldridge,1610612757,POR,5,208,37,112,0.33,3,11,0.273,32,36,0.889,21,35,56,9,2,12,8,16,109,101,1.13,0.25,2014,15,21.8,1.125,75,4,79,0.7088607594936709
2014-15,Playoffs,203081,50,Damian Lillard,1610612757,POR,5,201,39,96,0.406,5,31,0.161,25,32,0.781,2,18,20,23,2,3,12,15,108,80,1.92,0.17,2014,15,21.6,1.9166666666666667,57,7,64,0.3125
2014-15,Playoffs,2440,51,Matt Barnes,1610612746,LAC,14,409,38,100,0.38,16,60,0.267,15,20,0.75,16,55,71,22,20,10,16,54,107,147,1.38,1.25,2014,15,7.642857142857143,1.375,62,5,67,1.0597014925373134
2014-15,Playoffs,1717,52,Dirk Nowitzki,1610612742,DAL,5,181,38,84,0.452,4,17,0.235,26,28,0.929,4,48,52,12,2,2,10,16,106,116,1.2,0.2,2014,15,21.2,1.2,46,2,48,1.0833333333333333
2014-15,Playoffs,2733,53,Shaun Livingston,1610612744,GSW,21,375,42,79,0.532,0,1,0.0,21,25,0.84,13,38,51,38,8,5,21,32,105,145,1.81,0.38,2014,15,5.0,1.8095238095238095,37,4,41,1.2439024390243902
2014-15,Playoffs,2571,54,Leandro Barbosa,1610612744,GSW,21,229,39,88,0.443,8,23,0.348,18,22,0.818,8,19,27,18,6,1,12,24,104,91,1.5,0.5,2014,15,4.9523809523809526,1.5,49,4,53,0.5094339622641509
2014-15,Playoffs,203490,55,Otto Porter Jr.,1610612764,WAS,10,331,39,88,0.443,12,32,0.375,10,21,0.476,24,56,80,18,12,2,6,16,100,146,3.0,2.0,2014,15,10.0,3.0,49,11,60,1.3333333333333333
2014-15,Playoffs,2207,56,Joe Johnson,1610612751,BKN,6,249,34,94,0.362,12,41,0.293,19,24,0.792,5,41,46,29,7,0,5,16,99,111,5.8,1.4,2014,15,16.5,5.8,60,5,65,0.7076923076923077
2014-15,Playoffs,201145,57,Jeff Green,1610612763,MEM,11,298,36,108,0.333,4,18,0.222,22,26,0.846,9,43,52,19,5,5,16,18,98,87,1.19,0.31,2014,15,8.909090909090908,1.1875,72,4,76,0.6842105263157895
2014-15,Playoffs,203114,58,Khris Middleton,1610612749,MIL,6,232,35,92,0.38,11,34,0.324,14,15,0.933,7,15,22,12,14,3,10,14,95,78,1.2,1.4,2014,15,15.833333333333334,1.2,57,1,58,0.3793103448275862
2014-15,Playoffs,101106,59,Andrew Bogut,1610612744,GSW,19,440,42,75,0.56,0,1,0.0,5,13,0.385,41,112,153,36,11,34,26,69,89,256,1.39,0.42,2014,15,4.684210526315789,1.3846153846153846,33,8,41,3.731707317073171
2014-15,Playoffs,201959,59,Taj Gibson,1610612741,CHI,12,276,34,72,0.472,0,0,0.0,21,30,0.7,25,41,66,12,4,12,11,25,89,125,1.09,0.36,2014,15,7.416666666666667,1.0909090909090908,38,9,47,1.4042553191489362
2014-15,Playoffs,2592,61,James Jones,1610612739,CLE,20,311,26,75,0.347,22,64,0.344,13,14,0.929,1,28,29,9,8,3,5,42,87,81,1.8,1.6,2014,15,4.35,1.8,49,1,50,0.58
2014-15,Playoffs,203145,61,Kent Bazemore,1610612737,ATL,16,303,30,71,0.423,6,28,0.214,21,31,0.677,3,50,53,13,11,9,11,25,87,111,1.18,1.0,2014,15,5.4375,1.1818181818181819,41,10,51,1.0392156862745099
2014-15,Playoffs,203468,63,CJ McCollum,1610612757,POR,5,166,32,67,0.478,11,23,0.478,10,13,0.769,1,19,20,2,6,1,6,13,85,70,0.33,1.0,2014,15,17.0,0.3333333333333333,35,3,38,0.5263157894736842
2014-15,Playoffs,2564,64,Boris Diaw,1610612759,SAS,7,198,34,71,0.479,4,18,0.222,9,13,0.692,13,30,43,25,5,3,9,24,81,107,2.78,0.56,2014,15,11.571428571428571,2.7777777777777777,37,4,41,1.048780487804878
2014-15,Playoffs,201942,64,DeMar DeRozan,1610612761,TOR,4,159,32,80,0.4,3,8,0.375,14,17,0.824,5,20,25,23,6,0,10,12,81,74,2.3,0.6,2014,15,20.25,2.3,48,3,51,0.49019607843137253
2014-15,Playoffs,2403,66,Nene,1610612764,WAS,10,257,34,76,0.447,0,0,0.0,11,23,0.478,25,41,66,15,9,3,14,32,79,104,1.07,0.64,2014,15,7.9,1.0714285714285714,42,12,54,1.2222222222222223
2014-15,Playoffs,2757,67,Beno Udrih,1610612763,MEM,10,175,31,73,0.425,4,16,0.25,10,12,0.833,4,16,20,21,5,0,4,16,76,74,5.25,1.25,2014,15,7.6,5.25,42,2,44,0.45454545454545453
2014-15,Playoffs,2225,67,Tony Parker,1610612759,SAS,7,210,33,91,0.363,0,9,0.0,10,17,0.588,4,19,23,25,2,0,11,14,76,50,2.27,0.18,2014,15,10.857142857142858,2.272727272727273,58,7,65,0.35384615384615387
2014-15,Playoffs,201196,69,Ramon Sessions,1610612764,WAS,10,218,26,70,0.371,10,25,0.4,13,19,0.684,2,22,24,23,4,1,10,14,75,67,2.3,0.4,2014,15,7.5,2.3,44,6,50,0.48
2014-15,Playoffs,201569,70,Eric Gordon,1610612740,NOP,4,143,28,63,0.444,13,32,0.406,5,6,0.833,2,7,9,15,2,2,10,11,74,56,1.5,0.2,2014,15,18.5,1.5,35,1,36,0.25
2014-15,Playoffs,101127,70,Jarrett Jack,1610612751,BKN,6,153,28,54,0.519,5,15,0.333,13,13,1.0,2,23,25,27,7,1,20,14,74,88,1.35,0.35,2014,15,12.333333333333334,1.35,26,0,26,0.9615384615384616
2014-15,Playoffs,203487,72,Michael Carter-Williams,1610612749,MIL,6,191,33,78,0.423,0,5,0.0,7,12,0.583,1,26,27,29,7,6,16,14,73,76,1.81,0.44,2014,15,12.166666666666666,1.8125,45,5,50,0.54
2014-15,Playoffs,101114,73,Deron Williams,1610612751,BKN,6,192,27,69,0.391,11,26,0.423,6,7,0.857,3,34,37,33,8,0,16,18,71,90,2.06,0.5,2014,15,11.833333333333334,2.0625,42,1,43,0.8604651162790697
2014-15,Playoffs,201587,73,Nicolas Batum,1610612757,POR,5,209,24,70,0.343,13,39,0.333,10,13,0.769,6,37,43,26,1,1,12,11,71,81,2.17,0.08,2014,15,14.2,2.1666666666666665,46,3,49,0.8775510204081632
2014-15,Playoffs,201988,73,Patty Mills,1610612759,SAS,7,112,21,42,0.5,16,28,0.571,13,13,1.0,4,15,19,8,2,0,5,15,71,74,1.6,0.4,2014,15,10.142857142857142,1.6,21,0,21,0.9047619047619048
2014-15,Playoffs,203105,76,Festus Ezeli,1610612744,GSW,20,183,27,50,0.54,0,0,0.0,16,29,0.552,24,38,62,6,1,10,12,25,70,101,0.5,0.08,2014,15,3.5,0.5,23,13,36,1.7222222222222223
2014-15,Playoffs,202738,76,Isaiah Thomas,1610612738,BOS,4,119,18,54,0.333,3,18,0.167,31,32,0.969,1,11,12,28,3,0,14,10,70,62,2.0,0.21,2014,15,17.5,2.0,36,1,37,0.32432432432432434
2014-15,Playoffs,203507,78,Giannis Antetokounmpo,1610612749,MIL,6,201,26,71,0.366,0,1,0.0,17,23,0.739,12,30,42,16,3,9,11,18,69,77,1.46,0.27,2014,15,11.5,1.4545454545454546,45,6,51,0.8235294117647058
2014-15,Playoffs,201149,78,Joakim Noah,1610612741,CHI,12,395,31,76,0.408,0,0,0.0,7,20,0.35,45,87,132,38,10,14,20,37,69,185,1.9,0.5,2014,15,5.75,1.9,45,13,58,2.2758620689655173
2014-15,Playoffs,1713,78,Vince Carter,1610612763,MEM,11,196,27,67,0.403,7,28,0.25,8,9,0.889,13,34,47,11,7,2,7,17,69,88,1.57,1.0,2014,15,6.2727272727272725,1.5714285714285714,40,1,41,1.146341463414634
2014-15,Playoffs,2400,81,Drew Gooden,1610612764,WAS,10,178,23,61,0.377,12,26,0.462,10,13,0.769,13,42,55,8,2,10,14,21,68,88,0.57,0.14,2014,15,6.8,0.5714285714285714,38,3,41,1.3414634146341464
2014-15,Playoffs,101187,82,Alan Anderson,1610612751,BKN,6,142,25,41,0.61,10,16,0.625,6,9,0.667,2,19,21,7,4,1,8,9,66,72,0.88,0.5,2014,15,11.0,0.875,16,3,19,1.105263157894737
2014-15,Playoffs,2754,82,Tony Allen,1610612763,MEM,10,279,28,57,0.491,1,7,0.143,9,12,0.75,14,38,52,15,24,11,13,27,66,123,1.15,1.85,2014,15,6.6,1.1538461538461537,29,3,32,1.625
2014-15,Playoffs,201158,84,Marco Belinelli,1610612759,SAS,7,116,20,39,0.513,14,30,0.467,11,13,0.846,2,11,13,10,2,0,5,10,65,64,2.0,0.4,2014,15,9.285714285714286,2.0,19,2,21,0.6190476190476191
2014-15,Playoffs,202703,85,Nikola Mirotic,1610612741,CHI,11,164,20,66,0.303,7,30,0.233,16,20,0.8,7,23,30,9,6,6,8,22,63,56,1.13,0.75,2014,15,5.7272727272727275,1.125,46,4,50,0.6
2014-15,Playoffs,203544,85,Pero Antic,1610612737,ATL,15,199,16,50,0.32,11,32,0.344,20,25,0.8,9,34,43,4,2,3,5,38,63,71,0.8,0.4,2014,15,4.2,0.8,34,5,39,1.1025641025641026
2014-15,Playoffs,201152,85,Thaddeus Young,1610612751,BKN,6,190,29,66,0.439,0,4,0.0,5,12,0.417,17,26,43,16,5,1,14,15,63,70,1.14,0.36,2014,15,10.5,1.1428571428571428,37,7,44,0.9772727272727273
2014-15,Playoffs,202711,88,Bojan Bogdanovic,1610612751,BKN,6,206,23,59,0.39,11,33,0.333,5,7,0.714,3,20,23,10,4,2,8,12,62,55,1.25,0.5,2014,15,10.333333333333334,1.25,36,2,38,0.6052631578947368
2014-15,Playoffs,200826,89,J.J. Barea,1610612742,DAL,5,154,25,57,0.439,4,16,0.25,5,6,0.833,5,19,24,37,4,0,14,17,59,77,2.64,0.29,2014,15,11.8,2.642857142857143,32,1,33,0.7272727272727273
2014-15,Playoffs,201980,90,Danny Green,1610612759,SAS,7,204,21,61,0.344,12,40,0.3,4,6,0.667,7,15,22,15,7,7,5,12,58,62,3.0,1.4,2014,15,8.285714285714286,3.0,40,2,42,0.5238095238095238
2014-15,Playoffs,203991,91,Clint Capela,1610612745,HOU,17,127,21,31,0.677,0,0,0.0,15,29,0.517,13,29,42,5,3,9,3,19,57,89,1.67,1.0,2014,15,3.3529411764705883,1.6666666666666667,10,14,24,1.75
2014-15,Playoffs,201567,91,Kevin Love,1610612739,CLE,4,107,17,41,0.415,9,21,0.429,14,19,0.737,6,22,28,10,1,2,6,12,57,63,1.67,0.17,2014,15,14.25,1.6666666666666667,24,5,29,0.9655172413793104
2014-15,Playoffs,202329,93,Al-Farouq Aminu,1610612742,DAL,5,150,17,31,0.548,7,11,0.636,15,19,0.789,14,22,36,6,10,8,6,15,56,92,1.0,1.67,2014,15,11.2,1.0,14,4,18,2.0
2014-15,Playoffs,1938,93,Manu Ginobili,1610612759,SAS,7,131,15,43,0.349,8,22,0.364,18,23,0.783,4,20,24,32,4,6,14,19,56,75,2.29,0.29,2014,15,8.0,2.2857142857142856,28,5,33,0.7272727272727273
2014-15,Playoffs,201166,95,Aaron Brooks,1610612741,CHI,12,132,21,61,0.344,8,26,0.308,4,7,0.571,3,15,18,11,3,1,9,16,54,35,1.22,0.33,2014,15,4.5,1.2222222222222223,40,3,43,0.4186046511627907
2014-15,Playoffs,201564,95,O.J. Mayo,1610612749,MIL,6,156,18,54,0.333,6,19,0.316,12,12,1.0,1,19,20,18,7,1,9,14,54,55,2.0,0.78,2014,15,9.0,2.0,36,0,36,0.5555555555555556
2014-15,Playoffs,203089,97,John Henson,1610612749,MIL,6,153,24,41,0.585,0,1,0.0,5,14,0.357,21,27,48,4,5,10,11,14,53,83,0.36,0.46,2014,15,8.833333333333334,0.36363636363636365,17,9,26,1.8461538461538463
2014-15,Playoffs,203143,97,Pablo Prigioni,1610612745,HOU,17,293,19,57,0.333,12,41,0.293,3,4,0.75,6,13,19,39,15,0,12,40,53,75,3.25,1.25,2014,15,3.1176470588235294,3.25,38,1,39,0.48717948717948717
2014-15,Playoffs,101141,99,Ersan Ilyasova,1610612749,MIL,6,142,20,61,0.328,5,23,0.217,7,10,0.7,6,17,23,3,5,3,5,10,52,37,0.6,1.0,2014,15,8.666666666666666,0.6,41,3,44,0.5227272727272727
2014-15,Playoffs,101150,100,Lou Williams,1610612761,TOR,4,102,16,51,0.314,4,21,0.19,15,18,0.833,2,5,7,5,6,0,3,9,51,28,1.67,2.0,2014,15,12.75,1.6666666666666667,35,3,38,0.18421052631578946
2014-15,Playoffs,2199,100,Tyson Chandler,1610612742,DAL,5,160,19,29,0.655,0,0,0.0,13,26,0.5,27,27,54,1,3,6,5,16,51,87,0.2,0.6,2014,15,10.2,0.2,10,13,23,2.347826086956522
2014-15,Playoffs,203118,102,Mike Scott,1610612737,ATL,11,172,21,55,0.382,4,26,0.154,4,4,1.0,16,30,46,5,5,0,7,16,50,65,0.71,0.71,2014,15,4.545454545454546,0.7142857142857143,34,0,34,1.3529411764705883
2014-15,Playoffs,202340,103,Avery Bradley,1610612738,BOS,4,133,19,50,0.38,5,19,0.263,6,7,0.857,3,12,15,3,3,0,3,13,49,35,1.0,1.0,2014,15,12.25,1.0,31,1,32,0.46875
2014-15,Playoffs,203096,103,Jared Sullinger,1610612738,BOS,4,80,21,38,0.553,3,9,0.333,4,7,0.571,9,19,28,1,0,3,5,12,49,56,0.2,0.0,2014,15,12.25,0.2,17,3,20,1.4
2014-15,Playoffs,200768,103,Kyle Lowry,1610612761,TOR,4,131,18,57,0.316,5,23,0.217,8,11,0.727,7,15,22,19,5,0,12,18,49,41,1.58,0.42,2014,15,12.25,1.5833333333333333,39,3,42,0.5238095238095238
2014-15,Playoffs,101161,106,Amir Johnson,1610612761,TOR,4,112,20,29,0.69,0,1,0.0,6,12,0.5,7,21,28,4,1,3,7,16,46,60,0.57,0.14,2014,15,11.5,0.5714285714285714,9,6,15,1.8666666666666667
2014-15,Playoffs,202685,107,Jonas Valanciunas,1610612761,TOR,4,106,19,38,0.5,0,0,0.0,7,8,0.875,9,28,37,2,2,1,4,7,45,63,0.5,0.5,2014,15,11.25,0.5,19,1,20,1.85
2014-15,Playoffs,203109,108,Jae Crowder,1610612738,BOS,4,100,15,29,0.517,3,10,0.3,10,13,0.769,8,12,20,8,4,3,5,14,43,56,1.6,0.8,2014,15,10.75,1.6,14,3,17,1.1764705882352942
2014-15,Playoffs,201583,108,Ryan Anderson,1610612740,NOP,4,95,16,36,0.444,5,12,0.417,6,6,1.0,7,10,17,9,0,2,4,12,43,47,2.25,0.0,2014,15,10.75,2.25,20,0,20,0.85
2014-15,Playoffs,203503,108,Tony Snell,1610612741,CHI,11,140,15,44,0.341,9,27,0.333,4,4,1.0,1,16,17,6,0,3,5,13,43,35,1.2,0.0,2014,15,3.909090909090909,1.2,29,0,29,0.5862068965517241
2014-15,Playoffs,202323,111,Evan Turner,1610612738,BOS,4,118,16,44,0.364,2,4,0.5,8,9,0.889,2,27,29,19,3,0,9,11,42,55,2.11,0.33,2014,15,10.5,2.111111111111111,28,1,29,1.0
2014-15,Playoffs,203488,111,Mike Muscala,1610612737,ATL,10,102,20,33,0.606,2,8,0.25,0,0,0.0,8,10,18,1,1,3,4,13,42,48,0.25,0.25,2014,15,4.2,0.25,13,0,13,1.3846153846153846
2014-15,Playoffs,201175,113,Glen Davis,1610612746,LAC,14,144,17,38,0.447,0,1,0.0,7,9,0.778,9,18,27,3,5,5,9,33,41,49,0.33,0.56,2014,15,2.9285714285714284,0.3333333333333333,21,2,23,1.173913043478261
2014-15,Playoffs,202335,113,Patrick Patterson,1610612761,TOR,4,106,15,27,0.556,7,15,0.467,4,4,1.0,4,10,14,5,3,0,3,5,41,48,1.67,1.0,2014,15,10.25,1.6666666666666667,12,0,12,1.1666666666666667
2014-15,Playoffs,101135,115,David Lee,1610612744,GSW,13,107,16,40,0.4,0,0,0.0,8,15,0.533,11,23,34,8,3,2,2,17,40,54,4.0,1.5,2014,15,3.076923076923077,4.0,24,7,31,1.096774193548387
2014-15,Playoffs,201162,115,Jared Dudley,1610612749,MIL,6,110,14,30,0.467,8,14,0.571,4,7,0.571,3,8,11,8,12,2,5,12,40,49,1.6,2.4,2014,15,6.666666666666667,1.6,16,3,19,0.5789473684210527
2014-15,Playoffs,201936,115,Tyreke Evans,1610612740,NOP,4,125,14,43,0.326,2,11,0.182,10,17,0.588,3,17,20,20,5,1,6,10,40,44,3.33,0.83,2014,15,10.0,3.3333333333333335,29,7,36,0.5555555555555556
2014-15,Playoffs,2585,115,Zaza Pachulia,1610612749,MIL,6,129,16,40,0.4,0,0,0.0,8,13,0.615,11,29,40,9,10,3,5,15,40,68,1.8,2.0,2014,15,6.666666666666667,1.8,24,5,29,1.3793103448275863
2014-15,Playoffs,2405,119,Amar'e Stoudemire,1610612742,DAL,5,75,15,35,0.429,0,0,0.0,9,13,0.692,7,9,16,3,1,3,7,16,39,31,0.43,0.14,2014,15,7.8,0.42857142857142855,20,4,24,0.6666666666666666
2014-15,Playoffs,201573,119,Jerryd Bayless,1610612749,MIL,6,120,12,35,0.343,2,7,0.286,13,17,0.765,4,11,15,18,2,2,4,12,39,45,4.5,0.5,2014,15,6.5,4.5,23,4,27,0.5555555555555556
2014-15,Playoffs,203935,119,Marcus Smart,1610612738,BOS,4,90,14,29,0.483,3,13,0.231,8,15,0.533,5,6,11,5,1,1,4,12,39,31,1.25,0.25,2014,15,9.75,1.25,15,7,22,0.5
2014-15,Playoffs,203086,119,Meyers Leonard,1610612757,POR,5,106,14,21,0.667,10,13,0.769,1,2,0.5,6,27,33,5,2,2,3,17,39,70,1.67,0.67,2014,15,7.8,1.6666666666666667,7,1,8,4.125
2014-15,Playoffs,202714,119,Shelvin Mack,1610612737,ATL,10,99,15,39,0.385,6,21,0.286,3,6,0.5,2,9,11,10,8,0,2,7,39,39,5.0,4.0,2014,15,3.9,5.0,24,3,27,0.4074074074074074
2014-15,Playoffs,201585,124,Kosta Koufos,1610612763,MEM,11,127,17,31,0.548,0,0,0.0,3,5,0.6,19,20,39,4,4,6,1,14,37,73,4.0,4.0,2014,15,3.3636363636363638,4.0,14,2,16,2.4375
2014-15,Playoffs,201578,124,Marreese Speights,1610612744,GSW,10,67,14,42,0.333,0,0,0.0,9,15,0.6,8,13,21,4,4,3,4,14,37,31,1.0,1.0,2014,15,3.7,1.0,28,6,34,0.6176470588235294
2014-15,Playoffs,202708,126,Norris Cole,1610612740,NOP,4,106,15,36,0.417,3,14,0.214,2,3,0.667,1,6,7,7,0,1,8,15,35,20,0.88,0.0,2014,15,8.75,0.875,21,1,22,0.3181818181818182
2014-15,Playoffs,203092,127,Tyler Zeller,1610612738,BOS,4,90,15,29,0.517,0,0,0.0,4,5,0.8,2,16,18,2,2,1,4,5,34,38,0.5,0.5,2014,15,8.5,0.5,14,1,15,1.2
2014-15,Playoffs,202338,128,Kevin Seraphin,1610612764,WAS,6,72,15,31,0.484,0,0,0.0,3,6,0.5,3,16,19,2,2,1,4,10,33,34,0.5,0.5,2014,15,5.5,0.5,16,3,19,1.0
2014-15,Playoffs,201979,128,Nick Calathes,1610612763,MEM,10,126,12,36,0.333,6,13,0.462,3,8,0.375,1,15,16,16,9,1,10,15,33,36,1.6,0.9,2014,15,3.3,1.6,24,5,29,0.5517241379310345
2014-15,Playoffs,101111,130,Charlie Villanueva,1610612742,DAL,5,43,11,25,0.44,8,19,0.421,0,0,0.0,4,9,13,3,1,1,0,10,30,34,0.0,0.0,2014,15,6.0,inf,14,0,14,0.9285714285714286
2014-15,Playoffs,202349,130,Greivis Vasquez,1610612761,TOR,4,101,11,29,0.379,5,14,0.357,3,3,1.0,0,7,7,12,2,0,4,15,30,29,3.0,0.5,2014,15,7.5,3.0,18,0,18,0.3888888888888889
2014-15,Playoffs,202347,132,Quincy Pondexter,1610612740,NOP,4,124,10,28,0.357,3,10,0.3,6,7,0.857,3,17,20,12,7,0,1,13,29,48,12.0,7.0,2014,15,7.25,12.0,18,1,19,1.0526315789473684
2014-15,Playoffs,203082,133,Terrence Ross,1610612761,TOR,4,107,11,29,0.379,6,18,0.333,0,0,0.0,0,6,6,4,3,4,2,10,28,25,2.0,1.5,2014,15,7.0,2.0,18,0,18,0.3333333333333333
2014-15,Playoffs,2550,134,Kirk Hinrich,1610612741,CHI,10,126,9,19,0.474,6,10,0.6,2,3,0.667,0,5,5,11,3,1,1,14,26,34,11.0,3.0,2014,15,2.6,11.0,10,1,11,0.45454545454545453
2014-15,Playoffs,201577,134,Robin Lopez,1610612757,POR,5,117,9,15,0.6,0,0,0.0,8,8,1.0,9,13,22,3,1,5,5,15,26,46,0.6,0.2,2014,15,5.2,0.6,6,0,6,3.6666666666666665
2014-15,Playoffs,2734,136,Devin Harris,1610612742,DAL,4,74,8,23,0.348,0,11,0.0,8,9,0.889,1,7,8,4,2,0,4,10,24,18,1.0,0.5,2014,15,6.0,1.0,15,1,16,0.5
2014-15,Playoffs,201168,136,Tiago Splitter,1610612759,SAS,7,123,9,24,0.375,0,0,0.0,6,19,0.316,13,18,31,9,4,1,7,17,24,34,1.29,0.57,2014,15,3.4285714285714284,1.2857142857142858,15,13,28,1.1071428571428572
2014-15,Playoffs,201150,138,Spencer Hawes,1610612746,LAC,8,57,9,17,0.529,3,6,0.5,2,2,1.0,3,10,13,5,2,3,1,12,23,37,5.0,2.0,2014,15,2.875,5.0,8,0,8,1.625
2014-15,Playoffs,201967,139,Dante Cunningham,1610612740,NOP,4,75,9,11,0.818,0,0,0.0,3,3,1.0,4,14,18,2,3,4,0,7,21,46,0.0,0.0,2014,15,5.25,inf,2,0,2,9.0
2014-15,Playoffs,101138,140,Brandon Bass,1610612738,BOS,4,86,7,20,0.35,0,0,0.0,6,10,0.6,3,5,8,10,1,3,3,4,20,22,3.33,0.33,2014,15,5.0,3.3333333333333335,13,4,17,0.47058823529411764
2014-15,Playoffs,201950,141,Jrue Holiday,1610612740,NOP,3,55,7,19,0.368,1,4,0.25,4,4,1.0,2,1,3,13,2,1,5,3,19,21,2.6,0.4,2014,15,6.333333333333333,2.6,12,0,12,0.25
2014-15,Playoffs,200765,141,Rajon Rondo,1610612742,DAL,2,37,9,20,0.45,1,2,0.5,0,0,0.0,1,1,2,6,0,0,2,6,19,14,3.0,0.0,2014,15,9.5,3.0,11,0,11,0.18181818181818182
2014-15,Playoffs,101198,141,Will Bynum,1610612764,WAS,3,31,7,14,0.5,1,2,0.5,4,5,0.8,2,1,3,3,2,1,5,6,19,15,0.6,0.4,2014,15,6.333333333333333,0.6,7,1,8,0.375
2014-15,Playoffs,203482,144,Kelly Olynyk,1610612738,BOS,4,53,7,13,0.538,3,6,0.5,1,2,0.5,2,3,5,2,2,2,4,12,18,18,0.5,0.5,2014,15,4.5,0.5,6,1,7,0.7142857142857143
2014-15,Playoffs,2210,145,Richard Jefferson,1610612742,DAL,4,51,5,14,0.357,3,8,0.375,2,2,1.0,0,2,2,1,2,0,3,9,15,8,0.33,0.67,2014,15,3.75,0.3333333333333333,9,0,9,0.2222222222222222
2014-15,Playoffs,201991,146,Lester Hudson,1610612746,LAC,7,38,6,14,0.429,2,7,0.286,0,0,0.0,0,1,1,7,2,1,3,8,14,14,2.33,0.67,2014,15,2.0,2.3333333333333335,8,0,8,0.125
2014-15,Playoffs,203486,147,Mason Plumlee,1610612751,BKN,6,49,4,6,0.667,0,0,0.0,4,11,0.364,2,6,8,2,4,2,3,10,12,16,0.67,1.33,2014,15,2.0,0.6666666666666666,2,7,9,0.8888888888888888
2014-15,Playoffs,203910,147,Nick Johnson,1610612745,HOU,9,49,4,17,0.235,1,7,0.143,3,3,1.0,1,3,4,4,0,1,4,7,12,4,1.0,0.0,2014,15,1.3333333333333333,1.0,13,0,13,0.3076923076923077
2014-15,Playoffs,202709,149,Cory Joseph,1610612759,SAS,4,22,5,6,0.833,0,0,0.0,1,2,0.5,0,1,1,0,0,1,1,2,11,10,0.0,0.0,2014,15,2.75,0.0,1,1,2,0.5
2014-15,Playoffs,201973,149,Jonas Jerebko,1610612738,BOS,4,68,5,15,0.333,0,4,0.0,1,2,0.5,4,10,14,1,2,1,3,9,11,15,0.33,0.67,2014,15,2.75,0.3333333333333333,10,1,11,1.2727272727272727
2014-15,Playoffs,101109,149,Raymond Felton,1610612742,DAL,3,36,4,15,0.267,0,4,0.0,3,3,1.0,1,6,7,4,0,0,0,1,11,11,0.0,0.0,2014,15,3.6666666666666665,inf,11,0,11,0.6363636363636364
2014-15,Playoffs,203459,152,Allen Crabbe,1610612757,POR,2,39,4,5,0.8,2,2,1.0,0,0,0.0,0,3,3,1,2,1,1,1,10,15,1.0,2.0,2014,15,5.0,1.0,1,0,1,3.0
2014-15,Playoffs,202718,152,Chandler Parsons,1610612742,DAL,1,37,5,15,0.333,0,4,0.0,0,0,0.0,0,6,6,2,0,0,1,1,10,7,2.0,0.0,2014,15,10.0,2.0,10,0,10,0.6
2014-15,Playoffs,2045,152,Hedo Turkoglu,1610612746,LAC,11,55,4,17,0.235,2,13,0.154,0,0,0.0,1,6,7,4,4,1,2,10,10,11,2.0,2.0,2014,15,0.9090909090909091,2.0,13,0,13,0.5384615384615384
2014-15,Playoffs,203098,152,John Jenkins,1610612737,ATL,4,21,4,6,0.667,2,4,0.5,0,0,0.0,1,2,3,0,0,0,0,2,10,11,0.0,0.0,2014,15,2.5,,2,0,2,1.5
2014-15,Playoffs,2570,152,Kendrick Perkins,1610612739,CLE,8,33,2,8,0.25,0,0,0.0,6,10,0.6,2,7,9,0,0,3,4,6,10,8,0.0,0.0,2014,15,1.25,0.0,6,4,10,0.9
2014-15,Playoffs,203382,157,Aron Baynes,1610612759,SAS,4,40,3,10,0.3,0,0,0.0,3,3,1.0,3,7,10,1,0,0,3,9,9,10,0.33,0.0,2014,15,2.25,0.3333333333333333,7,0,7,1.4285714285714286
2014-15,Playoffs,2549,157,Chris Kaman,1610612757,POR,3,37,4,8,0.5,0,0,0.0,1,1,1.0,5,9,14,3,0,0,3,5,9,19,1.0,0.0,2014,15,3.0,1.0,4,0,4,3.5
2014-15,Playoffs,2034,157,Mike Miller,1610612739,CLE,9,65,3,5,0.6,3,5,0.6,0,0,0.0,0,10,10,0,1,1,1,6,9,18,0.0,1.0,2014,15,1.0,0.0,2,0,2,5.0
2014-15,Playoffs,201582,160,Alexis Ajinca,1610612740,NOP,3,10,4,4,1.0,0,0,0.0,0,0,0.0,0,1,1,1,1,0,0,2,8,11,0.0,0.0,2014,15,2.6666666666666665,inf,0,0,0,inf
2014-15,Playoffs,203925,160,Joe Harris,1610612739,CLE,6,16,2,6,0.333,1,3,0.333,3,4,0.75,0,1,1,1,0,0,1,1,8,4,1.0,0.0,2014,15,1.3333333333333333,1.0,4,1,5,0.2
2014-15,Playoffs,201600,160,Ömer Aşik,1610612740,NOP,4,79,2,10,0.2,0,0,0.0,4,7,0.571,12,17,29,6,5,0,5,10,8,32,1.2,1.0,2014,15,2.0,1.2,8,3,11,2.6363636363636362
2014-15,Playoffs,202066,163,Garrett Temple,1610612764,WAS,4,26,1,6,0.167,0,3,0.0,5,8,0.625,1,2,3,1,2,0,3,4,7,2,0.33,0.67,2014,15,1.75,0.3333333333333333,5,3,8,0.375
2014-15,Playoffs,203919,163,Jordan Adams,1610612763,MEM,4,10,2,3,0.667,1,1,1.0,2,4,0.5,0,1,1,0,1,0,0,0,7,6,0.0,0.0,2014,15,1.75,,1,2,3,0.3333333333333333
2014-15,Playoffs,2581,163,Steve Blake,1610612757,POR,5,43,2,11,0.182,1,8,0.125,2,2,1.0,0,1,1,8,0,1,2,4,7,6,4.0,0.0,2014,15,1.4,4.0,9,0,9,0.1111111111111111
2014-15,Playoffs,201947,166,Earl Clark,1610612751,BKN,2,13,2,10,0.2,2,3,0.667,0,0,0.0,0,2,2,0,1,0,0,1,6,1,0.0,0.0,2014,15,3.0,,8,0,8,0.25
2014-15,Playoffs,203948,166,Johnny O'Bryant III,1610612749,MIL,1,12,3,8,0.375,0,0,0.0,0,0,0.0,1,2,3,0,0,0,0,1,6,4,0.0,0.0,2014,15,6.0,,5,0,5,0.6
2014-15,Playoffs,203900,166,Markel Brown,1610612751,BKN,2,10,2,5,0.4,0,2,0.0,2,2,1.0,2,0,2,1,0,0,2,0,6,4,0.5,0.0,2014,15,3.0,0.5,3,0,3,0.6666666666666666
2014-15,Playoffs,2588,166,Matt Bonner,1610612759,SAS,7,36,2,10,0.2,2,9,0.222,0,0,0.0,0,6,6,1,0,1,1,8,6,5,1.0,0.0,2014,15,0.8571428571428571,1.0,8,0,8,0.75
2014-15,Playoffs,201167,170,Arron Afflalo,1610612757,POR,3,60,2,12,0.167,1,4,0.25,0,1,0.0,0,7,7,2,0,0,3,6,5,0,0.67,0.0,2014,15,1.6666666666666667,0.6666666666666666,10,1,11,0.6363636363636364
2014-15,Playoffs,203926,170,Doug McDermott,1610612741,CHI,3,10,1,3,0.333,1,2,0.5,2,2,1.0,1,1,2,1,0,0,1,0,5,5,1.0,0.0,2014,15,1.6666666666666667,1.0,2,0,2,1.0
2014-15,Playoffs,202734,170,E'Twaun Moore,1610612741,CHI,3,9,2,6,0.333,1,1,1.0,0,0,0.0,0,3,3,0,2,0,0,1,5,6,0.0,0.0,2014,15,1.6666666666666667,,4,0,4,0.75
2014-15,Playoffs,201880,170,Greg Stiemsma,1610612761,TOR,1,2,2,2,1.0,0,0,0.0,1,2,0.5,0,0,0,0,0,0,0,0,5,4,0.0,0.0,2014,15,5.0,,0,1,1,0.0
2014-15,Playoffs,203898,170,Tyler Ennis,1610612749,MIL,1,16,2,9,0.222,1,5,0.2,0,0,0.0,3,1,4,3,0,0,0,1,5,5,0.0,0.0,2014,15,5.0,inf,7,0,7,0.5714285714285714
2014-15,Playoffs,201946,170,Tyler Hansbrough,1610612761,TOR,4,48,1,5,0.2,0,0,0.0,3,4,0.75,1,5,6,3,2,1,2,8,5,10,1.5,1.0,2014,15,1.25,1.5,4,1,5,1.2
2014-15,Playoffs,2563,176,Dahntay Jones,1610612746,LAC,11,18,2,2,1.0,0,0,0.0,0,0,0.0,0,1,1,0,2,0,0,7,4,7,0.0,0.0,2014,15,0.36363636363636365,,0,0,0,inf
2014-15,Playoffs,203540,176,Gigi Datome,1610612738,BOS,3,14,2,6,0.333,0,2,0.0,0,0,0.0,0,1,1,1,0,0,0,4,4,2,0.0,0.0,2014,15,1.3333333333333333,inf,4,0,4,0.25
2014-15,Playoffs,201949,176,James Johnson,1610612761,TOR,2,12,2,6,0.333,0,0,0.0,0,6,0.0,0,2,2,1,0,0,0,0,4,-3,0.0,0.0,2014,15,2.0,inf,4,6,10,0.2
2014-15,Playoffs,203949,176,James Michael McAdoo,1610612744,GSW,5,10,2,3,0.667,0,0,0.0,0,0,0.0,1,3,4,0,0,1,1,0,4,7,0.0,0.0,2014,15,0.8,0.0,1,0,1,4.0
2014-15,Playoffs,202720,176,Jon Leuer,1610612763,MEM,4,9,2,4,0.5,0,0,0.0,0,0,0.0,2,3,5,0,0,0,0,1,4,7,0.0,0.0,2014,15,1.0,,2,0,2,2.5
2014-15,Playoffs,1737,176,Nazr Mohammed,1610612741,CHI,3,14,2,7,0.286,0,1,0.0,0,0,0.0,3,2,5,0,0,1,0,0,4,5,0.0,0.0,2014,15,1.3333333333333333,,5,0,5,1.0
2014-15,Playoffs,201575,182,Brandon Rush,1610612744,GSW,3,7,1,6,0.167,1,2,0.5,0,0,0.0,1,2,3,0,0,0,0,2,3,1,0.0,0.0,2014,15,1.0,,5,0,5,0.6
2014-15,Playoffs,203200,182,Justin Holiday,1610612744,GSW,5,11,1,2,0.5,1,1,1.0,0,0,0.0,0,1,1,1,0,0,2,1,3,2,0.5,0.0,2014,15,0.6,0.5,1,0,1,1.0
2014-15,Playoffs,203123,182,Kostas Papanikolaou,1610612745,HOU,8,21,1,4,0.25,0,3,0.0,1,2,0.5,0,2,2,0,0,0,5,4,3,-4,0.0,0.0,2014,15,0.375,0.0,3,1,4,0.5
2014-15,Playoffs,203101,182,Miles Plumlee,1610612749,MIL,1,16,1,8,0.125,0,0,0.0,1,2,0.5,3,3,6,1,0,1,1,1,3,2,1.0,0.0,2014,15,3.0,1.0,7,1,8,0.75
2014-15,Playoffs,202327,186,Ekpe Udoh,1610612746,LAC,4,12,1,3,0.333,0,0,0.0,0,0,0.0,0,3,3,0,0,0,0,3,2,3,0.0,0.0,2014,15,0.5,,2,0,2,1.5
2014-15,Playoffs,203210,186,JaMychal Green,1610612763,MEM,5,8,0,2,0.0,0,1,0.0,2,2,1.0,0,3,3,0,1,1,0,1,2,5,0.0,0.0,2014,15,0.4,,2,0,2,1.5
2014-15,Playoffs,203268,186,Jorge Gutierrez,1610612749,MIL,1,12,1,2,0.5,0,0,0.0,0,0,0.0,0,1,1,1,0,0,0,1,2,3,0.0,0.0,2014,15,2.0,inf,1,0,1,1.0
2014-15,Playoffs,2743,186,Kris Humphries,1610612764,WAS,1,5,1,1,1.0,0,0,0.0,0,0,0.0,0,3,3,0,0,0,0,1,2,5,0.0,0.0,2014,15,2.0,,0,0,0,inf
2014-15,Playoffs,101110,186,Martell Webster,1610612764,WAS,1,4,1,2,0.5,0,1,0.0,0,0,0.0,0,0,0,0,0,0,0,0,2,1,0.0,0.0,2014,15,2.0,,1,0,1,0.0
2014-15,Playoffs,1890,186,Shawn Marion,1610612739,CLE,6,25,1,6,0.167,0,0,0.0,0,0,0.0,2,4,6,1,2,0,0,1,2,6,0.0,0.0,2014,15,0.3333333333333333,inf,5,0,5,1.2
2014-15,Playoffs,1882,192,Elton Brand,1610612737,ATL,3,4,0,1,0.0,0,0,0.0,1,2,0.5,0,1,1,0,0,0,0,3,1,0,0.0,0.0,2014,15,0.3333333333333333,,1,1,2,0.5
2014-15,Playoffs,201595,192,Joey Dorsey,1610612745,HOU,6,13,0,2,0.0,0,0,0.0,1,2,0.5,1,3,4,2,0,0,1,2,1,3,2.0,0.0,2014,15,0.16666666666666666,2.0,2,1,3,1.3333333333333333
2014-15,Playoffs,202087,194,Alonzo Gee,1610612757,POR,1,3,0,0,0.0,0,0,0.0,0,0,0.0,0,1,1,1,0,0,0,0,0,2,0.0,0.0,2014,15,0.0,inf,0,0,0,inf
2014-15,Playoffs,203108,194,Bernard James,1610612742,DAL,1,2,0,0,0.0,0,0,0.0,0,0,0.0,0,0,0,0,0,0,0,0,0,0,0.0,0.0,2014,15,0.0,,0,0,0,
2014-15,Playoffs,2217,194,Brendan Haywood,1610612739,CLE,1,2,0,1,0.0,0,0,0.0,0,0,0.0,0,0,0,0,0,0,0,0,0,-1,0.0,0.0,2014,15,0.0,,1,0,1,0.0
2014-15,Playoffs,202721,194,Darius Morris,1610612751,BKN,1,5,0,1,0.0,0,0,0.0,0,0,0.0,0,0,0,0,0,0,0,0,0,-1,0.0,0.0,2014,15,0.0,,1,0,1,0.0
2014-15,Playoffs,203939,194,Dwight Powell,1610612742,DAL,2,3,0,1,0.0,0,0,0.0,0,0,0.0,0,1,1,1,0,0,0,1,0,1,0.0,0.0,2014,15,0.0,inf,1,0,1,1.0
2014-15,Playoffs,2222,194,Gerald Wallace,1610612738,BOS,1,4,0,1,0.0,0,0,0.0,0,0,0.0,0,1,1,0,0,0,0,0,0,0,0.0,0.0,2014,15,0.0,,1,0,1,1.0
2014-15,Playoffs,202962,194,Greg Smith,1610612742,DAL,1,1,0,0,0.0,0,0,0.0,0,0,0.0,0,0,0,0,0,0,0,0,0,0,0.0,0.0,2014,15,0.0,,0,0,0,
2014-15,Playoffs,201965,194,Jeff Ayres,1610612759,SAS,3,12,0,1,0.0,0,0,0.0,0,0,0.0,0,3,3,2,0,0,0,0,0,4,0.0,0.0,2014,15,0.0,inf,1,0,1,3.0
2014-15,Playoffs,202366,194,Jerome Jordan,1610612751,BKN,1,5,0,2,0.0,0,0,0.0,0,0,0.0,1,1,2,0,0,0,1,0,0,-1,0.0,0.0,2014,15,0.0,0.0,2,0,2,1.0
2014-15,Playoffs,200777,194,Joel Freeland,1610612757,POR,2,7,0,0,0.0,0,0,0.0,0,0,0.0,0,1,1,0,1,0,0,0,0,2,0.0,0.0,2014,15,0.0,,0,0,0,inf
2014-15,Playoffs,203141,194,Mirza Teletovic,1610612751,BKN,3,16,0,5,0.0,0,4,0.0,0,0,0.0,0,4,4,0,1,0,1,1,0,-1,0.0,1.0,2014,15,0.0,0.0,5,0,5,0.8
2014-15,Playoffs,203515,194,Phil Pressey,1610612738,BOS,2,5,0,3,0.0,0,1,0.0,0,0,0.0,1,0,1,0,0,1,0,1,0,-1,0.0,0.0,2014,15,0.0,,3,0,3,0.3333333333333333
2014-15,Playoffs,2446,194,Rasual Butler,1610612764,WAS,2,7,0,1,0.0,0,1,0.0,0,0,0.0,0,1,1,1,0,0,0,2,0,1,0.0,0.0,2014,15,0.0,inf,1,0,1,1.0
2014-15,Playoffs,203893,194,Russ Smith,1610612763,MEM,2,3,0,0,0.0,0,0,0.0,0,0,0.0,0,0,0,2,0,0,0,0,0,2,0.0,0.0,2014,15,0.0,inf,0,0,0,
2014-15,Playoffs,204025,194,Tim Frazier,1610612757,POR,2,3,0,1,0.0,0,0,0.0,0,0,0.0,0,0,0,0,0,0,1,0,0,-2,0.0,0.0,2014,15,0.0,0.0,1,0,1,0.0
2015-16,RegularSeason,201935,1,James Harden,1610612745,HOU,82,3125,710,1617,0.439,236,657,0.359,720,837,0.86,63,438,501,612,139,51,374,229,2376,2281,1.64,0.37,2015,16,28.975609756097562,1.6363636363636365,907,117,1024,0.4892578125
2015-16,RegularSeason,201939,2,Stephen Curry,1610612744,GSW,79,2700,805,1598,0.504,402,886,0.454,363,400,0.908,68,362,430,527,169,15,262,161,2375,2424,2.01,0.65,2015,16,30.063291139240505,2.0114503816793894,793,37,830,0.5180722891566265
2015-16,RegularSeason,201142,3,Kevin Durant,1610612760,OKC,72,2578,698,1381,0.505,186,481,0.387,447,498,0.898,45,544,589,361,69,85,250,137,2029,2149,1.44,0.28,2015,16,28.180555555555557,1.444,683,51,734,0.8024523160762943
2015-16,RegularSeason,2544,4,LeBron James,1610612739,CLE,76,2709,737,1416,0.52,87,282,0.309,359,491,0.731,111,454,565,514,104,49,249,143,1920,2092,2.06,0.42,2015,16,25.263157894736842,2.0642570281124497,679,132,811,0.6966707768187423
2015-16,RegularSeason,203081,5,Damian Lillard,1610612757,POR,75,2676,618,1474,0.419,229,610,0.375,414,464,0.892,45,257,302,512,65,28,242,165,1879,1638,2.12,0.27,2015,16,25.053333333333335,2.115702479338843,856,50,906,0.3333333333333333
2015-16,RegularSeason,201566,6,Russell Westbrook,1610612760,OKC,80,2750,656,1444,0.454,101,341,0.296,465,573,0.812,145,481,626,834,163,20,342,200,1878,2283,2.44,0.48,2015,16,23.475,2.43859649122807,788,108,896,0.6986607142857143
2015-16,RegularSeason,202331,7,Paul George,1610612754,IND,81,2819,605,1449,0.418,210,566,0.371,454,528,0.86,79,484,563,329,152,29,265,230,1874,1764,1.24,0.57,2015,16,23.135802469135804,1.241509433962264,844,74,918,0.6132897603485838
2015-16,RegularSeason,201942,8,DeMar DeRozan,1610612761,TOR,78,2804,614,1377,0.446,47,139,0.338,555,653,0.85,64,285,349,315,81,21,175,167,1830,1560,1.8,0.46,2015,16,23.46153846153846,1.8,763,98,861,0.40534262485482
2015-16,RegularSeason,202738,9,Isaiah Thomas,1610612738,BOS,82,2644,591,1382,0.428,167,465,0.359,474,544,0.871,46,197,243,509,91,9,220,167,1823,1594,2.31,0.41,2015,16,22.23170731707317,2.3136363636363635,791,70,861,0.28222996515679444
2015-16,RegularSeason,202691,10,Klay Thompson,1610612744,GSW,80,2666,651,1386,0.47,276,650,0.425,193,221,0.873,35,271,306,166,60,49,138,152,1771,1451,1.2,0.43,2015,16,22.1375,1.2028985507246377,735,28,763,0.40104849279161203
2015-16,RegularSeason,202326,11,DeMarcus Cousins,1610612758,SAC,65,2246,601,1332,0.451,70,210,0.333,476,663,0.718,158,589,747,214,101,92,249,236,1748,1735,0.86,0.41,2015,16,26.892307692307693,0.8594377510040161,731,187,918,0.8137254901960784
2015-16,RegularSeason,202689,12,Kemba Walker,1610612766,CHA,81,2885,568,1331,0.427,182,490,0.371,371,438,0.847,56,301,357,421,126,39,171,111,1689,1631,2.46,0.74,2015,16,20.85185185185185,2.461988304093567,763,67,830,0.43012048192771085
2015-16,RegularSeason,203952,13,Andrew Wiggins,1610612750,MIN,81,2845,594,1294,0.459,57,190,0.3,430,565,0.761,105,186,291,164,78,46,182,165,1675,1237,0.9,0.43,2015,16,20.679012345679013,0.9010989010989011,700,135,835,0.34850299401197604
2015-16,RegularSeason,203468,14,CJ McCollum,1610612757,POR,80,2780,641,1431,0.448,197,472,0.417,187,226,0.827,47,212,259,341,97,23,196,187,1666,1361,1.74,0.49,2015,16,20.825,1.739795918367347,790,39,829,0.31242460796139926
2015-16,RegularSeason,200768,15,Kyle Lowry,1610612761,TOR,77,2851,512,1198,0.427,212,547,0.388,398,491,0.811,55,310,365,494,158,34,225,211,1634,1681,2.2,0.7,2015,16,21.22077922077922,2.1955555555555555,686,93,779,0.4685494223363286
2015-16,RegularSeason,202330,16,Gordon Hayward,1610612762,UTA,80,2893,521,1202,0.433,143,410,0.349,393,477,0.824,61,336,397,296,95,27,202,183,1578,1426,1.47,0.47,2015,16,19.725,1.4653465346534653,681,84,765,0.5189542483660131
2015-16,RegularSeason,2546,17,Carmelo Anthony,1610612752,NYK,72,2530,567,1307,0.434,105,310,0.339,334,403,0.829,98,458,556,299,62,38,176,180,1573,1543,1.7,0.35,2015,16,21.84722222222222,1.6988636363636365,740,69,809,0.6872682323856613
2015-16,RegularSeason,202322,18,John Wall,1610612764,WAS,77,2784,572,1349,0.424,115,328,0.351,272,344,0.791,42,337,379,789,145,59,318,159,1531,1736,2.48,0.46,2015,16,19.883116883116884,2.481132075471698,777,72,849,0.4464075382803298
2015-16,RegularSeason,202695,19,Kawhi Leonard,1610612759,SAS,72,2380,551,1090,0.506,129,291,0.443,292,334,0.874,95,398,493,186,128,71,105,133,1523,1715,1.77,1.22,2015,16,21.15277777777778,1.7714285714285714,539,42,581,0.8485370051635112
2015-16,RegularSeason,1626157,20,Karl-Anthony Towns,1610612750,MIN,82,2627,625,1153,0.542,30,88,0.341,223,275,0.811,229,629,858,161,58,138,183,245,1503,1955,0.88,0.32,2015,16,18.329268292682926,0.8797814207650273,528,52,580,1.4793103448275862
2015-16,RegularSeason,201572,21,Brook Lopez,1610612751,BKN,73,2457,591,1157,0.511,2,14,0.143,317,403,0.787,204,369,573,146,58,124,175,215,1501,1575,0.83,0.33,2015,16,20.561643835616437,0.8342857142857143,566,86,652,0.8788343558282209
2015-16,RegularSeason,202704,22,Reggie Jackson,1610612765,DET,79,2424,540,1244,0.434,118,334,0.353,291,337,0.864,58,195,253,492,59,11,223,187,1489,1331,2.21,0.27,2015,16,18.848101265822784,2.2062780269058297,704,46,750,0.3373333333333333
2015-16,RegularSeason,203076,23,Anthony Davis,1610612740,NOP,61,2164,560,1136,0.493,35,108,0.324,326,430,0.758,130,497,627,116,78,125,121,148,1481,1626,0.96,0.65,2015,16,24.278688524590162,0.9586776859504132,576,104,680,0.9220588235294118
2015-16,RegularSeason,101108,24,Chris Paul,1610612746,LAC,74,2420,515,1114,0.462,122,329,0.371,294,328,0.896,39,271,310,738,152,13,194,185,1446,1832,3.8,0.78,2015,16,19.54054054054054,3.804123711340206,599,34,633,0.48973143759873616
2015-16,RegularSeason,203114,25,Khris Middleton,1610612749,MIL,79,2852,507,1142,0.444,143,361,0.396,277,312,0.888,44,258,302,331,131,19,180,204,1434,1367,1.84,0.73,2015,16,18.151898734177216,1.8388888888888888,635,35,670,0.4507462686567164
2015-16,RegularSeason,2548,26,Dwyane Wade,1610612748,MIA,74,2258,540,1183,0.456,7,44,0.159,322,406,0.793,82,220,302,344,79,42,203,116,1409,1246,1.7,0.39,2015,16,19.04054054054054,1.6945812807881773,643,84,727,0.4154057771664374
2015-16,RegularSeason,202710,27,Jimmy Butler,1610612741,CHI,67,2474,470,1035,0.454,64,205,0.312,395,475,0.832,79,279,358,321,110,43,132,124,1399,1454,2.43,0.83,2015,16,20.880597014925375,2.4318181818181817,565,80,645,0.5550387596899224
2015-16,RegularSeason,200794,28,Paul Millsap,1610612737,ATL,81,2647,501,1066,0.47,74,232,0.319,309,408,0.757,198,534,732,265,147,139,191,237,1385,1813,1.39,0.77,2015,16,17.098765432098766,1.387434554973822,565,99,664,1.1024096385542168
2015-16,RegularSeason,1717,29,Dirk Nowitzki,1610612742,DAL,75,2364,498,1112,0.448,126,342,0.368,250,280,0.893,52,437,489,132,52,52,84,161,1372,1369,1.57,0.62,2015,16,18.293333333333333,1.5714285714285714,614,30,644,0.7593167701863354
2015-16,RegularSeason,203507,30,Giannis Antetokounmpo,1610612749,MIL,80,2823,513,1013,0.506,28,109,0.257,296,409,0.724,113,499,612,345,94,113,208,258,1350,1693,1.66,0.45,2015,16,16.875,1.6586538461538463,500,113,613,0.99836867862969
2015-16,RegularSeason,200746,31,LaMarcus Aldridge,1610612759,SAS,74,2261,536,1045,0.513,0,16,0.0,259,302,0.858,176,456,632,110,38,81,99,151,1331,1541,1.11,0.38,2015,16,17.986486486486488,1.1111111111111112,509,43,552,1.144927536231884
2015-16,RegularSeason,203083,32,Andre Drummond,1610612765,DET,81,2666,552,1060,0.521,2,6,0.333,208,586,0.355,395,803,1198,67,119,112,155,245,1314,1769,0.43,0.77,2015,16,16.22222222222222,0.432258064516129,508,378,886,1.3521444695259595
2015-16,RegularSeason,201143,33,Al Horford,1610612737,ATL,82,2631,529,1048,0.505,88,256,0.344,103,129,0.798,148,448,596,263,68,121,107,163,1249,1645,2.46,0.64,2015,16,15.231707317073171,2.457943925233645,519,26,545,1.0935779816513762
2015-16,RegularSeason,201952,34,Jeff Teague,1610612737,ATL,79,2255,434,988,0.439,110,274,0.401,261,312,0.837,33,181,214,470,97,24,218,167,1239,1221,2.16,0.45,2015,16,15.683544303797468,2.1559633027522938,554,51,605,0.3537190082644628
2015-16,RegularSeason,201567,35,Kevin Love,1610612739,CLE,77,2424,409,977,0.419,158,439,0.36,258,314,0.822,149,613,762,185,58,41,142,159,1234,1514,1.3,0.41,2015,16,16.025974025974026,1.3028169014084507,568,56,624,1.2211538461538463
2015-16,RegularSeason,200755,36,JJ Redick,1610612746,LAC,75,2097,422,880,0.48,200,421,0.475,182,205,0.888,10,129,139,106,42,5,78,135,1226,959,1.36,0.54,2015,16,16.346666666666668,1.358974358974359,458,23,481,0.288981288981289
2015-16,RegularSeason,203903,37,Jordan Clarkson,1610612747,LAL,79,2552,475,1098,0.433,111,320,0.347,164,204,0.804,93,220,313,192,88,7,135,168,1225,1027,1.42,0.65,2015,16,15.50632911392405,1.4222222222222223,623,40,663,0.4720965309200603
2015-16,RegularSeason,203095,38,Evan Fournier,1610612753,ORL,79,2566,429,929,0.462,156,390,0.4,199,238,0.836,33,192,225,214,96,2,133,214,1213,1078,1.61,0.72,2015,16,15.354430379746836,1.6090225563909775,500,39,539,0.4174397031539889
2015-16,RegularSeason,202328,39,Greg Monroe,1610612749,MIL,79,2314,491,941,0.522,0,1,0.0,228,308,0.74,218,478,696,178,72,67,129,163,1210,1564,1.38,0.56,2015,16,15.316455696202532,1.37984496124031,450,80,530,1.3132075471698113
2015-16,RegularSeason,200752,40,Rudy Gay,1610612758,SAC,70,2379,466,1007,0.463,74,215,0.344,198,254,0.78,103,353,456,120,100,51,139,184,1204,1195,0.86,0.72,2015,16,17.2,0.8633093525179856,541,56,597,0.7638190954773869
2015-16,RegularSeason,2200,41,Pau Gasol,1610612741,CHI,72,2291,467,995,0.469,24,69,0.348,229,289,0.792,155,638,793,294,42,146,164,148,1187,1710,1.79,0.26,2015,16,16.48611111111111,1.7926829268292683,528,60,588,1.348639455782313
2015-16,RegularSeason,202696,42,Nikola Vucevic,1610612753,ORL,65,2037,533,1046,0.51,2,9,0.222,113,150,0.753,174,402,576,179,53,70,123,173,1181,1386,1.46,0.43,2015,16,18.16923076923077,1.4552845528455285,513,37,550,1.0472727272727274
2015-16,RegularSeason,203115,43,Will Barton,1610612743,DEN,82,2353,425,983,0.432,112,325,0.345,216,268,0.806,59,417,476,203,71,39,139,147,1178,1218,1.46,0.51,2015,16,14.365853658536585,1.460431654676259,558,52,610,0.780327868852459
2015-16,RegularSeason,977,44,Kobe Bryant,1610612747,LAL,66,1863,398,1113,0.358,133,467,0.285,232,281,0.826,41,206,247,184,62,13,129,115,1161,774,1.43,0.48,2015,16,17.59090909090909,1.426356589147287,715,49,764,0.32329842931937175
2015-16,RegularSeason,202340,45,Avery Bradley,1610612738,BOS,76,2536,456,1019,0.447,147,407,0.361,96,123,0.78,48,172,220,158,117,19,109,164,1155,970,1.45,1.07,2015,16,15.197368421052632,1.4495412844036697,563,27,590,0.3728813559322034
2015-16,RegularSeason,203506,46,Victor Oladipo,1610612753,ORL,72,2379,425,970,0.438,98,282,0.348,205,247,0.83,48,297,345,282,116,54,153,174,1153,1210,1.84,0.76,2015,16,16.01388888888889,1.8431372549019607,545,42,587,0.5877342419080068
2015-16,RegularSeason,203897,47,Zach LaVine,1610612750,MIN,82,2294,433,959,0.452,123,316,0.389,161,203,0.793,27,201,228,251,69,17,155,193,1150,992,1.62,0.45,2015,16,14.024390243902438,1.6193548387096774,526,42,568,0.4014084507042254
2015-16,RegularSeason,203918,48,Rodney Hood,1610612762,UTA,79,2541,408,972,0.42,161,449,0.359,172,200,0.86,38,229,267,213,73,16,125,202,1149,1001,1.7,0.58,2015,16,14.544303797468354,1.704,564,28,592,0.4510135135135135
2015-16,RegularSeason,203110,49,Draymond Green,1610612744,GSW,81,2808,401,819,0.49,100,258,0.388,229,329,0.696,134,635,769,598,119,113,259,240,1131,1953,2.31,0.46,2015,16,13.962962962962964,2.3088803088803087,418,100,518,1.4845559845559846
2015-16,RegularSeason,202694,49,Marcus Morris Sr.,1610612765,DET,80,2856,410,945,0.434,108,298,0.362,203,271,0.749,91,313,404,201,67,23,140,170,1131,1083,1.44,0.48,2015,16,14.1375,1.4357142857142857,535,68,603,0.6699834162520729
2015-16,RegularSeason,201583,51,Ryan Anderson,1610612740,NOP,66,2008,397,929,0.427,131,358,0.366,199,228,0.873,131,265,396,73,38,25,90,109,1124,1005,0.81,0.42,2015,16,17.03030303030303,0.8111111111111111,532,29,561,0.7058823529411765
2015-16,RegularSeason,101145,52,Monta Ellis,1610612754,IND,81,2734,436,1021,0.427,87,282,0.309,162,206,0.786,42,229,271,383,150,37,203,174,1121,1130,1.89,0.74,2015,16,13.839506172839506,1.8866995073891626,585,44,629,0.43084260731319557
2015-16,RegularSeason,2037,53,Jamal Crawford,1610612746,LAC,79,2126,379,939,0.404,117,344,0.34,245,271,0.904,20,125,145,183,52,12,113,122,1120,813,1.62,0.46,2015,16,14.177215189873417,1.6194690265486726,560,26,586,0.24744027303754265
2015-16,RegularSeason,202699,54,Tobias Harris,1610612765,DET,76,2513,417,889,0.469,80,239,0.335,202,243,0.831,96,414,510,169,65,40,108,153,1116,1279,1.56,0.6,2015,16,14.68421052631579,1.5648148148148149,472,41,513,0.9941520467836257
2015-16,RegularSeason,203484,55,Kentavious Caldwell-Pope,1610612765,DET,76,2789,403,960,0.42,114,369,0.309,185,228,0.811,70,212,282,138,110,17,105,167,1105,947,1.31,1.05,2015,16,14.539473684210526,1.3142857142857143,557,43,600,0.47
2015-16,RegularSeason,201152,56,Thaddeus Young,1610612751,BKN,73,2407,495,963,0.514,7,30,0.233,105,163,0.644,176,484,660,136,112,37,136,182,1102,1385,1.0,0.82,2015,16,15.095890410958905,1.0,468,58,526,1.2547528517110267
2015-16,RegularSeason,201950,57,Jrue Holiday,1610612740,NOP,65,1831,410,935,0.439,87,259,0.336,182,216,0.843,27,168,195,391,88,22,167,148,1089,1059,2.34,0.53,2015,16,16.753846153846155,2.341317365269461,525,34,559,0.3488372093023256
2015-16,RegularSeason,201565,58,Derrick Rose,1610612741,CHI,66,2097,447,1048,0.427,44,150,0.293,142,179,0.793,46,179,225,311,44,14,175,84,1080,861,1.78,0.25,2015,16,16.363636363636363,1.7771428571428571,601,37,638,0.35266457680250785
2015-16,RegularSeason,203953,59,Jabari Parker,1610612749,MIL,76,2408,443,899,0.493,9,35,0.257,175,228,0.768,123,272,395,130,69,29,116,154,1070,1068,1.12,0.59,2015,16,14.078947368421053,1.1206896551724137,456,53,509,0.7760314341846758
2015-16,RegularSeason,1626156,60,D'Angelo Russell,1610612747,LAL,80,2259,392,956,0.41,130,370,0.351,140,190,0.737,47,227,274,266,93,13,196,142,1054,890,1.36,0.47,2015,16,13.175,1.3571428571428572,564,50,614,0.44625407166123776
2015-16,RegularSeason,1626164,61,Devin Booker,1610612756,PHX,76,2108,367,867,0.423,99,289,0.343,215,256,0.84,27,160,187,200,44,20,160,225,1048,798,1.25,0.28,2015,16,13.789473684210526,1.25,500,41,541,0.3456561922365989
2015-16,RegularSeason,201587,62,Nicolas Batum,1610612766,CHA,70,2448,372,873,0.426,139,399,0.348,163,192,0.849,55,373,428,403,65,43,205,114,1046,1250,1.97,0.32,2015,16,14.942857142857143,1.9658536585365853,501,29,530,0.8075471698113208
2015-16,RegularSeason,202681,63,Kyrie Irving,1610612739,CLE,53,1667,394,879,0.448,84,262,0.321,169,191,0.885,44,113,157,250,56,18,124,107,1041,891,2.02,0.45,2015,16,19.641509433962263,2.0161290322580645,485,22,507,0.3096646942800789
2015-16,RegularSeason,202355,64,Hassan Whiteside,1610612748,MIA,73,2125,413,682,0.606,0,0,0.0,214,329,0.65,238,627,865,29,44,269,137,201,1040,1726,0.21,0.32,2015,16,14.246575342465754,0.2116788321167883,269,115,384,2.2526041666666665
2015-16,RegularSeason,2216,64,Zach Randolph,1610612763,MEM,68,2016,431,907,0.475,6,26,0.231,172,216,0.796,179,350,529,142,43,13,105,146,1040,1142,1.35,0.41,2015,16,15.294117647058824,1.3523809523809525,476,44,520,1.0173076923076922
2015-16,RegularSeason,202683,66,Enes Freedom,1610612760,OKC,82,1721,414,719,0.576,10,21,0.476,200,251,0.797,249,415,664,33,26,33,115,166,1038,1323,0.29,0.23,2015,16,12.658536585365853,0.28695652173913044,305,51,356,1.8651685393258426
2015-16,RegularSeason,203109,66,Jae Crowder,1610612738,BOS,73,2308,360,813,0.443,122,363,0.336,196,239,0.82,70,303,373,135,126,35,83,198,1038,1128,1.63,1.52,2015,16,14.219178082191782,1.6265060240963856,453,43,496,0.7520161290322581
2015-16,RegularSeason,201568,68,Danilo Gallinari,1610612743,DEN,53,1839,287,700,0.41,87,239,0.364,375,432,0.868,52,229,281,135,42,19,77,87,1036,966,1.75,0.55,2015,16,19.547169811320753,1.7532467532467533,413,57,470,0.597872340425532
2015-16,RegularSeason,201954,69,Darren Collison,1610612758,SAC,74,2219,377,776,0.486,87,217,0.401,194,226,0.858,28,141,169,318,77,4,130,142,1035,1042,2.45,0.59,2015,16,13.986486486486486,2.4461538461538463,399,32,431,0.39211136890951276
2015-16,RegularSeason,204001,70,Kristaps Porzingis,1610612752,NYK,72,2047,373,886,0.421,81,243,0.333,201,240,0.838,132,394,526,94,53,134,121,205,1028,1162,0.78,0.44,2015,16,14.277777777777779,0.7768595041322314,513,39,552,0.9528985507246377
2015-16,RegularSeason,101150,70,Lou Williams,1610612747,LAL,67,1907,283,693,0.408,110,320,0.344,352,424,0.83,31,138,169,167,62,19,107,107,1028,856,1.56,0.58,2015,16,15.343283582089553,1.560747663551402,410,72,482,0.3506224066390041
2015-16,RegularSeason,2772,72,Trevor Ariza,1610612745,HOU,81,2859,357,859,0.416,185,499,0.371,126,161,0.783,67,299,366,188,160,26,113,177,1025,1115,1.66,1.42,2015,16,12.654320987654321,1.663716814159292,502,35,537,0.6815642458100558
2015-16,RegularSeason,202688,73,Brandon Knight,1610612756,PHX,52,1870,371,895,0.415,120,351,0.342,156,183,0.852,36,166,202,263,61,20,177,124,1018,836,1.49,0.34,2015,16,19.576923076923077,1.4858757062146892,524,27,551,0.3666061705989111
2015-16,RegularSeason,201609,73,Goran Dragic,1610612748,MIA,72,2363,417,875,0.477,64,205,0.312,120,165,0.727,54,223,277,419,71,17,185,188,1018,1114,2.27,0.38,2015,16,14.13888888888889,2.264864864864865,458,45,503,0.5506958250497018
2015-16,RegularSeason,202324,75,Derrick Favors,1610612762,UTA,62,1983,418,811,0.515,0,4,0.0,180,254,0.709,169,334,503,94,74,91,104,150,1016,1207,0.9,0.71,2015,16,16.387096774193548,0.9038461538461539,393,74,467,1.077087794432548
2015-16,RegularSeason,101162,76,Marcin Gortat,1610612764,WAS,75,2256,433,764,0.567,0,1,0.0,146,207,0.705,222,519,741,106,47,96,121,193,1012,1489,0.88,0.39,2015,16,13.493333333333334,0.8760330578512396,331,61,392,1.8903061224489797
2015-16,RegularSeason,2547,77,Chris Bosh,1610612748,MIA,53,1778,358,767,0.467,81,222,0.365,213,268,0.795,48,342,390,128,36,34,78,101,1010,1056,1.64,0.46,2015,16,19.056603773584907,1.641025641025641,409,55,464,0.8405172413793104
2015-16,RegularSeason,2207,78,Joe Johnson,1610612748,MIA,81,2703,377,859,0.439,120,313,0.383,118,142,0.831,49,243,292,318,61,4,159,146,992,1002,2.0,0.38,2015,16,12.246913580246913,2.0,482,24,506,0.5770750988142292
2015-16,RegularSeason,201586,79,Serge Ibaka,1610612760,OKC,78,2500,416,869,0.479,60,184,0.326,91,121,0.752,141,392,533,66,38,148,108,211,983,1177,0.61,0.35,2015,16,12.602564102564102,0.6111111111111112,453,30,483,1.10351966873706
2015-16,RegularSeason,201599,80,DeAndre Jordan,1610612746,LAC,77,2598,357,508,0.703,0,1,0.0,266,619,0.43,267,792,1059,90,51,177,107,207,980,1746,0.84,0.48,2015,16,12.727272727272727,0.8411214953271028,151,353,504,2.1011904761904763
2015-16,RegularSeason,202083,81,Wesley Matthews,1610612742,DAL,78,2644,331,854,0.388,189,525,0.36,126,146,0.863,27,211,238,151,78,17,78,179,977,840,1.94,1.0,2015,16,12.525641025641026,1.935897435897436,523,20,543,0.43830570902394106
2015-16,RegularSeason,2730,82,Dwight Howard,1610612745,HOU,71,2280,372,600,0.62,0,6,0.0,232,474,0.489,238,597,835,98,69,113,166,219,976,1455,0.59,0.42,2015,16,13.746478873239436,0.5903614457831325,228,242,470,1.7765957446808511
2015-16,RegularSeason,202397,83,Ish Smith,1610612755,PHI,77,2239,397,967,0.411,56,170,0.329,122,176,0.693,43,262,305,502,88,24,175,133,972,1092,2.87,0.5,2015,16,12.623376623376624,2.8685714285714288,570,54,624,0.48878205128205127
2015-16,RegularSeason,203141,84,Mirza Teletovic,1610612756,PHX,79,1686,332,777,0.427,181,460,0.393,120,155,0.774,55,247,302,89,32,21,84,159,965,845,1.06,0.38,2015,16,12.215189873417721,1.0595238095238095,445,35,480,0.6291666666666667
2015-16,RegularSeason,203078,85,Bradley Beal,1610612764,WAS,55,1708,359,799,0.449,105,271,0.387,135,176,0.767,41,147,188,162,54,11,112,117,958,780,1.45,0.48,2015,16,17.418181818181818,1.4464285714285714,440,41,481,0.3908523908523909
2015-16,RegularSeason,2747,86,JR Smith,1610612739,CLE,77,2362,353,850,0.415,204,510,0.4,45,71,0.634,43,174,217,130,81,21,59,204,955,822,2.2,1.37,2015,16,12.402597402597403,2.2033898305084745,497,26,523,0.4149139579349904
2015-16,RegularSeason,101107,87,Marvin Williams,1610612766,CHA,81,2338,338,747,0.452,152,378,0.402,120,144,0.833,127,394,521,110,58,77,62,133,948,1219,1.77,0.94,2015,16,11.703703703703704,1.7741935483870968,409,24,433,1.2032332563510393
2015-16,RegularSeason,201145,88,Jeff Green,1610612746,LAC,80,2253,354,824,0.43,67,213,0.315,164,220,0.745,74,258,332,138,58,40,93,164,939,888,1.48,0.62,2015,16,11.7375,1.4838709677419355,470,56,526,0.6311787072243346
2015-16,RegularSeason,203914,89,Gary Harris,1610612743,DEN,76,2439,359,765,0.469,105,297,0.354,109,133,0.82,54,166,220,147,97,18,98,143,932,886,1.5,0.99,2015,16,12.263157894736842,1.5,406,24,430,0.5116279069767442
2015-16,RegularSeason,1626143,90,Jahlil Okafor,1610612755,PHI,53,1591,397,781,0.508,1,6,0.167,133,194,0.686,122,251,373,65,22,61,124,140,928,880,0.52,0.18,2015,16,17.50943396226415,0.5241935483870968,384,61,445,0.8382022471910112
2015-16,RegularSeason,203944,91,Julius Randle,1610612747,LAL,81,2286,358,835,0.429,10,36,0.278,193,270,0.715,172,657,829,144,53,29,149,242,919,1271,0.97,0.36,2015,16,11.345679012345679,0.9664429530201343,477,77,554,1.4963898916967509
2015-16,RegularSeason,101114,92,Deron Williams,1610612742,DAL,65,2106,321,775,0.414,97,282,0.344,179,206,0.869,19,171,190,378,61,14,150,155,918,930,2.52,0.41,2015,16,14.123076923076923,2.52,454,27,481,0.39501039501039503
2015-16,RegularSeason,202391,93,Jeremy Lin,1610612766,CHA,78,2048,300,728,0.412,76,226,0.336,238,292,0.815,42,211,253,235,58,42,150,165,914,870,1.57,0.39,2015,16,11.717948717948717,1.5666666666666667,428,54,482,0.524896265560166
2015-16,RegularSeason,2736,94,Luol Deng,1610612748,MIA,74,2394,339,745,0.455,88,256,0.344,145,192,0.755,108,335,443,140,74,29,81,122,911,1063,1.73,0.91,2015,16,12.31081081081081,1.728395061728395,406,47,453,0.977924944812362
2015-16,RegularSeason,201167,95,Arron Afflalo,1610612752,NYK,71,2371,354,799,0.443,91,238,0.382,110,131,0.84,23,243,266,144,25,10,82,142,909,806,1.76,0.3,2015,16,12.80281690140845,1.7560975609756098,445,21,466,0.5708154506437768
2015-16,RegularSeason,201588,96,George Hill,1610612754,IND,74,2524,326,739,0.441,128,314,0.408,114,150,0.76,58,240,298,259,83,17,101,149,894,1001,2.56,0.82,2015,16,12.08108108108108,2.5643564356435644,413,36,449,0.6636971046770601
2015-16,RegularSeason,202711,97,Bojan Bogdanovic,1610612751,BKN,79,2115,324,749,0.433,129,338,0.382,110,132,0.833,36,219,255,99,29,5,115,119,887,713,0.86,0.25,2015,16,11.227848101265822,0.8608695652173913,425,22,447,0.5704697986577181
2015-16,RegularSeason,203471,98,Dennis Schroder,1610612737,ATL,80,1621,329,781,0.421,77,239,0.322,144,182,0.791,25,179,204,349,70,9,183,138,879,838,1.91,0.38,2015,16,10.9875,1.907103825136612,452,38,490,0.4163265306122449
2015-16,RegularSeason,1626144,99,Emmanuel Mudiay,1610612743,DEN,68,2068,329,905,0.364,74,232,0.319,140,209,0.67,32,200,232,372,65,35,217,141,872,714,1.71,0.3,2015,16,12.823529411764707,1.7142857142857142,576,69,645,0.35968992248062015
2015-16,RegularSeason,203145,99,Kent Bazemore,1610612737,ATL,75,2083,320,725,0.441,109,305,0.357,123,151,0.815,28,351,379,171,98,38,138,176,872,987,1.24,0.71,2015,16,11.626666666666667,1.2391304347826086,405,28,433,0.8752886836027713
2015-16,RegularSeason,203490,101,Otto Porter Jr.,1610612764,WAS,75,2276,339,717,0.473,98,267,0.367,95,126,0.754,97,294,391,120,105,32,70,163,871,1040,1.71,1.5,2015,16,11.613333333333333,1.7142857142857142,378,31,409,0.9559902200488998
2015-16,RegularSeason,203498,102,Shabazz Muhammad,1610612750,MIN,82,1682,317,681,0.465,44,152,0.289,185,242,0.764,100,167,267,52,24,7,70,94,863,722,0.74,0.34,2015,16,10.524390243902438,0.7428571428571429,364,57,421,0.6342042755344418
2015-16,RegularSeason,201188,103,Marc Gasol,1610612763,MEM,52,1791,328,707,0.464,2,3,0.667,203,245,0.829,58,304,362,196,50,70,118,141,861,1000,1.66,0.42,2015,16,16.557692307692307,1.6610169491525424,379,42,421,0.8598574821852731
2015-16,RegularSeason,200765,104,Rajon Rondo,1610612758,SAC,72,2537,355,782,0.454,62,170,0.365,87,150,0.58,77,358,435,839,141,10,278,175,859,1516,3.02,0.51,2015,16,11.930555555555555,3.0179856115107913,427,63,490,0.8877551020408163
2015-16,RegularSeason,203496,105,Robert Covington,1610612755,PHI,67,1903,274,712,0.385,170,482,0.353,140,177,0.791,65,354,419,97,105,40,143,232,858,901,0.68,0.73,2015,16,12.805970149253731,0.6783216783216783,438,37,475,0.8821052631578947
2015-16,RegularSeason,201144,106,Mike Conley,1610612763,MEM,56,1761,294,696,0.422,78,215,0.363,191,229,0.834,26,138,164,342,67,16,84,100,857,922,4.07,0.8,2015,16,15.303571428571429,4.071428571428571,402,38,440,0.37272727272727274
2015-16,RegularSeason,2225,106,Tony Parker,1610612759,SAS,72,1980,350,710,0.493,27,65,0.415,130,171,0.76,17,159,176,379,54,11,131,114,857,945,2.89,0.41,2015,16,11.902777777777779,2.8931297709923665,360,41,401,0.4389027431421446
2015-16,RegularSeason,202323,108,Evan Turner,1610612738,BOS,81,2271,343,753,0.456,20,83,0.241,148,179,0.827,50,347,397,359,80,28,169,139,854,1108,2.12,0.47,2015,16,10.54320987654321,2.1242603550295858,410,31,441,0.9002267573696145
2015-16,RegularSeason,203477,109,Isaiah Canaan,1610612755,PHI,77,1966,260,722,0.36,176,485,0.363,150,180,0.833,20,154,174,137,56,12,91,133,846,642,1.5,0.61,2015,16,10.987012987012987,1.5054945054945055,462,30,492,0.35365853658536583
2015-16,RegularSeason,201577,110,Robin Lopez,1610612752,NYK,82,2219,357,662,0.539,0,1,0.0,128,161,0.795,268,334,602,114,16,129,133,182,842,1232,0.86,0.12,2015,16,10.268292682926829,0.8571428571428571,305,33,338,1.7810650887573964
2015-16,RegularSeason,202329,111,Al-Farouq Aminu,1610612757,POR,82,2341,299,719,0.416,126,349,0.361,115,156,0.737,98,401,499,138,72,53,120,171,839,1020,1.15,0.6,2015,16,10.231707317073171,1.15,420,41,461,1.0824295010845988
2015-16,RegularSeason,202718,112,Chandler Parsons,1610612742,DAL,61,1799,320,651,0.492,104,251,0.414,93,136,0.684,29,256,285,169,46,21,95,114,837,889,1.78,0.48,2015,16,13.721311475409836,1.7789473684210526,331,43,374,0.7620320855614974
2015-16,RegularSeason,202702,113,Kenneth Faried,1610612743,DEN,67,1694,349,626,0.558,1,2,0.5,136,222,0.613,235,346,581,79,32,60,91,169,835,1133,0.87,0.35,2015,16,12.462686567164178,0.8681318681318682,277,86,363,1.600550964187328
2015-16,RegularSeason,203096,114,Jared Sullinger,1610612738,BOS,81,1915,351,806,0.435,29,103,0.282,103,161,0.64,194,479,673,187,75,47,102,209,834,1201,1.83,0.73,2015,16,10.296296296296296,1.8333333333333333,455,58,513,1.3118908382066277
2015-16,RegularSeason,203459,115,Allen Crabbe,1610612757,POR,81,2105,311,678,0.459,112,285,0.393,98,113,0.867,27,189,216,99,63,16,64,192,832,780,1.55,0.98,2015,16,10.271604938271604,1.546875,367,15,382,0.5654450261780105
2015-16,RegularSeason,203476,116,Gorgui Dieng,1610612750,MIN,82,2220,308,579,0.532,6,20,0.3,205,248,0.827,157,428,585,143,94,96,140,219,827,1291,1.02,0.67,2015,16,10.085365853658537,1.0214285714285714,271,43,314,1.8630573248407643
2015-16,RegularSeason,201956,117,Omri Casspi,1610612758,SAC,69,1880,299,622,0.481,112,274,0.409,103,159,0.648,58,352,410,95,56,17,94,154,813,918,1.01,0.6,2015,16,11.782608695652174,1.0106382978723405,323,56,379,1.0817941952506596
2015-16,RegularSeason,201196,118,Ramon Sessions,1610612764,WAS,82,1667,280,592,0.473,36,111,0.324,214,283,0.756,25,178,203,239,46,5,115,102,810,807,2.08,0.4,2015,16,9.878048780487806,2.0782608695652174,312,69,381,0.5328083989501312
2015-16,RegularSeason,200826,119,J.J. Barea,1610612742,DAL,74,1667,317,711,0.446,100,260,0.385,74,96,0.771,26,126,152,302,26,2,113,110,808,761,2.67,0.23,2015,16,10.91891891891892,2.672566371681416,394,22,416,0.36538461538461536
2015-16,RegularSeason,203999,120,Nikola Jokic,1610612743,DEN,80,1733,307,600,0.512,28,84,0.333,154,190,0.811,181,379,560,189,79,50,104,208,796,1241,1.82,0.76,2015,16,9.95,1.8173076923076923,293,36,329,1.702127659574468
2015-16,RegularSeason,203901,121,Elfrid Payton,1610612753,ORL,73,2145,318,730,0.436,30,92,0.326,112,190,0.589,77,184,261,467,89,20,177,159,778,948,2.64,0.5,2015,16,10.657534246575343,2.638418079096045,412,78,490,0.5326530612244897
2015-16,RegularSeason,202703,122,Nikola Mirotic,1610612741,CHI,66,1646,248,609,0.407,135,346,0.39,146,181,0.807,58,304,362,100,58,46,102,151,777,845,0.98,0.57,2015,16,11.772727272727273,0.9803921568627451,361,35,396,0.9141414141414141
2015-16,RegularSeason,203084,123,Harrison Barnes,1610612744,GSW,66,2042,295,633,0.466,82,214,0.383,102,134,0.761,77,248,325,117,41,10,57,136,774,840,2.05,0.72,2015,16,11.727272727272727,2.0526315789473686,338,32,370,0.8783783783783784
2015-16,RegularSeason,202685,124,Jonas Valanciunas,1610612761,TOR,60,1557,303,536,0.565,0,0,0.0,162,213,0.761,184,363,547,42,25,80,85,158,768,1093,0.49,0.29,2015,16,12.8,0.49411764705882355,233,51,284,1.926056338028169
2015-16,RegularSeason,101141,125,Ersan Ilyasova,1610612753,ORL,74,1880,280,661,0.424,96,259,0.371,111,154,0.721,144,259,403,67,52,33,71,171,767,827,0.94,0.73,2015,16,10.364864864864865,0.9436619718309859,381,43,424,0.9504716981132075
2015-16,RegularSeason,201937,126,Ricky Rubio,1610612750,MIN,76,2323,219,586,0.374,62,190,0.326,266,314,0.847,40,286,326,658,162,10,193,201,766,1314,3.41,0.84,2015,16,10.078947368421053,3.4093264248704664,367,48,415,0.7855421686746988
2015-16,RegularSeason,202693,127,Markieff Morris,1610612764,WAS,64,1629,305,718,0.425,47,155,0.303,108,147,0.735,73,279,352,124,58,34,135,184,765,746,0.92,0.43,2015,16,11.953125,0.9185185185185185,413,39,452,0.7787610619469026
2015-16,RegularSeason,203926,128,Doug McDermott,1610612741,CHI,81,1861,291,644,0.452,110,259,0.425,72,84,0.857,37,158,195,59,14,6,53,127,764,620,1.11,0.26,2015,16,9.432098765432098,1.1132075471698113,353,12,365,0.5342465753424658
2015-16,RegularSeason,101109,129,Raymond Felton,1610612742,DAL,80,2192,277,682,0.406,60,213,0.282,149,176,0.847,36,222,258,284,68,15,121,141,763,835,2.35,0.56,2015,16,9.5375,2.347107438016529,405,27,432,0.5972222222222222
2015-16,RegularSeason,203079,130,Dion Waiters,1610612760,OKC,78,2152,282,706,0.399,86,240,0.358,112,157,0.713,36,166,202,154,81,15,120,143,762,625,1.28,0.68,2015,16,9.76923076923077,1.2833333333333334,424,45,469,0.43070362473347545
2015-16,RegularSeason,201584,131,Courtney Lee,1610612766,CHA,79,2334,290,639,0.454,82,217,0.378,99,118,0.839,29,176,205,136,85,28,72,134,761,775,1.89,1.18,2015,16,9.632911392405063,1.8888888888888888,349,19,368,0.5570652173913043
2015-16,RegularSeason,203138,132,Hollis Thompson,1610612755,PHI,77,2154,270,680,0.397,149,392,0.38,69,96,0.719,54,218,272,99,36,24,76,187,758,676,1.3,0.47,2015,16,9.844155844155845,1.3026315789473684,410,27,437,0.6224256292906178
2015-16,RegularSeason,2440,132,Matt Barnes,1610612763,MEM,76,2190,264,693,0.381,119,370,0.322,111,138,0.804,84,336,420,163,78,57,121,234,758,899,1.35,0.65,2015,16,9.973684210526315,1.3471074380165289,429,27,456,0.9210526315789473
2015-16,RegularSeason,101139,134,CJ Miles,1610612754,IND,64,1464,259,634,0.409,142,387,0.367,93,124,0.75,25,150,175,63,53,29,70,142,753,597,0.9,0.76,2015,16,11.765625,0.9,375,31,406,0.43103448275862066
2015-16,RegularSeason,201933,135,Blake Griffin,1610612746,LAC,35,1170,301,603,0.499,6,18,0.333,141,194,0.727,51,243,294,170,28,17,83,95,749,820,2.05,0.34,2015,16,21.4,2.0481927710843375,302,53,355,0.828169014084507
2015-16,RegularSeason,203924,135,Jerami Grant,1610612755,PHI,77,2066,251,599,0.419,35,146,0.24,212,322,0.658,99,262,361,135,54,127,110,215,749,858,1.23,0.49,2015,16,9.727272727272727,1.2272727272727273,348,110,458,0.7882096069868996
2015-16,RegularSeason,203486,135,Mason Plumlee,1610612757,POR,82,2084,267,517,0.516,0,4,0.0,215,335,0.642,201,427,628,226,68,85,154,253,749,1232,1.47,0.44,2015,16,9.134146341463415,1.4675324675324675,250,120,370,1.6972972972972973
2015-16,RegularSeason,203457,138,Nerlens Noel,1610612755,PHI,67,1965,306,587,0.521,1,2,0.5,134,227,0.59,154,388,542,122,118,100,158,192,747,1097,0.77,0.75,2015,16,11.149253731343284,0.7721518987341772,281,93,374,1.4491978609625669
2015-16,RegularSeason,202682,139,Derrick Williams,1610612752,NYK,80,1435,254,565,0.45,44,150,0.293,194,256,0.758,47,249,296,75,29,9,61,69,746,721,1.23,0.47,2015,16,9.325,1.2295081967213115,311,62,373,0.7935656836461126
2015-16,RegularSeason,2594,140,Kyle Korver,1610612737,ATL,80,2401,268,617,0.434,158,397,0.398,45,54,0.833,14,246,260,164,60,35,98,161,739,802,1.67,0.61,2015,16,9.2375,1.6734693877551021,349,9,358,0.7262569832402235
2015-16,RegularSeason,203082,141,Terrence Ross,1610612761,TOR,73,1747,270,626,0.431,131,339,0.386,49,62,0.79,21,164,185,56,54,25,46,120,720,625,1.22,1.17,2015,16,9.863013698630137,1.2173913043478262,356,13,369,0.5013550135501355
2015-16,RegularSeason,203932,142,Aaron Gordon,1610612753,ORL,78,1863,274,579,0.473,42,142,0.296,129,193,0.668,154,353,507,128,59,55,66,153,719,1033,1.94,0.89,2015,16,9.217948717948717,1.9393939393939394,305,64,369,1.3739837398373984
2015-16,RegularSeason,203458,143,Alex Len,1610612756,PHX,78,1821,264,624,0.423,1,7,0.143,174,239,0.728,178,416,594,97,38,62,145,230,703,924,0.67,0.26,2015,16,9.012820512820513,0.6689655172413793,360,65,425,1.3976470588235295
2015-16,RegularSeason,201976,144,Patrick Beverley,1610612745,HOU,71,2041,258,594,0.434,124,310,0.4,60,88,0.682,73,177,250,239,94,26,91,234,700,854,2.63,1.03,2015,16,9.859154929577464,2.6263736263736264,336,28,364,0.6868131868131868
2015-16,RegularSeason,201158,145,Marco Belinelli,1610612758,SAC,68,1672,245,635,0.386,91,297,0.306,115,138,0.833,10,107,117,127,37,2,80,91,696,486,1.59,0.46,2015,16,10.235294117647058,1.5875,390,23,413,0.28329297820823246
2015-16,RegularSeason,201988,146,Patty Mills,1610612759,SAS,81,1662,260,612,0.425,123,320,0.384,47,58,0.81,27,131,158,226,59,6,76,102,690,700,2.97,0.78,2015,16,8.518518518518519,2.973684210526316,352,11,363,0.43526170798898073
2015-16,RegularSeason,203482,147,Kelly Olynyk,1610612738,BOS,69,1395,253,556,0.455,85,210,0.405,96,128,0.75,72,209,281,105,52,33,74,163,687,749,1.42,0.7,2015,16,9.956521739130435,1.4189189189189189,303,32,335,0.8388059701492537
2015-16,RegularSeason,201569,148,Eric Gordon,1610612740,NOP,45,1481,231,552,0.418,113,294,0.384,111,125,0.888,10,89,99,121,43,14,73,98,686,555,1.66,0.59,2015,16,15.244444444444444,1.6575342465753424,321,14,335,0.2955223880597015
2015-16,RegularSeason,203504,149,Trey Burke,1610612762,UTA,64,1366,262,634,0.413,88,256,0.344,67,82,0.817,18,94,112,148,35,6,80,86,679,513,1.85,0.44,2015,16,10.609375,1.85,372,15,387,0.28940568475452194
2015-16,RegularSeason,202709,150,Cory Joseph,1610612761,TOR,80,2046,257,585,0.439,30,110,0.273,133,174,0.764,39,171,210,250,63,20,102,131,677,749,2.45,0.62,2015,16,8.4625,2.450980392156863,328,41,369,0.5691056910569106
2015-16,RegularSeason,2449,151,Luis Scola,1610612761,TOR,76,1636,269,598,0.45,65,161,0.404,61,84,0.726,84,276,360,66,46,27,68,178,664,743,0.97,0.68,2015,16,8.736842105263158,0.9705882352941176,329,23,352,1.0227272727272727
2015-16,RegularSeason,101133,152,Ian Mahinmi,1610612754,IND,71,1816,264,448,0.589,0,0,0.0,132,225,0.587,138,369,507,104,65,75,100,220,660,1034,1.04,0.65,2015,16,9.295774647887324,1.04,184,93,277,1.8303249097472925
2015-16,RegularSeason,200782,153,P.J. Tucker,1610612756,PHX,82,2540,239,582,0.411,68,206,0.33,106,142,0.746,165,347,512,177,106,20,111,202,652,977,1.59,0.95,2015,16,7.951219512195122,1.5945945945945945,343,36,379,1.3509234828496042
2015-16,RegularSeason,2585,154,Zaza Pachulia,1610612742,DAL,76,2004,219,470,0.466,0,3,0.0,212,276,0.768,249,469,718,128,64,22,119,181,650,1148,1.08,0.54,2015,16,8.552631578947368,1.0756302521008403,251,64,315,2.2793650793650793
2015-16,RegularSeason,201941,155,Jordan Hill,1610612754,IND,73,1513,278,549,0.506,0,1,0.0,89,125,0.712,156,295,451,87,36,37,92,155,645,857,0.95,0.39,2015,16,8.835616438356164,0.9456521739130435,271,36,307,1.4690553745928339
2015-16,RegularSeason,202684,156,Tristan Thompson,1610612739,CLE,82,2269,247,420,0.588,0,0,0.0,149,242,0.616,268,470,738,62,38,51,61,202,643,1205,1.02,0.62,2015,16,7.841463414634147,1.0163934426229508,173,93,266,2.774436090225564
2015-16,RegularSeason,203469,157,Cody Zeller,1610612766,CHA,73,1774,231,437,0.529,1,10,0.1,175,232,0.754,138,317,455,71,57,63,68,204,638,953,1.04,0.84,2015,16,8.73972602739726,1.0441176470588236,206,57,263,1.7300380228136882
2015-16,RegularSeason,201162,157,Jared Dudley,1610612764,WAS,81,2098,233,487,0.478,100,238,0.42,72,98,0.735,54,232,286,171,75,18,80,190,638,828,2.14,0.94,2015,16,7.8765432098765435,2.1375,254,26,280,1.0214285714285714
2015-16,RegularSeason,203500,159,Steven Adams,1610612760,OKC,80,2014,261,426,0.613,0,0,0.0,114,196,0.582,219,314,533,62,42,89,84,223,636,1031,0.74,0.5,2015,16,7.95,0.7380952380952381,165,82,247,2.1578947368421053
2015-16,RegularSeason,202339,160,Eric Bledsoe,1610612756,PHX,31,1059,223,492,0.453,48,129,0.372,138,172,0.802,18,107,125,190,63,19,110,75,632,616,1.73,0.57,2015,16,20.387096774193548,1.7272727272727273,269,34,303,0.41254125412541254
2015-16,RegularSeason,201596,161,Mario Chalmers,1610612748,MIA,61,1373,182,444,0.41,46,149,0.309,218,262,0.832,24,133,157,230,88,13,110,181,628,700,2.09,0.8,2015,16,10.295081967213115,2.090909090909091,262,44,306,0.5130718954248366
2015-16,RegularSeason,201959,162,Taj Gibson,1610612741,CHI,73,1936,263,500,0.526,0,3,0.0,101,146,0.692,206,298,504,106,47,77,78,180,627,1001,1.36,0.6,2015,16,8.58904109589041,1.358974358974359,237,45,282,1.7872340425531914
2015-16,RegularSeason,204038,163,Langston Galloway,1610612752,NYK,82,2033,231,588,0.393,77,224,0.344,86,114,0.754,43,245,288,207,77,22,61,177,625,773,3.39,1.26,2015,16,7.621951219512195,3.3934426229508197,357,28,385,0.7480519480519481
2015-16,RegularSeason,201945,164,Gerald Henderson,1610612757,POR,72,1431,232,529,0.439,48,136,0.353,112,146,0.767,30,181,211,75,39,19,68,87,624,569,1.1,0.57,2015,16,8.666666666666666,1.1029411764705883,297,34,331,0.6374622356495468
2015-16,RegularSeason,203487,165,Michael Carter-Williams,1610612749,MIL,54,1649,251,555,0.452,15,55,0.273,106,162,0.654,48,228,276,281,80,41,153,162,623,788,1.84,0.52,2015,16,11.537037037037036,1.8366013071895424,304,56,360,0.7666666666666667
2015-16,RegularSeason,1626167,166,Myles Turner,1610612754,IND,60,1367,264,530,0.498,3,14,0.214,88,121,0.727,68,264,332,41,25,86,67,158,619,737,0.61,0.37,2015,16,10.316666666666666,0.6119402985074627,266,33,299,1.1103678929765886
2015-16,RegularSeason,203917,167,Nik Stauskas,1610612755,PHI,73,1809,210,545,0.385,106,325,0.326,91,118,0.771,23,160,183,138,44,20,94,115,617,546,1.47,0.47,2015,16,8.452054794520548,1.4680851063829787,335,27,362,0.505524861878453
2015-16,RegularSeason,101123,168,Gerald Green,1610612748,MIA,69,1557,230,587,0.392,84,260,0.323,72,92,0.783,25,138,163,56,38,19,46,123,616,469,1.22,0.83,2015,16,8.927536231884059,1.2173913043478262,357,20,377,0.4323607427055703
2015-16,RegularSeason,1626163,169,Frank Kaminsky,1610612766,CHA,81,1708,215,525,0.41,68,202,0.337,108,148,0.73,69,266,335,98,38,43,58,126,606,712,1.69,0.66,2015,16,7.481481481481482,1.6896551724137931,310,40,350,0.9571428571428572
2015-16,RegularSeason,203085,170,Austin Rivers,1610612746,LAC,67,1464,226,516,0.438,62,185,0.335,79,116,0.681,22,108,130,99,48,9,61,137,593,491,1.62,0.79,2015,16,8.850746268656716,1.6229508196721312,290,37,327,0.39755351681957185
2015-16,RegularSeason,1626169,170,Stanley Johnson,1610612765,DET,73,1687,225,600,0.375,63,205,0.307,80,102,0.784,58,248,306,118,55,12,114,178,593,573,1.03,0.48,2015,16,8.123287671232877,1.0350877192982457,375,22,397,0.7707808564231738
2015-16,RegularSeason,201147,172,Corey Brewer,1610612745,HOU,82,1669,212,552,0.384,61,224,0.272,105,140,0.75,42,157,199,109,84,19,78,168,590,548,1.4,1.08,2015,16,7.195121951219512,1.3974358974358974,340,35,375,0.5306666666666666
2015-16,RegularSeason,201977,172,Marcus Thornton,1610612764,WAS,61,1108,216,542,0.399,91,270,0.337,67,79,0.848,38,112,150,84,47,4,51,90,590,486,1.65,0.92,2015,16,9.672131147540984,1.6470588235294117,326,12,338,0.4437869822485207
2015-16,RegularSeason,201961,174,Wayne Ellington,1610612751,BKN,76,1615,218,561,0.389,96,268,0.358,54,63,0.857,20,154,174,83,48,5,45,82,586,499,1.84,1.07,2015,16,7.7105263157894735,1.8444444444444446,343,9,352,0.4943181818181818
2015-16,RegularSeason,202066,175,Garrett Temple,1610612764,WAS,80,1951,201,505,0.398,89,258,0.345,91,125,0.728,36,176,212,140,69,18,64,195,582,619,2.19,1.08,2015,16,7.275,2.1875,304,34,338,0.6272189349112426
2015-16,RegularSeason,203087,176,Jeremy Lamb,1610612766,CHA,66,1227,230,510,0.451,56,181,0.309,64,88,0.727,44,208,252,77,42,30,50,105,580,627,1.54,0.84,2015,16,8.787878787878787,1.54,280,24,304,0.8289473684210527
2015-16,RegularSeason,203210,177,JaMychal Green,1610612763,MEM,78,1446,230,495,0.465,15,45,0.333,103,137,0.752,139,234,373,67,46,33,83,189,578,715,0.81,0.55,2015,16,7.410256410256411,0.8072289156626506,265,34,299,1.2474916387959867
2015-16,RegularSeason,101161,178,Amir Johnson,1610612738,BOS,79,1800,249,426,0.585,10,43,0.233,69,121,0.57,178,327,505,138,52,83,94,214,577,1032,1.47,0.55,2015,16,7.30379746835443,1.4680851063829787,177,52,229,2.2052401746724892
2015-16,RegularSeason,202362,179,Lance Stephenson,1610612763,MEM,69,1372,228,474,0.481,30,78,0.385,87,111,0.784,40,183,223,133,43,9,94,135,573,617,1.42,0.46,2015,16,8.304347826086957,1.4148936170212767,246,24,270,0.825925925925926
2015-16,RegularSeason,201980,180,Danny Green,1610612759,SAS,79,2062,211,561,0.376,116,349,0.332,34,46,0.739,48,255,303,141,79,64,75,141,572,722,1.88,1.05,2015,16,7.2405063291139244,1.88,350,12,362,0.8370165745856354
2015-16,RegularSeason,203521,181,Matthew Dellavedova,1610612739,CLE,76,1867,207,511,0.405,98,239,0.41,57,66,0.864,33,129,162,337,44,9,116,178,569,692,2.9,0.38,2015,16,7.4868421052631575,2.9051724137931036,304,9,313,0.5175718849840255
2015-16,RegularSeason,202720,182,Jon Leuer,1610612756,PHX,67,1255,224,466,0.481,42,110,0.382,77,101,0.762,76,297,373,72,38,30,75,125,567,739,0.96,0.51,2015,16,8.462686567164178,0.96,242,24,266,1.4022556390977443
2015-16,RegularSeason,203499,183,Shane Larkin,1610612751,BKN,78,1751,222,502,0.442,39,108,0.361,83,107,0.776,28,152,180,342,95,12,146,121,566,745,2.34,0.65,2015,16,7.256410256410256,2.3424657534246576,280,24,304,0.5921052631578947
2015-16,RegularSeason,2744,184,Al Jefferson,1610612766,CHA,47,1096,245,505,0.485,0,0,0.0,72,111,0.649,57,244,301,70,30,41,34,117,562,671,2.06,0.88,2015,16,11.957446808510639,2.0588235294117645,260,39,299,1.0066889632107023
2015-16,RegularSeason,203935,185,Marcus Smart,1610612738,BOS,61,1667,184,529,0.348,61,241,0.253,129,166,0.777,76,179,255,185,91,18,80,183,558,645,2.31,1.14,2015,16,9.147540983606557,2.3125,345,37,382,0.6675392670157068
2015-16,RegularSeason,203497,186,Rudy Gobert,1610612762,UTA,61,1932,198,354,0.559,0,0,0.0,161,283,0.569,208,460,668,91,45,135,114,163,557,1104,0.8,0.4,2015,16,9.131147540983607,0.7982456140350878,156,122,278,2.402877697841727
2015-16,RegularSeason,1938,187,Manu Ginobili,1610612759,SAS,58,1134,197,435,0.453,70,179,0.391,91,112,0.813,26,120,146,177,66,11,99,99,555,597,1.79,0.67,2015,16,9.568965517241379,1.7878787878787878,238,21,259,0.5637065637065637
2015-16,RegularSeason,2561,188,David West,1610612759,SAS,78,1404,244,448,0.545,3,7,0.429,63,80,0.788,72,237,309,143,44,55,68,142,554,816,2.1,0.65,2015,16,7.102564102564102,2.1029411764705883,204,17,221,1.3981900452488687
2015-16,RegularSeason,202325,189,Wesley Johnson,1610612746,LAC,80,1666,208,515,0.404,103,309,0.333,30,46,0.652,37,211,248,49,89,56,54,173,549,614,0.91,1.65,2015,16,6.8625,0.9074074074074074,307,16,323,0.7678018575851393
2015-16,RegularSeason,201160,190,Jason Smith,1610612753,ORL,76,1181,244,503,0.485,4,16,0.25,54,67,0.806,53,166,219,62,33,65,57,163,546,596,1.09,0.58,2015,16,7.184210526315789,1.087719298245614,259,13,272,0.8051470588235294
2015-16,RegularSeason,101181,191,Jose Calderon,1610612752,NYK,72,2024,209,455,0.459,84,203,0.414,42,48,0.875,22,207,229,298,63,7,87,135,544,802,3.42,0.72,2015,16,7.555555555555555,3.425287356321839,246,6,252,0.9087301587301587
2015-16,RegularSeason,202335,192,Patrick Patterson,1610612761,TOR,79,2020,204,493,0.414,106,293,0.362,29,34,0.853,77,265,342,94,53,32,65,128,543,705,1.45,0.81,2015,16,6.8734177215189876,1.4461538461538461,289,5,294,1.163265306122449
2015-16,RegularSeason,203991,193,Clint Capela,1610612745,HOU,77,1471,231,397,0.582,0,1,0.0,80,211,0.379,194,300,494,47,59,92,60,190,542,877,0.78,0.98,2015,16,7.038961038961039,0.7833333333333333,166,131,297,1.6632996632996633
2015-16,RegularSeason,201573,194,Jerryd Bayless,1610612749,MIL,52,1505,185,437,0.423,101,231,0.437,70,90,0.778,21,120,141,163,47,11,73,111,541,558,2.23,0.64,2015,16,10.403846153846153,2.232876712328767,252,20,272,0.5183823529411765
2015-16,RegularSeason,2754,195,Tony Allen,1610612763,MEM,64,1620,215,469,0.458,15,42,0.357,90,138,0.652,104,192,296,70,110,18,78,175,535,649,0.9,1.41,2015,16,8.359375,0.8974358974358975,254,48,302,0.9801324503311258
2015-16,RegularSeason,203463,196,Ben McLemore,1610612758,SAC,68,1443,195,455,0.429,67,185,0.362,74,103,0.718,34,114,148,79,52,10,99,140,531,432,0.8,0.53,2015,16,7.8088235294117645,0.797979797979798,260,29,289,0.5121107266435986
2015-16,RegularSeason,201962,196,Toney Douglas,1610612740,NOP,61,1262,183,445,0.411,81,203,0.399,84,99,0.848,25,118,143,157,70,5,64,131,531,565,2.45,1.09,2015,16,8.704918032786885,2.453125,262,15,277,0.516245487364621
2015-16,RegularSeason,201585,198,Kosta Koufos,1610612758,SAC,78,1482,236,444,0.532,0,0,0.0,57,104,0.548,169,254,423,33,40,70,48,185,529,792,0.69,0.83,2015,16,6.782051282051282,0.6875,208,47,255,1.6588235294117648
2015-16,RegularSeason,201589,199,Darrell Arthur,1610612743,DEN,70,1516,221,489,0.452,45,117,0.385,40,53,0.755,86,207,293,96,53,48,66,185,527,670,1.46,0.8,2015,16,7.5285714285714285,1.4545454545454546,268,13,281,1.0427046263345197
2015-16,RegularSeason,202334,200,Ed Davis,1610612757,POR,81,1684,206,337,0.611,0,0,0.0,114,204,0.559,224,375,599,88,57,72,64,202,526,1057,1.38,0.89,2015,16,6.493827160493828,1.375,131,90,221,2.7104072398190047
2015-16,RegularSeason,2403,201,Nene,1610612764,WAS,57,1094,209,384,0.544,0,3,0.0,107,185,0.578,52,207,259,97,54,26,76,156,525,632,1.28,0.71,2015,16,9.210526315789474,1.2763157894736843,175,78,253,1.023715415019763
2015-16,RegularSeason,1495,202,Tim Duncan,1610612759,SAS,61,1536,215,441,0.488,0,2,0.0,92,131,0.702,115,332,447,163,47,78,90,125,522,902,1.81,0.52,2015,16,8.557377049180328,1.8111111111111111,226,39,265,1.6867924528301887
2015-16,RegularSeason,201155,203,Rodney Stuckey,1610612754,IND,58,1275,183,443,0.413,20,83,0.241,131,158,0.829,19,137,156,142,43,8,76,77,517,503,1.87,0.57,2015,16,8.913793103448276,1.868421052631579,260,27,287,0.5435540069686411
2015-16,RegularSeason,203933,204,T.J. Warren,1610612756,PHX,47,1070,221,441,0.501,28,70,0.4,45,64,0.703,57,90,147,44,37,16,32,94,515,488,1.38,1.16,2015,16,10.957446808510639,1.375,220,19,239,0.6150627615062761
2015-16,RegularSeason,203382,205,Aron Baynes,1610612765,DET,81,1233,194,384,0.505,0,2,0.0,126,165,0.764,140,244,384,51,21,52,67,151,514,726,0.76,0.31,2015,16,6.345679012345679,0.7611940298507462,190,39,229,1.6768558951965065
2015-16,RegularSeason,2755,205,Kevin Martin,1610612759,SAS,55,1095,156,419,0.372,49,136,0.36,153,172,0.89,14,96,110,58,26,3,54,83,514,375,1.07,0.48,2015,16,9.345454545454546,1.0740740740740742,263,19,282,0.3900709219858156
2015-16,RegularSeason,201578,207,Marreese Speights,1610612744,GSW,72,832,197,456,0.432,24,62,0.387,94,114,0.825,77,162,239,61,19,34,66,117,512,520,0.92,0.29,2015,16,7.111111111111111,0.9242424242424242,259,20,279,0.8566308243727598
2015-16,RegularSeason,203086,208,Meyers Leonard,1610612757,POR,61,1333,195,435,0.448,86,228,0.377,35,46,0.761,51,263,314,92,8,18,77,183,511,615,1.2,0.1,2015,16,8.37704918032787,1.1948051948051948,240,11,251,1.250996015936255
2015-16,RegularSeason,203462,209,Archie Goodwin,1610612756,PHX,57,1114,176,422,0.417,23,99,0.232,130,193,0.674,27,115,142,118,27,13,100,84,505,396,1.18,0.27,2015,16,8.859649122807017,1.18,246,63,309,0.459546925566343
2015-16,RegularSeason,1626159,210,Justise Winslow,1610612748,MIA,78,2232,195,462,0.422,32,116,0.276,80,117,0.684,81,322,403,118,68,26,95,184,502,718,1.24,0.72,2015,16,6.435897435897436,1.2421052631578948,267,37,304,1.325657894736842
2015-16,RegularSeason,203090,211,Maurice Harkless,1610612757,POR,78,1457,195,411,0.474,39,140,0.279,69,111,0.622,101,179,280,67,49,35,62,124,498,609,1.08,0.79,2015,16,6.384615384615385,1.0806451612903225,216,42,258,1.0852713178294573
2015-16,RegularSeason,204456,212,T.J. McConnell,1610612755,PHI,81,1606,218,464,0.47,31,89,0.348,26,41,0.634,43,207,250,367,95,10,140,114,493,814,2.62,0.68,2015,16,6.08641975308642,2.6214285714285714,246,15,261,0.9578544061302682
2015-16,RegularSeason,201166,213,Aaron Brooks,1610612741,CHI,69,1108,188,469,0.401,66,185,0.357,49,64,0.766,21,80,101,180,30,10,82,132,491,434,2.19,0.37,2015,16,7.115942028985507,2.1951219512195124,281,15,296,0.34121621621621623
2015-16,RegularSeason,2733,214,Shaun Livingston,1610612744,GSW,78,1520,203,379,0.536,2,12,0.167,80,93,0.86,42,127,169,237,57,27,78,140,488,711,3.04,0.73,2015,16,6.256410256410256,3.0384615384615383,176,13,189,0.8941798941798942
2015-16,RegularSeason,1626168,214,Trey Lyles,1610612762,UTA,80,1382,191,436,0.438,49,128,0.383,57,82,0.695,59,240,299,59,26,18,65,114,488,555,0.91,0.4,2015,16,6.1,0.9076923076923077,245,25,270,1.1074074074074074
2015-16,RegularSeason,2734,216,Devin Harris,1610612742,DAL,64,1280,167,374,0.447,52,158,0.329,101,140,0.721,18,120,138,118,60,13,66,124,487,504,1.79,0.91,2015,16,7.609375,1.7878787878787878,207,39,246,0.5609756097560976
2015-16,RegularSeason,2564,217,Boris Diaw,1610612759,SAS,76,1386,202,383,0.527,25,69,0.362,56,76,0.737,58,175,233,176,26,21,97,102,485,643,1.81,0.27,2015,16,6.381578947368421,1.8144329896907216,181,20,201,1.1592039800995024
2015-16,RegularSeason,201967,218,Dante Cunningham,1610612740,NOP,80,1971,186,412,0.451,55,174,0.316,57,82,0.695,57,179,236,77,42,33,41,173,484,580,1.88,1.02,2015,16,6.05,1.8780487804878048,226,25,251,0.9402390438247012
2015-16,RegularSeason,202498,218,Lance Thomas,1610612752,NYK,59,1313,169,382,0.442,44,109,0.404,102,119,0.857,34,97,131,53,22,7,57,109,484,410,0.93,0.39,2015,16,8.203389830508474,0.9298245614035088,213,17,230,0.5695652173913044
2015-16,RegularSeason,201579,220,Roy Hibbert,1610612747,LAL,81,1878,182,411,0.443,0,2,0.0,117,145,0.807,132,266,398,95,32,110,76,252,481,783,1.25,0.42,2015,16,5.938271604938271,1.25,229,28,257,1.54863813229572
2015-16,RegularSeason,200757,221,Thabo Sefolosha,1610612737,ATL,75,1758,188,371,0.507,42,123,0.341,62,99,0.626,52,282,334,107,85,37,68,109,480,755,1.57,1.25,2015,16,6.4,1.5735294117647058,183,37,220,1.518181818181818
2015-16,RegularSeason,1626209,222,Mario Hezonja,1610612753,ORL,79,1413,181,418,0.433,67,192,0.349,49,54,0.907,28,148,176,109,39,17,97,124,478,480,1.12,0.4,2015,16,6.050632911392405,1.1237113402061856,237,5,242,0.7272727272727273
2015-16,RegularSeason,202708,223,Norris Cole,1610612740,NOP,45,1198,196,484,0.405,33,102,0.324,52,65,0.8,10,141,151,167,37,5,75,102,477,461,2.23,0.49,2015,16,10.6,2.2266666666666666,288,13,301,0.5016611295681063
2015-16,RegularSeason,203526,224,Raul Neto,1610612762,UTA,81,1499,180,418,0.431,64,162,0.395,52,70,0.743,17,103,120,174,62,2,109,122,476,469,1.6,0.57,2015,16,5.8765432098765435,1.5963302752293578,238,18,256,0.46875
2015-16,RegularSeason,202389,225,Timofey Mozgov,1610612739,CLE,76,1326,203,359,0.565,1,7,0.143,68,95,0.716,110,227,337,33,22,57,71,159,475,670,0.47,0.31,2015,16,6.25,0.4647887323943662,156,27,183,1.8415300546448088
2015-16,RegularSeason,200751,226,Randy Foye,1610612760,OKC,81,1642,169,482,0.351,75,250,0.3,61,74,0.824,24,132,156,161,39,29,86,131,474,447,1.87,0.45,2015,16,5.851851851851852,1.872093023255814,313,13,326,0.4785276073619632
2015-16,RegularSeason,101138,227,Brandon Bass,1610612747,LAL,66,1342,174,317,0.549,0,2,0.0,125,148,0.845,104,181,285,74,33,55,42,125,473,712,1.76,0.79,2015,16,7.166666666666667,1.7619047619047619,143,23,166,1.716867469879518
2015-16,RegularSeason,2199,228,Tyson Chandler,1610612756,PHX,66,1618,183,314,0.583,0,1,0.0,106,171,0.62,175,401,576,64,36,44,93,145,472,903,0.69,0.39,2015,16,7.151515151515151,0.6881720430107527,131,65,196,2.938775510204082
2015-16,RegularSeason,201571,229,D.J. Augustin,1610612743,DEN,62,1178,148,350,0.423,68,168,0.405,103,128,0.805,8,87,95,198,38,4,84,85,467,491,2.36,0.45,2015,16,7.532258064516129,2.357142857142857,202,25,227,0.4185022026431718
2015-16,RegularSeason,203530,230,Joffrey Lauvergne,1610612743,DEN,59,1041,195,380,0.513,13,53,0.245,62,69,0.899,77,213,290,56,13,15,54,115,465,593,1.04,0.24,2015,16,7.88135593220339,1.037037037037037,185,7,192,1.5104166666666667
2015-16,RegularSeason,203118,231,Mike Scott,1610612737,ATL,75,1146,176,376,0.468,62,158,0.392,50,63,0.794,53,153,206,78,25,17,42,102,464,535,1.86,0.59,2015,16,6.1866666666666665,1.8571428571428572,200,13,213,0.9671361502347418
2015-16,RegularSeason,202344,232,Trevor Booker,1610612762,UTA,79,1632,190,388,0.49,12,41,0.293,71,106,0.67,166,286,452,83,59,41,81,169,463,784,1.02,0.73,2015,16,5.860759493670886,1.0246913580246915,198,35,233,1.9399141630901287
2015-16,RegularSeason,1626161,232,Willie Cauley-Stein,1610612758,SAC,66,1412,191,339,0.563,0,2,0.0,81,125,0.648,134,218,352,37,47,66,46,146,463,727,0.8,1.02,2015,16,7.015151515151516,0.8043478260869565,148,44,192,1.8333333333333333
2015-16,RegularSeason,2738,234,Andre Iguodala,1610612744,GSW,65,1732,176,368,0.478,54,154,0.351,51,83,0.614,52,211,263,219,73,19,79,102,457,728,2.77,0.92,2015,16,7.030769230769231,2.7721518987341773,192,32,224,1.1741071428571428
2015-16,RegularSeason,202687,235,Bismack Biyombo,1610612761,TOR,82,1808,156,288,0.542,0,1,0.0,142,226,0.628,182,473,655,29,19,133,71,225,454,1003,0.41,0.27,2015,16,5.536585365853658,0.4084507042253521,132,84,216,3.0324074074074074
2015-16,RegularSeason,202714,236,Shelvin Mack,1610612762,UTA,52,1058,182,415,0.439,39,125,0.312,45,61,0.738,13,115,128,187,34,3,95,72,448,456,1.97,0.36,2015,16,8.615384615384615,1.9684210526315788,233,16,249,0.5140562248995983
2015-16,RegularSeason,202734,237,E'Twaun Moore,1610612741,CHI,59,1263,187,389,0.481,47,104,0.452,22,35,0.629,19,114,133,99,37,18,53,103,443,462,1.87,0.7,2015,16,7.508474576271187,1.8679245283018868,202,13,215,0.6186046511627907
2015-16,RegularSeason,1626171,238,Bobby Portis,1610612741,CHI,62,1102,186,436,0.427,16,52,0.308,48,66,0.727,123,214,337,52,25,22,54,100,436,550,0.96,0.46,2015,16,7.032258064516129,0.9629629629629629,250,18,268,1.257462686567164
2015-16,RegularSeason,203093,239,Terrence Jones,1610612745,HOU,50,1044,166,367,0.452,25,79,0.316,77,116,0.664,62,149,211,41,23,39,49,86,434,459,0.84,0.47,2015,16,8.68,0.8367346938775511,201,39,240,0.8791666666666667
2015-16,RegularSeason,2571,240,Leandro Barbosa,1610612744,GSW,68,1079,171,370,0.462,39,110,0.355,52,62,0.839,28,89,117,82,44,10,53,107,433,424,1.55,0.83,2015,16,6.367647058823529,1.5471698113207548,199,10,209,0.5598086124401914
2015-16,RegularSeason,202730,241,Lavoy Allen,1610612754,IND,79,1599,191,370,0.516,0,0,0.0,46,73,0.63,162,262,424,76,26,42,69,147,428,721,1.1,0.38,2015,16,5.417721518987341,1.1014492753623188,179,27,206,2.058252427184466
2015-16,RegularSeason,101135,242,David Lee,1610612742,DAL,55,903,178,335,0.531,0,1,0.0,71,93,0.763,101,204,305,84,22,28,66,114,427,621,1.27,0.33,2015,16,7.763636363636364,1.2727272727272727,157,22,179,1.7039106145251397
2015-16,RegularSeason,1626170,243,Jerian Grant,1610612752,NYK,76,1265,154,391,0.394,22,100,0.22,96,123,0.78,23,120,143,177,50,10,87,97,426,455,2.03,0.57,2015,16,5.605263157894737,2.0344827586206895,237,27,264,0.5416666666666666
2015-16,RegularSeason,101112,244,Channing Frye,1610612739,CLE,70,1199,152,347,0.438,91,235,0.387,30,35,0.857,35,199,234,71,29,28,43,127,425,544,1.65,0.67,2015,16,6.071428571428571,1.6511627906976745,195,5,200,1.17
2015-16,RegularSeason,202388,245,Donald Sloan,1610612751,BKN,61,1318,154,350,0.44,38,99,0.384,78,104,0.75,17,156,173,268,32,4,80,73,424,599,3.35,0.4,2015,16,6.950819672131147,3.35,196,26,222,0.7792792792792793
2015-16,RegularSeason,1891,246,Jason Terry,1610612745,HOU,72,1258,151,376,0.402,93,261,0.356,27,33,0.818,14,65,79,103,47,9,49,91,422,380,2.1,0.96,2015,16,5.861111111111111,2.1020408163265305,225,6,231,0.341991341991342
2015-16,RegularSeason,1718,247,Paul Pierce,1610612746,LAC,68,1231,144,397,0.363,75,242,0.31,54,66,0.818,12,174,186,71,33,17,58,129,417,401,1.22,0.57,2015,16,6.132352941176471,1.2241379310344827,253,12,265,0.7018867924528301
2015-16,RegularSeason,202692,248,Alec Burks,1610612762,UTA,31,797,137,334,0.41,32,79,0.405,106,141,0.752,16,93,109,63,18,4,51,71,412,323,1.24,0.35,2015,16,13.290322580645162,1.2352941176470589,197,35,232,0.4698275862068966
2015-16,RegularSeason,101127,249,Jarrett Jack,1610612751,BKN,32,1027,140,358,0.391,31,102,0.304,100,112,0.893,9,127,136,236,34,7,94,77,411,500,2.51,0.36,2015,16,12.84375,2.5106382978723403,218,12,230,0.591304347826087
2015-16,RegularSeason,203798,250,PJ Hairston,1610612763,MEM,66,1313,145,408,0.355,70,241,0.29,50,64,0.781,25,149,174,38,32,11,41,137,410,347,0.93,0.78,2015,16,6.212121212121212,0.926829268292683,263,14,277,0.628158844765343
2015-16,RegularSeason,2210,250,Richard Jefferson,1610612739,CLE,74,1326,143,312,0.458,66,173,0.382,58,87,0.667,15,113,128,59,33,14,43,129,410,403,1.37,0.77,2015,16,5.54054054054054,1.372093023255814,169,29,198,0.6464646464646465
2015-16,RegularSeason,203939,252,Dwight Powell,1610612742,DAL,69,992,146,296,0.493,2,16,0.125,105,142,0.739,84,189,273,44,36,24,40,118,399,549,1.1,0.9,2015,16,5.782608695652174,1.1,150,37,187,1.4598930481283423
2015-16,RegularSeason,203089,253,John Henson,1610612749,MIL,57,960,164,291,0.564,0,1,0.0,69,117,0.59,87,134,221,54,18,109,64,131,397,560,0.84,0.28,2015,16,6.964912280701754,0.84375,127,48,175,1.262857142857143
2015-16,RegularSeason,1713,254,Vince Carter,1610612763,MEM,60,1005,133,343,0.388,59,169,0.349,70,84,0.833,31,115,146,56,38,16,35,101,395,392,1.6,1.09,2015,16,6.583333333333333,1.6,210,14,224,0.6517857142857143
2015-16,RegularSeason,201156,255,Nick Young,1610612747,LAL,54,1033,126,372,0.339,77,237,0.325,63,76,0.829,14,83,97,34,23,7,30,50,392,264,1.13,0.77,2015,16,7.2592592592592595,1.1333333333333333,246,13,259,0.3745173745173745
2015-16,RegularSeason,202390,256,Gary Neal,1610612764,WAS,40,807,151,325,0.465,41,100,0.41,47,55,0.855,11,72,83,47,20,1,29,55,390,330,1.62,0.69,2015,16,9.75,1.6206896551724137,174,8,182,0.45604395604395603
2015-16,RegularSeason,203094,257,Andrew Nicholson,1610612753,ORL,56,823,146,310,0.471,41,114,0.36,51,65,0.785,34,167,201,25,10,22,41,69,384,423,0.61,0.24,2015,16,6.857142857142857,0.6097560975609756,164,14,178,1.1292134831460674
2015-16,RegularSeason,201229,258,Anthony Tolliver,1610612765,DET,72,1341,128,332,0.386,98,272,0.36,29,47,0.617,39,190,229,52,26,16,28,86,383,456,1.86,0.93,2015,16,5.319444444444445,1.8571428571428572,204,18,222,1.0315315315315314
2015-16,RegularSeason,201627,259,Anthony Morrow,1610612760,OKC,68,926,136,333,0.408,79,204,0.387,29,39,0.744,10,52,62,24,22,5,17,64,380,269,1.41,1.29,2015,16,5.588235294117647,1.411764705882353,197,10,207,0.2995169082125604
2015-16,RegularSeason,201936,260,Tyreke Evans,1610612740,NOP,25,765,136,314,0.433,33,85,0.388,74,93,0.796,20,109,129,164,32,8,73,66,379,442,2.25,0.44,2015,16,15.16,2.2465753424657535,178,19,197,0.6548223350253807
2015-16,RegularSeason,101106,261,Andrew Bogut,1610612744,GSW,70,1451,175,279,0.627,1,1,1.0,24,50,0.48,121,371,492,162,33,114,83,221,375,963,1.95,0.4,2015,16,5.357142857142857,1.9518072289156627,104,26,130,3.7846153846153845
2015-16,RegularSeason,203960,262,JaKarr Sampson,1610612743,DEN,73,1160,140,317,0.442,14,63,0.222,80,122,0.656,46,144,190,46,23,33,70,142,374,377,0.66,0.33,2015,16,5.123287671232877,0.6571428571428571,177,42,219,0.867579908675799
2015-16,RegularSeason,201951,263,Ty Lawson,1610612754,IND,66,1411,139,354,0.393,36,108,0.333,59,86,0.686,26,94,120,237,53,7,95,87,373,453,2.5,0.56,2015,16,5.651515151515151,2.4947368421052634,215,27,242,0.49586776859504134
2015-16,RegularSeason,203092,264,Tyler Zeller,1610612738,BOS,60,710,138,290,0.476,0,0,0.0,88,108,0.815,62,116,178,29,10,22,46,97,364,385,0.63,0.22,2015,16,6.066666666666666,0.6304347826086957,152,20,172,1.0348837209302326
2015-16,RegularSeason,203900,265,Markel Brown,1610612751,BKN,62,982,127,322,0.394,38,121,0.314,71,94,0.755,23,99,122,91,38,15,54,94,363,357,1.69,0.7,2015,16,5.854838709677419,1.6851851851851851,195,23,218,0.5596330275229358
2015-16,RegularSeason,201582,266,Alexis Ajinca,1610612740,NOP,59,861,150,315,0.476,0,1,0.0,52,62,0.839,75,194,269,31,19,36,54,134,352,478,0.57,0.35,2015,16,5.966101694915254,0.5740740740740741,165,10,175,1.5371428571428571
2015-16,RegularSeason,201171,267,Carl Landry,1610612755,PHI,36,569,139,250,0.556,6,13,0.462,67,91,0.736,49,97,146,32,12,9,22,69,351,393,1.46,0.55,2015,16,9.75,1.4545454545454546,111,24,135,1.0814814814814815
2015-16,RegularSeason,203937,268,Kyle Anderson,1610612759,SAS,78,1245,138,295,0.468,12,37,0.324,62,83,0.747,25,219,244,123,60,29,59,97,350,569,2.08,1.02,2015,16,4.487179487179487,2.0847457627118646,157,21,178,1.3707865168539326
2015-16,RegularSeason,1626204,269,Larry Nance Jr.,1610612747,LAL,63,1266,158,300,0.527,1,10,0.1,32,47,0.681,101,211,312,44,54,23,41,124,349,584,1.07,1.32,2015,16,5.5396825396825395,1.0731707317073171,142,15,157,1.9872611464968153
2015-16,RegularSeason,203930,270,Sean Kilpatrick,1610612751,BKN,31,616,123,270,0.456,39,114,0.342,60,67,0.896,12,44,56,29,12,2,31,37,345,259,0.94,0.39,2015,16,11.129032258064516,0.9354838709677419,147,7,154,0.36363636363636365
2015-16,RegularSeason,2743,271,Kris Humphries,1610612737,ATL,53,835,121,295,0.41,34,108,0.315,67,84,0.798,57,161,218,36,16,23,38,94,343,407,0.95,0.42,2015,16,6.471698113207547,0.9473684210526315,174,17,191,1.1413612565445026
2015-16,RegularSeason,204060,272,Joe Ingles,1610612762,UTA,81,1241,124,291,0.426,81,210,0.386,13,18,0.722,19,132,151,96,55,4,65,98,342,411,1.48,0.85,2015,16,4.222222222222222,1.476923076923077,167,5,172,0.877906976744186
2015-16,RegularSeason,1626196,273,Josh Richardson,1610612748,MIA,52,1107,123,272,0.452,53,115,0.461,42,63,0.667,21,86,107,73,36,25,35,107,341,377,2.09,1.03,2015,16,6.5576923076923075,2.085714285714286,149,21,170,0.6294117647058823
2015-16,RegularSeason,201973,274,Jonas Jerebko,1610612738,BOS,78,1176,118,286,0.413,43,108,0.398,61,78,0.782,77,211,288,62,20,24,52,137,340,497,1.19,0.39,2015,16,4.358974358974359,1.1923076923076923,168,17,185,1.5567567567567568
2015-16,RegularSeason,201150,274,Spencer Hawes,1610612766,CHA,57,1035,124,306,0.405,38,102,0.373,54,65,0.831,51,193,244,109,22,27,58,111,340,491,1.88,0.38,2015,16,5.964912280701754,1.8793103448275863,182,11,193,1.2642487046632125
2015-16,RegularSeason,2590,276,Mo Williams,1610612739,CLE,41,748,132,302,0.437,36,102,0.353,38,42,0.905,6,66,72,98,14,5,57,60,338,296,1.72,0.25,2015,16,8.24390243902439,1.719298245614035,170,4,174,0.41379310344827586
2015-16,RegularSeason,203503,276,Tony Snell,1610612741,CHI,64,1301,126,339,0.372,56,155,0.361,30,33,0.909,19,180,199,63,16,17,52,100,338,365,1.21,0.31,2015,16,5.28125,1.2115384615384615,213,3,216,0.9212962962962963
2015-16,RegularSeason,203460,278,Andre Roberson,1610612760,OKC,70,1553,136,274,0.496,32,103,0.311,33,54,0.611,79,172,251,47,53,42,35,133,337,536,1.34,1.51,2015,16,4.814285714285714,1.3428571428571427,138,21,159,1.578616352201258
2015-16,RegularSeason,201943,279,Brandon Jennings,1610612753,ORL,48,868,112,304,0.368,51,155,0.329,57,78,0.731,16,80,96,170,29,7,57,57,332,364,2.98,0.51,2015,16,6.916666666666667,2.982456140350877,192,21,213,0.4507042253521127
2015-16,RegularSeason,2746,279,Josh Smith,1610612745,HOU,55,880,127,349,0.364,41,143,0.287,37,67,0.552,51,141,192,90,34,47,77,118,332,366,1.17,0.44,2015,16,6.036363636363636,1.1688311688311688,222,30,252,0.7619047619047619
2015-16,RegularSeason,203613,281,Jonathon Simmons,1610612759,SAS,55,813,122,242,0.504,18,47,0.383,69,92,0.75,16,80,96,58,24,5,53,103,331,318,1.09,0.45,2015,16,6.0181818181818185,1.0943396226415094,120,23,143,0.6713286713286714
2015-16,RegularSeason,101179,281,Ronnie Price,1610612756,PHX,62,1211,116,302,0.384,68,196,0.347,31,41,0.756,25,74,99,147,74,13,70,161,331,398,2.1,1.06,2015,16,5.338709677419355,2.1,186,10,196,0.5051020408163265
2015-16,RegularSeason,202332,283,Cole Aldrich,1610612746,LAC,60,800,134,225,0.596,0,0,0.0,60,84,0.714,86,202,288,50,47,68,64,139,328,602,0.78,0.73,2015,16,5.466666666666667,0.78125,91,24,115,2.5043478260869567
2015-16,RegularSeason,202337,284,Luke Babbitt,1610612740,NOP,47,845,122,289,0.422,44,109,0.404,39,50,0.78,25,123,148,53,11,7,23,90,327,345,2.3,0.48,2015,16,6.957446808510638,2.3043478260869565,167,11,178,0.8314606741573034
2015-16,RegularSeason,203501,285,Tim Hardaway Jr.,1610612737,ATL,51,864,114,265,0.43,48,143,0.336,50,56,0.893,7,79,86,51,21,7,23,48,326,311,2.22,0.91,2015,16,6.392156862745098,2.217391304347826,151,6,157,0.5477707006369427
2015-16,RegularSeason,202087,286,Alonzo Gee,1610612740,NOP,73,1632,132,255,0.518,17,60,0.283,44,66,0.667,60,185,245,72,63,13,55,169,325,518,1.31,1.15,2015,16,4.4520547945205475,1.309090909090909,123,22,145,1.6896551724137931
2015-16,RegularSeason,201564,287,O.J. Mayo,1610612749,MIL,41,1090,119,321,0.371,52,162,0.321,31,40,0.775,13,92,105,118,48,8,72,126,321,317,1.64,0.67,2015,16,7.829268292682927,1.6388888888888888,202,9,211,0.4976303317535545
2015-16,RegularSeason,203105,288,Festus Ezeli,1610612744,GSW,46,770,125,228,0.548,0,0,0.0,70,132,0.53,91,166,257,32,18,50,38,94,320,474,0.84,0.47,2015,16,6.956521739130435,0.8421052631578947,103,62,165,1.5575757575757576
2015-16,RegularSeason,101111,289,Charlie Villanueva,1610612742,DAL,62,665,125,327,0.382,47,172,0.273,22,24,0.917,24,128,152,24,18,15,31,71,319,293,0.77,0.58,2015,16,5.145161290322581,0.7741935483870968,202,2,204,0.7450980392156863
2015-16,RegularSeason,203101,290,Miles Plumlee,1610612749,MIL,61,870,140,233,0.601,0,0,0.0,34,59,0.576,94,138,232,16,21,50,40,73,314,475,0.4,0.53,2015,16,5.147540983606557,0.4,93,25,118,1.9661016949152543
2015-16,RegularSeason,204020,290,Tyler Johnson,1610612748,MIA,36,863,118,243,0.486,27,71,0.38,51,64,0.797,28,81,109,79,24,14,47,66,314,355,1.68,0.51,2015,16,8.722222222222221,1.6808510638297873,125,13,138,0.7898550724637681
2015-16,RegularSeason,202697,292,Iman Shumpert,1610612739,CLE,54,1316,114,305,0.374,43,146,0.295,40,51,0.784,32,171,203,92,54,19,57,119,311,420,1.61,0.95,2015,16,5.7592592592592595,1.6140350877192982,191,11,202,1.004950495049505
2015-16,RegularSeason,203124,293,Kyle O'Quinn,1610612752,NYK,65,764,129,271,0.476,5,22,0.227,46,60,0.767,76,174,250,72,20,49,61,107,309,483,1.18,0.33,2015,16,4.753846153846154,1.180327868852459,142,14,156,1.6025641025641026
2015-16,RegularSeason,202357,294,Nemanja Bjelica,1610612750,MIN,60,1075,110,235,0.468,48,125,0.384,40,55,0.727,49,161,210,82,26,21,47,154,308,460,1.75,0.55,2015,16,5.133333333333334,1.7446808510638299,125,15,140,1.5
2015-16,RegularSeason,203112,295,Quincy Acy,1610612758,SAC,59,876,119,214,0.556,19,49,0.388,50,68,0.735,65,123,188,27,29,24,27,103,307,435,1.0,1.07,2015,16,5.203389830508475,1.0,95,18,113,1.663716814159292
2015-16,RegularSeason,203080,295,Thomas Robinson,1610612751,BKN,71,917,130,291,0.447,0,1,0.0,47,109,0.431,136,223,359,46,39,36,69,111,307,495,0.67,0.56,2015,16,4.323943661971831,0.6666666666666666,161,62,223,1.609865470852018
2015-16,RegularSeason,201575,297,Brandon Rush,1610612744,GSW,72,1055,111,260,0.427,65,157,0.414,18,28,0.643,21,160,181,57,20,23,33,57,305,394,1.73,0.61,2015,16,4.236111111111111,1.7272727272727273,149,10,159,1.1383647798742138
2015-16,RegularSeason,200745,298,Andrea Bargnani,1610612751,BKN,46,634,127,279,0.455,3,16,0.188,47,57,0.825,28,69,97,18,4,9,26,61,304,244,0.69,0.15,2015,16,6.608695652173913,0.6923076923076923,152,10,162,0.5987654320987654
2015-16,RegularSeason,2405,299,Amar'e Stoudemire,1610612748,MIA,52,762,125,221,0.566,0,0,0.0,50,67,0.746,65,157,222,27,18,41,47,92,300,448,0.57,0.38,2015,16,5.769230769230769,0.574468085106383,96,17,113,1.9646017699115044
2015-16,RegularSeason,2749,300,Jameer Nelson,1610612743,DEN,39,1036,113,307,0.368,43,144,0.299,30,35,0.857,19,96,115,190,25,5,66,100,299,369,2.88,0.38,2015,16,7.666666666666667,2.878787878787879,194,5,199,0.5778894472361809
2015-16,RegularSeason,203552,300,Seth Curry,1610612758,SAC,44,692,102,224,0.455,50,111,0.45,45,54,0.833,9,51,60,67,22,3,36,41,299,284,1.86,0.61,2015,16,6.795454545454546,1.8611111111111112,122,9,131,0.4580152671755725
2015-16,RegularSeason,1626246,302,Boban Marjanovic,1610612759,SAS,54,508,105,174,0.603,0,0,0.0,87,114,0.763,73,121,194,21,12,23,29,54,297,422,0.72,0.41,2015,16,5.5,0.7241379310344828,69,27,96,2.0208333333333335
2015-16,RegularSeason,2756,303,Sasha Vujacic,1610612752,NYK,61,908,106,277,0.383,52,143,0.364,32,39,0.821,26,123,149,84,34,5,44,83,296,346,1.91,0.77,2015,16,4.852459016393443,1.9090909090909092,171,7,178,0.8370786516853933
2015-16,RegularSeason,201949,304,James Johnson,1610612761,TOR,57,926,114,240,0.475,20,66,0.303,39,68,0.574,28,98,126,67,29,33,54,84,287,333,1.24,0.54,2015,16,5.035087719298246,1.2407407407407407,126,29,155,0.8129032258064516
2015-16,RegularSeason,1626158,304,Richaun Holmes,1610612755,PHI,51,702,114,222,0.514,8,44,0.182,51,74,0.689,62,73,135,33,19,40,32,92,287,351,1.03,0.59,2015,16,5.627450980392157,1.03125,108,23,131,1.0305343511450382
2015-16,RegularSeason,201960,306,DeMarre Carroll,1610612761,TOR,26,786,105,270,0.389,46,118,0.39,30,50,0.6,31,91,122,27,44,6,28,63,286,272,0.96,1.57,2015,16,11.0,0.9642857142857143,165,20,185,0.6594594594594595
2015-16,RegularSeason,1626166,307,Cameron Payne,1610612760,OKC,57,698,114,278,0.41,36,111,0.324,19,24,0.792,9,76,85,108,36,6,44,80,283,305,2.46,0.82,2015,16,4.964912280701754,2.4545454545454546,164,5,169,0.5029585798816568
2015-16,RegularSeason,203943,307,Noah Vonleh,1610612757,POR,78,1174,117,278,0.421,11,46,0.239,38,51,0.745,91,214,305,30,27,26,50,152,283,447,0.6,0.54,2015,16,3.628205128205128,0.6,161,13,174,1.7528735632183907
2015-16,RegularSeason,1626181,309,Norman Powell,1610612761,TOR,49,725,97,229,0.424,36,89,0.404,43,53,0.811,16,95,111,47,29,10,32,59,273,296,1.47,0.91,2015,16,5.571428571428571,1.46875,132,10,142,0.7816901408450704
2015-16,RegularSeason,201978,310,Chase Budinger,1610612756,PHX,66,930,104,239,0.435,24,86,0.279,39,56,0.696,43,107,150,64,32,10,44,62,271,331,1.46,0.73,2015,16,4.106060606060606,1.4545454545454546,135,17,152,0.9868421052631579
2015-16,RegularSeason,201600,311,Ömer Aşik,1610612740,NOP,68,1178,104,195,0.533,0,0,0.0,61,112,0.545,120,294,414,26,21,23,60,124,269,551,0.43,0.35,2015,16,3.9558823529411766,0.43333333333333335,91,51,142,2.915492957746479
2015-16,RegularSeason,203994,312,Jusuf Nurkic,1610612743,DEN,32,547,101,242,0.417,0,3,0.0,61,99,0.616,65,110,175,40,24,44,55,91,263,312,0.73,0.44,2015,16,8.21875,0.7272727272727273,141,38,179,0.9776536312849162
2015-16,RegularSeason,204025,313,Tim Frazier,1610612740,NOP,51,741,96,229,0.419,16,48,0.333,53,74,0.716,26,84,110,162,33,2,65,73,261,349,2.49,0.51,2015,16,5.117647058823529,2.4923076923076923,133,21,154,0.7142857142857143
2015-16,RegularSeason,203473,314,Dewayne Dedmon,1610612753,ORL,58,705,99,177,0.559,0,0,0.0,57,76,0.75,67,161,228,13,22,46,32,109,255,435,0.41,0.69,2015,16,4.396551724137931,0.40625,78,19,97,2.350515463917526
2015-16,RegularSeason,201563,314,Michael Beasley,1610612745,HOU,20,363,107,205,0.522,3,9,0.333,38,49,0.776,29,69,98,16,11,9,24,39,255,256,0.67,0.46,2015,16,12.75,0.6666666666666666,98,11,109,0.8990825688073395
2015-16,RegularSeason,2581,316,Steve Blake,1610612765,DET,58,986,93,240,0.388,52,151,0.344,16,20,0.8,9,80,89,200,24,5,81,70,254,340,2.47,0.3,2015,16,4.379310344827586,2.4691358024691357,147,4,151,0.5894039735099338
2015-16,RegularSeason,203524,317,Solomon Hill,1610612754,IND,59,866,93,208,0.447,24,74,0.324,36,42,0.857,39,127,166,57,37,11,33,68,246,363,1.73,1.12,2015,16,4.169491525423729,1.7272727272727273,115,6,121,1.371900826446281
2015-16,RegularSeason,203584,318,Troy Daniels,1610612766,CHA,43,476,89,187,0.476,59,122,0.484,5,9,0.556,7,50,57,21,11,3,24,40,242,208,0.88,0.46,2015,16,5.627906976744186,0.875,98,4,102,0.5588235294117647
2015-16,RegularSeason,203200,319,Justin Holiday,1610612741,CHI,53,773,88,228,0.386,36,105,0.343,27,37,0.73,12,78,90,56,32,19,39,61,239,247,1.44,0.82,2015,16,4.509433962264151,1.435897435897436,140,10,150,0.6
2015-16,RegularSeason,1626273,320,Marcelo Huertas,1610612747,LAL,53,869,97,230,0.422,16,61,0.262,27,29,0.931,18,72,90,182,26,7,80,76,237,327,2.27,0.33,2015,16,4.471698113207547,2.275,133,2,135,0.6666666666666666
2015-16,RegularSeason,203546,321,Ian Clark,1610612744,GSW,66,578,89,202,0.441,30,84,0.357,28,34,0.824,13,55,68,64,17,13,43,58,236,236,1.49,0.4,2015,16,3.5757575757575757,1.4883720930232558,113,6,119,0.5714285714285714
2015-16,RegularSeason,1626162,321,Kelly Oubre Jr.,1610612764,WAS,63,671,90,211,0.427,25,79,0.316,31,49,0.633,25,108,133,13,22,7,34,100,236,238,0.38,0.65,2015,16,3.746031746031746,0.38235294117647056,121,18,139,0.9568345323741008
2015-16,RegularSeason,202713,323,Kyle Singler,1610612760,OKC,68,977,86,221,0.389,30,97,0.309,29,44,0.659,50,91,141,24,30,9,32,120,231,253,0.75,0.94,2015,16,3.3970588235294117,0.75,135,15,150,0.94
2015-16,RegularSeason,201601,323,Luc Mbah a Moute,1610612746,LAC,75,1274,94,207,0.454,13,40,0.325,30,57,0.526,60,111,171,30,44,19,34,100,231,321,0.88,1.29,2015,16,3.08,0.8823529411764706,113,27,140,1.2214285714285715
2015-16,RegularSeason,202700,325,Donatas Motiejunas,1610612745,HOU,37,547,90,205,0.439,16,57,0.281,34,53,0.642,37,72,109,41,17,5,44,69,230,224,0.93,0.39,2015,16,6.216216216216216,0.9318181818181818,115,19,134,0.8134328358208955
2015-16,RegularSeason,2399,326,Mike Dunleavy,1610612741,CHI,31,703,77,188,0.41,39,99,0.394,29,37,0.784,8,75,83,39,14,10,26,66,222,223,1.5,0.54,2015,16,7.161290322580645,1.5,111,8,119,0.6974789915966386
2015-16,RegularSeason,2419,327,Tayshaun Prince,1610612750,MIN,77,1462,102,229,0.445,4,23,0.174,13,19,0.684,32,115,147,74,36,13,27,62,221,331,2.74,1.33,2015,16,2.8701298701298703,2.740740740740741,127,6,133,1.105263157894737
2015-16,RegularSeason,203481,328,Jeff Withey,1610612762,UTA,51,658,87,162,0.537,0,2,0.0,43,59,0.729,56,117,173,20,21,53,28,75,217,365,0.71,0.75,2015,16,4.254901960784314,0.7142857142857143,75,16,91,1.901098901098901
2015-16,RegularSeason,1626173,328,Rashad Vaughn,1610612749,MIL,70,1001,81,266,0.305,43,147,0.293,12,15,0.8,11,77,88,39,29,16,28,73,217,173,1.39,1.04,2015,16,3.1,1.3928571428571428,185,3,188,0.46808510638297873
2015-16,RegularSeason,1626147,330,Justin Anderson,1610612742,DAL,55,647,71,175,0.406,22,83,0.265,44,55,0.8,18,114,132,29,19,25,24,45,208,274,1.21,0.79,2015,16,3.7818181818181817,1.2083333333333333,104,11,115,1.1478260869565218
2015-16,RegularSeason,201581,331,JJ Hickson,1610612764,WAS,35,437,80,155,0.516,0,1,0.0,46,103,0.447,39,93,132,23,15,14,25,47,206,233,0.92,0.6,2015,16,5.885714285714286,0.92,75,57,132,1.0
2015-16,RegularSeason,203898,331,Tyler Ennis,1610612749,MIL,46,654,84,187,0.449,13,39,0.333,25,34,0.735,13,62,75,95,25,1,46,64,206,244,2.06,0.54,2015,16,4.478260869565218,2.0652173913043477,103,9,112,0.6696428571428571
2015-16,RegularSeason,2757,333,Beno Udrih,1610612763,MEM,44,708,86,198,0.434,15,44,0.341,18,20,0.9,8,64,72,116,14,1,53,51,205,241,2.19,0.26,2015,16,4.659090909090909,2.188679245283019,112,2,114,0.631578947368421
2015-16,RegularSeason,203148,333,Brian Roberts,1610612757,POR,51,470,74,165,0.448,15,42,0.357,42,47,0.894,6,35,41,54,10,2,23,35,205,193,2.35,0.43,2015,16,4.019607843137255,2.347826086956522,91,5,96,0.4270833333333333
2015-16,RegularSeason,203187,333,Chris Johnson,1610612762,UTA,70,857,72,194,0.371,27,99,0.273,34,42,0.81,27,105,132,45,32,20,40,100,205,264,1.13,0.8,2015,16,2.9285714285714284,1.125,122,8,130,1.0153846153846153
2015-16,RegularSeason,203894,336,Shabazz Napier,1610612753,ORL,55,600,68,201,0.338,34,104,0.327,33,45,0.733,9,46,55,97,23,1,46,38,203,188,2.11,0.5,2015,16,3.690909090909091,2.108695652173913,133,12,145,0.3793103448275862
2015-16,RegularSeason,201168,337,Tiago Splitter,1610612737,ATL,36,579,81,155,0.523,0,2,0.0,39,48,0.813,45,75,120,30,20,12,24,71,201,276,1.25,0.83,2015,16,5.583333333333333,1.25,74,9,83,1.4457831325301205
2015-16,RegularSeason,203948,338,Johnny O'Bryant III,1610612749,MIL,66,857,86,209,0.411,1,1,1.0,27,40,0.675,65,111,176,32,18,8,31,100,200,267,1.03,0.58,2015,16,3.0303030303030303,1.032258064516129,123,13,136,1.2941176470588236
2015-16,RegularSeason,203488,339,Mike Muscala,1610612737,ATL,60,565,76,152,0.5,12,39,0.308,31,39,0.795,38,79,117,34,13,27,27,72,195,275,1.26,0.48,2015,16,3.25,1.2592592592592593,76,8,84,1.3928571428571428
2015-16,RegularSeason,202338,340,Kevin Seraphin,1610612752,NYK,48,526,84,205,0.41,0,2,0.0,19,23,0.826,31,95,126,47,8,36,43,67,187,236,1.09,0.19,2015,16,3.8958333333333335,1.0930232558139534,121,4,125,1.008
2015-16,RegularSeason,203186,341,Willie Reed,1610612751,BKN,39,426,76,133,0.571,0,0,0.0,30,55,0.545,49,73,122,10,6,30,16,47,182,252,0.63,0.38,2015,16,4.666666666666667,0.625,57,25,82,1.4878048780487805
2015-16,RegularSeason,202341,342,James Anderson,1610612758,SAC,51,721,67,178,0.376,23,86,0.267,22,29,0.759,13,73,86,41,21,14,42,54,179,181,0.98,0.5,2015,16,3.5098039215686274,0.9761904761904762,111,7,118,0.7288135593220338
2015-16,RegularSeason,2592,343,James Jones,1610612739,CLE,48,463,58,142,0.408,41,104,0.394,21,26,0.808,8,42,50,14,11,10,13,50,178,161,1.08,0.85,2015,16,3.7083333333333335,1.0769230769230769,84,5,89,0.5617977528089888
2015-16,RegularSeason,203098,343,John Jenkins,1610612756,PHX,43,480,71,160,0.444,16,51,0.314,20,24,0.833,8,49,57,35,8,1,27,22,178,159,1.3,0.3,2015,16,4.1395348837209305,1.2962962962962963,89,4,93,0.6129032258064516
2015-16,RegularSeason,1897,345,Metta World Peace,1610612747,LAL,35,590,55,177,0.311,26,84,0.31,40,57,0.702,19,70,89,27,22,11,15,67,176,171,1.8,1.47,2015,16,5.0285714285714285,1.8,122,17,139,0.6402877697841727
2015-16,RegularSeason,201580,346,JaVale McGee,1610612742,DAL,34,370,77,134,0.575,0,1,0.0,18,36,0.5,53,80,133,3,5,26,21,49,172,243,0.14,0.24,2015,16,5.0588235294117645,0.14285714285714285,57,18,75,1.7733333333333334
2015-16,RegularSeason,203922,347,Glenn Robinson III,1610612754,IND,45,508,65,151,0.43,14,37,0.378,27,39,0.692,12,56,68,26,17,9,18,21,171,175,1.44,0.94,2015,16,3.8,1.4444444444444444,86,12,98,0.6938775510204082
2015-16,RegularSeason,1626178,348,Rondae Hollis-Jefferson,1610612751,BKN,29,615,63,138,0.457,4,14,0.286,37,52,0.712,39,115,154,43,39,16,26,61,167,303,1.65,1.5,2015,16,5.758620689655173,1.6538461538461537,75,15,90,1.711111111111111
2015-16,RegularSeason,203516,349,James Ennis III,1610612740,NOP,22,329,54,113,0.478,26,58,0.448,25,34,0.735,21,21,42,21,16,5,19,28,159,156,1.1,0.84,2015,16,7.2272727272727275,1.105263157894737,59,9,68,0.6176470588235294
2015-16,RegularSeason,1626145,350,Tyus Jones,1610612750,MIN,37,573,56,156,0.359,16,53,0.302,28,39,0.718,7,40,47,108,31,3,33,33,156,201,3.27,0.94,2015,16,4.216216216216216,3.272727272727273,100,11,111,0.42342342342342343
2015-16,RegularSeason,1626202,351,Joe Young,1610612754,IND,41,384,62,169,0.367,10,46,0.217,20,25,0.8,6,44,50,65,15,0,33,30,154,139,1.97,0.46,2015,16,3.7560975609756095,1.9696969696969697,107,5,112,0.44642857142857145
2015-16,RegularSeason,1626185,352,Jarell Martin,1610612763,MEM,27,380,54,116,0.466,0,2,0.0,45,62,0.726,39,47,86,15,8,7,19,58,153,171,0.79,0.42,2015,16,5.666666666666667,0.7894736842105263,62,17,79,1.0886075949367089
2015-16,RegularSeason,1626199,353,Darrun Hilliard,1610612765,DET,38,383,52,131,0.397,19,50,0.38,29,40,0.725,5,40,45,27,9,1,19,28,152,125,1.42,0.47,2015,16,4.0,1.4210526315789473,79,11,90,0.5
2015-16,RegularSeason,203527,353,Ryan Kelly,1610612747,LAL,36,470,55,149,0.369,5,37,0.135,37,54,0.685,21,100,121,20,13,10,18,39,152,187,1.11,0.72,2015,16,4.222222222222222,1.1111111111111112,94,17,111,1.09009009009009
2015-16,RegularSeason,201177,355,Josh McRoberts,1610612748,MIA,42,595,55,148,0.372,12,49,0.245,28,40,0.7,22,83,105,81,18,7,30,68,150,226,2.7,0.6,2015,16,3.5714285714285716,2.7,93,12,105,1.0
2015-16,RegularSeason,201574,356,Jason Thompson,1610612761,TOR,47,471,52,108,0.481,5,15,0.333,38,54,0.704,32,102,134,29,12,20,15,80,147,255,1.93,0.8,2015,16,3.127659574468085,1.9333333333333333,56,16,72,1.8611111111111112
2015-16,RegularSeason,203143,357,Pablo Prigioni,1610612746,LAC,59,823,55,147,0.374,28,95,0.295,7,8,0.875,38,76,114,130,53,1,49,82,145,301,2.65,1.08,2015,16,2.457627118644068,2.6530612244897958,92,1,93,1.2258064516129032
2015-16,RegularSeason,1889,358,Andre Miller,1610612759,SAS,39,461,59,106,0.557,2,8,0.25,24,32,0.75,12,39,51,87,16,0,37,46,144,206,2.35,0.43,2015,16,3.6923076923076925,2.3513513513513513,47,8,55,0.9272727272727272
2015-16,RegularSeason,201228,359,C.J. Watson,1610612753,ORL,33,656,47,137,0.343,14,48,0.292,34,39,0.872,10,56,66,88,19,5,25,49,142,200,3.52,0.76,2015,16,4.303030303030303,3.52,90,5,95,0.6947368421052632
2015-16,RegularSeason,1626149,360,Montrezl Harrell,1610612745,HOU,39,379,58,90,0.644,0,1,0.0,24,46,0.522,25,40,65,17,11,11,17,48,140,173,1.0,0.65,2015,16,3.58974358974359,1.0,32,22,54,1.2037037037037037
2015-16,RegularSeason,2760,361,Anderson Varejao,1610612744,GSW,53,496,53,124,0.427,0,1,0.0,32,50,0.64,37,104,141,35,16,10,22,70,138,229,1.59,0.73,2015,16,2.6037735849056602,1.5909090909090908,71,18,89,1.5842696629213484
2015-16,RegularSeason,2550,362,Kirk Hinrich,1610612737,ATL,46,631,49,129,0.38,24,62,0.387,15,16,0.938,8,62,70,73,15,2,30,64,137,186,2.43,0.5,2015,16,2.9782608695652173,2.433333333333333,80,1,81,0.8641975308641975
2015-16,RegularSeason,203492,362,Ray McCallum,1610612759,SAS,41,474,55,146,0.377,15,42,0.357,12,15,0.8,8,39,47,60,12,7,24,29,137,145,2.5,0.5,2015,16,3.341463414634146,2.5,91,3,94,0.5
2015-16,RegularSeason,204028,364,Tarik Black,1610612747,LAL,39,496,57,104,0.548,0,0,0.0,19,45,0.422,44,113,157,16,14,18,22,78,133,243,0.73,0.64,2015,16,3.41025641025641,0.7272727272727273,47,26,73,2.1506849315068495
2015-16,RegularSeason,203940,365,Adreian Payne,1610612750,MIN,52,486,53,145,0.366,9,32,0.281,17,26,0.654,20,91,111,29,16,11,36,77,132,162,0.81,0.44,2015,16,2.5384615384615383,0.8055555555555556,92,9,101,1.099009900990099
2015-16,RegularSeason,202349,366,Greivis Vasquez,1610612749,MIL,23,460,45,138,0.326,18,73,0.247,22,26,0.846,5,42,47,91,10,0,40,42,130,141,2.27,0.25,2015,16,5.6521739130434785,2.275,93,4,97,0.4845360824742268
2015-16,RegularSeason,202706,367,Jordan Hamilton,1610612740,NOP,11,304,49,116,0.422,13,45,0.289,14,21,0.667,12,50,62,25,8,3,17,24,125,132,1.47,0.47,2015,16,11.363636363636363,1.4705882352941178,67,7,74,0.8378378378378378
2015-16,RegularSeason,1626257,367,Salah Mejri,1610612742,DAL,34,397,49,78,0.628,0,1,0.0,27,46,0.587,41,82,123,10,8,36,23,54,125,231,0.43,0.35,2015,16,3.676470588235294,0.43478260869565216,29,19,48,2.5625
2015-16,RegularSeason,201149,369,Joakim Noah,1610612741,CHI,29,635,51,133,0.383,0,1,0.0,22,45,0.489,87,168,255,110,18,29,52,77,124,379,2.12,0.35,2015,16,4.275862068965517,2.1153846153846154,82,23,105,2.4285714285714284
2015-16,RegularSeason,2446,369,Rasual Butler,1610612759,SAS,46,432,49,104,0.471,15,49,0.306,11,16,0.688,3,53,56,24,13,23,8,11,124,172,3.0,1.63,2015,16,2.6956521739130435,3.0,55,5,60,0.9333333333333333
2015-16,RegularSeason,200797,369,Ryan Hollins,1610612763,MEM,37,460,49,79,0.62,0,0,0.0,26,42,0.619,47,51,98,10,6,21,24,62,124,189,0.42,0.25,2015,16,3.3513513513513513,0.4166666666666667,30,16,46,2.130434782608696
2015-16,RegularSeason,2555,372,Nick Collison,1610612760,OKC,59,699,50,109,0.459,0,2,0.0,23,33,0.697,68,103,171,52,15,16,50,107,123,258,1.04,0.3,2015,16,2.0847457627118646,1.04,59,10,69,2.4782608695652173
2015-16,RegularSeason,708,373,Kevin Garnett,1610612750,MIN,38,556,54,115,0.47,0,1,0.0,14,21,0.667,15,135,150,62,28,10,16,70,122,288,3.88,1.75,2015,16,3.210526315789474,3.875,61,7,68,2.2058823529411766
2015-16,RegularSeason,203493,373,Reggie Bullock Jr.,1610612765,DET,37,429,43,98,0.439,22,53,0.415,14,15,0.933,14,54,68,27,10,2,8,29,122,165,3.38,1.25,2015,16,3.2972972972972974,3.375,55,1,56,1.2142857142857142
2015-16,RegularSeason,203099,375,Jared Cunningham,1610612739,CLE,44,410,36,105,0.343,12,39,0.308,36,55,0.655,3,35,38,20,14,2,21,41,120,85,0.95,0.67,2015,16,2.727272727272727,0.9523809523809523,69,19,88,0.4318181818181818
2015-16,RegularSeason,203949,376,James Michael McAdoo,1610612744,GSW,41,262,45,84,0.536,1,2,0.5,26,49,0.531,30,28,58,17,10,8,16,39,117,132,1.06,0.63,2015,16,2.8536585365853657,1.0625,39,23,62,0.9354838709677419
2015-16,RegularSeason,1626148,377,Anthony Brown,1610612747,LAL,29,599,39,126,0.31,20,70,0.286,17,20,0.85,9,61,70,19,14,5,15,34,115,118,1.27,0.93,2015,16,3.9655172413793105,1.2666666666666666,87,3,90,0.7777777777777778
2015-16,RegularSeason,1626191,378,Chris McCullough,1610612751,BKN,24,362,44,109,0.404,13,34,0.382,11,23,0.478,25,43,68,9,28,12,15,39,112,137,0.6,1.87,2015,16,4.666666666666667,0.6,65,12,77,0.8831168831168831
2015-16,RegularSeason,203088,379,Kendall Marshall,1610612755,PHI,30,400,43,118,0.364,16,49,0.327,9,13,0.692,2,26,28,73,16,2,43,30,111,108,1.7,0.37,2015,16,3.7,1.697674418604651,75,4,79,0.35443037974683544
2015-16,RegularSeason,200770,380,Jordan Farmar,1610612763,MEM,12,291,42,100,0.42,16,45,0.356,10,10,1.0,4,21,25,37,15,2,18,22,110,113,2.06,0.83,2015,16,9.166666666666666,2.0555555555555554,58,0,58,0.43103448275862066
2015-16,RegularSeason,201603,381,Sonny Weems,1610612756,PHX,43,498,42,110,0.382,15,41,0.366,8,15,0.533,7,46,53,49,10,1,41,47,107,104,1.2,0.24,2015,16,2.488372093023256,1.1951219512195121,68,7,75,0.7066666666666667
2015-16,RegularSeason,2365,382,Chris Andersen,1610612763,MEM,27,403,38,72,0.528,4,14,0.286,25,36,0.694,36,62,98,12,15,13,9,29,105,189,1.33,1.67,2015,16,3.888888888888889,1.3333333333333333,34,11,45,2.1777777777777776
2015-16,RegularSeason,1626245,382,Cristiano Felicio,1610612741,CHI,31,321,40,72,0.556,0,4,0.0,25,35,0.714,30,72,102,26,6,13,13,31,105,197,2.0,0.46,2015,16,3.3870967741935485,2.0,32,10,42,2.4285714285714284
2015-16,RegularSeason,201946,384,Tyler Hansbrough,1610612766,CHA,44,343,32,71,0.451,2,3,0.667,38,65,0.585,40,49,89,8,12,7,12,55,104,142,0.67,1.0,2015,16,2.3636363636363638,0.6666666666666666,39,27,66,1.3484848484848484
2015-16,RegularSeason,1626153,385,Delon Wright,1610612761,TOR,27,229,36,80,0.45,5,13,0.385,26,35,0.743,8,29,37,31,8,3,16,7,103,113,1.94,0.5,2015,16,3.814814814814815,1.9375,44,9,53,0.6981132075471698
2015-16,RegularSeason,203895,386,Jordan McRae,1610612739,CLE,22,196,34,78,0.436,10,22,0.455,21,28,0.75,4,16,20,25,3,1,15,17,99,82,1.67,0.2,2015,16,4.5,1.6666666666666667,44,7,51,0.39215686274509803
2015-16,RegularSeason,1626154,387,RJ Hunter,1610612738,BOS,36,315,36,98,0.367,19,63,0.302,6,7,0.857,2,35,37,13,14,4,11,29,97,91,1.18,1.27,2015,16,2.6944444444444446,1.1818181818181819,62,1,63,0.5873015873015873
2015-16,RegularSeason,203508,387,Sergey Karasev,1610612751,BKN,40,399,30,74,0.405,11,37,0.297,26,28,0.929,8,50,58,35,6,2,22,27,97,130,1.59,0.27,2015,16,2.425,1.5909090909090908,44,2,46,1.2608695652173914
2015-16,RegularSeason,203156,389,Henry Sims,1610612751,BKN,14,263,33,77,0.429,0,0,0.0,25,30,0.833,21,51,72,9,9,14,12,37,91,134,0.75,0.75,2015,16,6.5,0.75,44,5,49,1.469387755102041
2015-16,RegularSeason,2570,389,Kendrick Perkins,1610612740,NOP,37,542,40,75,0.533,0,0,0.0,11,25,0.44,25,103,128,31,11,11,41,64,91,182,0.76,0.27,2015,16,2.4594594594594597,0.7560975609756098,35,14,49,2.6122448979591835
2015-16,RegularSeason,203909,391,KJ McDaniels,1610612745,HOU,37,235,29,72,0.403,7,25,0.28,24,30,0.8,16,26,42,10,7,6,17,30,89,88,0.59,0.41,2015,16,2.4054054054054053,0.5882352941176471,43,6,49,0.8571428571428571
2015-16,RegularSeason,203077,391,Michael Kidd-Gilchrist,1610612766,CHA,7,205,33,61,0.541,3,7,0.429,20,29,0.69,12,33,45,9,3,3,8,9,89,104,1.13,0.38,2015,16,12.714285714285714,1.125,28,9,37,1.2162162162162162
2015-16,RegularSeason,203135,393,Robert Sacre,1610612747,LAL,25,320,31,75,0.413,0,0,0.0,25,38,0.658,32,40,72,14,4,10,12,43,87,118,1.17,0.33,2015,16,3.48,1.1666666666666667,44,13,57,1.263157894736842
2015-16,RegularSeason,203934,394,Lamar Patterson,1610612737,ATL,35,395,28,80,0.35,12,49,0.245,16,22,0.727,4,46,50,39,9,2,23,45,84,103,1.7,0.39,2015,16,2.4,1.6956521739130435,52,6,58,0.8620689655172413
2015-16,RegularSeason,201148,395,Brandan Wright,1610612763,MEM,12,212,35,52,0.673,0,0,0.0,13,24,0.542,14,29,43,6,5,15,10,21,83,114,0.6,0.5,2015,16,6.916666666666667,0.6,17,11,28,1.5357142857142858
2015-16,RegularSeason,2400,396,Drew Gooden,1610612764,WAS,30,305,33,103,0.32,7,41,0.171,9,14,0.643,28,57,85,13,8,11,13,40,82,111,1.0,0.61,2015,16,2.7333333333333334,1.0,70,5,75,1.1333333333333333
2015-16,RegularSeason,204098,397,Xavier Munford,1610612763,MEM,14,244,32,77,0.416,9,23,0.391,7,14,0.5,3,28,31,22,13,3,15,25,80,82,1.47,0.87,2015,16,5.714285714285714,1.4666666666666666,45,7,52,0.5961538461538461
2015-16,RegularSeason,1626214,398,Bryce Dejean-Jones,1610612740,NOP,14,279,28,69,0.406,12,32,0.375,11,21,0.524,8,40,48,15,10,2,11,17,79,92,1.36,0.91,2015,16,5.642857142857143,1.3636363636363635,41,10,51,0.9411764705882353
2015-16,RegularSeason,203515,399,Phil Pressey,1610612757,POR,23,283,30,78,0.385,4,18,0.222,13,25,0.52,3,28,31,75,18,4,33,28,77,112,2.27,0.55,2015,16,3.347826086956522,2.272727272727273,48,12,60,0.5166666666666667
2015-16,RegularSeason,1626253,400,Axel Toupane,1610612743,DEN,21,305,25,70,0.357,13,40,0.325,13,17,0.765,8,23,31,15,7,6,6,40,76,80,2.5,1.17,2015,16,3.619047619047619,2.5,45,4,49,0.6326530612244898
2015-16,RegularSeason,2588,400,Matt Bonner,1610612759,SAS,30,206,29,57,0.509,15,34,0.441,3,4,0.75,3,24,27,9,6,1,3,16,76,87,3.0,2.0,2015,16,2.533333333333333,3.0,28,1,29,0.9310344827586207
2015-16,RegularSeason,204014,402,Damjan Rudez,1610612750,MIN,33,277,25,62,0.403,17,50,0.34,8,8,1.0,5,15,20,11,3,1,13,33,75,60,0.85,0.23,2015,16,2.272727272727273,0.8461538461538461,37,0,37,0.5405405405405406
2015-16,RegularSeason,1626179,403,Terry Rozier,1610612738,BOS,39,311,29,106,0.274,6,27,0.222,8,10,0.8,24,39,63,37,6,1,19,23,72,81,1.95,0.32,2015,16,1.8461538461538463,1.9473684210526316,77,2,79,0.7974683544303798
2015-16,RegularSeason,202379,404,Jeremy Evans,1610612742,DAL,30,251,26,48,0.542,4,16,0.25,15,21,0.714,11,43,54,2,6,9,7,19,71,107,0.29,0.86,2015,16,2.3666666666666667,0.2857142857142857,22,6,28,1.9285714285714286
2015-16,RegularSeason,203912,405,C.J. Wilcox,1610612746,LAC,23,167,26,66,0.394,9,23,0.391,9,12,0.75,1,11,12,10,10,2,2,15,70,59,5.0,5.0,2015,16,3.0434782608695654,5.0,40,3,43,0.27906976744186046
2015-16,RegularSeason,1882,405,Elton Brand,1610612755,PHI,17,225,31,72,0.431,0,1,0.0,8,9,0.889,9,54,63,18,9,8,11,32,70,115,1.64,0.82,2015,16,4.117647058823529,1.6363636363636365,41,1,42,1.5
2015-16,RegularSeason,203123,407,Kostas Papanikolaou,1610612743,DEN,26,294,24,66,0.364,10,32,0.313,9,14,0.643,8,32,40,16,13,5,21,24,67,73,0.76,0.62,2015,16,2.576923076923077,0.7619047619047619,42,5,47,0.851063829787234
2015-16,RegularSeason,203100,407,Tony Wroten,1610612752,NYK,8,144,22,65,0.338,3,17,0.176,20,37,0.541,2,19,21,20,3,0,29,11,67,22,0.69,0.1,2015,16,8.375,0.6896551724137931,43,17,60,0.35
2015-16,RegularSeason,101187,409,Alan Anderson,1610612764,WAS,13,192,21,59,0.356,12,37,0.324,11,15,0.733,1,26,27,14,4,1,2,25,65,67,7.0,2.0,2015,16,5.0,7.0,38,4,42,0.6428571428571429
2015-16,RegularSeason,203512,409,Lucas Nogueira,1610612761,TOR,29,225,28,44,0.636,1,3,0.333,8,15,0.533,18,28,46,7,12,12,11,29,65,108,0.64,1.09,2015,16,2.2413793103448274,0.6363636363636364,16,7,23,2.0
2015-16,RegularSeason,2406,411,Caron Butler,1610612758,SAC,17,176,25,59,0.424,3,18,0.167,10,12,0.833,5,17,22,10,9,1,3,19,63,66,3.33,3.0,2015,16,3.7058823529411766,3.3333333333333335,34,2,36,0.6111111111111112
2015-16,RegularSeason,204067,411,Jarell Eddie,1610612764,WAS,26,147,20,65,0.308,15,47,0.319,8,8,1.0,2,21,23,5,5,1,1,5,63,51,5.0,5.0,2015,16,2.423076923076923,5.0,45,0,45,0.5111111111111111
2015-16,RegularSeason,2034,411,Mike Miller,1610612743,DEN,47,373,22,62,0.355,19,52,0.365,0,0,0.0,6,47,53,40,13,4,17,53,63,116,2.35,0.77,2015,16,1.3404255319148937,2.3529411764705883,40,0,40,1.325
2015-16,RegularSeason,1626174,414,Christian Wood,1610612755,PHI,17,145,22,53,0.415,4,11,0.364,13,21,0.619,13,25,38,3,5,7,2,11,61,73,1.5,2.5,2015,16,3.588235294117647,1.5,31,8,39,0.9743589743589743
2015-16,RegularSeason,201971,414,DeJuan Blair,1610612764,WAS,29,218,28,68,0.412,0,1,0.0,5,13,0.385,20,37,57,11,8,2,15,53,61,76,0.73,0.53,2015,16,2.103448275862069,0.7333333333333333,40,8,48,1.1875
2015-16,RegularSeason,203906,416,Devyn Marble,1610612753,ORL,28,249,21,71,0.296,8,32,0.25,10,24,0.417,6,32,38,12,13,1,7,25,60,53,1.71,1.86,2015,16,2.142857142857143,1.7142857142857142,50,14,64,0.59375
2015-16,RegularSeason,2617,417,Udonis Haslem,1610612748,MIA,37,260,23,61,0.377,1,9,0.111,12,16,0.75,10,65,75,14,5,2,5,25,59,108,2.8,1.0,2015,16,1.5945945945945945,2.8,38,4,42,1.7857142857142858
2015-16,RegularSeason,203915,418,Spencer Dinwiddie,1610612741,CHI,12,159,19,54,0.352,1,10,0.1,19,33,0.576,4,13,17,22,3,0,7,20,58,44,3.14,0.43,2015,16,4.833333333333333,3.142857142857143,35,14,49,0.3469387755102041
2015-16,RegularSeason,201593,419,Nikola Pekovic,1610612750,MIN,12,156,19,50,0.38,0,0,0.0,16,20,0.8,7,14,21,11,1,0,9,22,54,43,1.22,0.11,2015,16,4.5,1.2222222222222223,31,4,35,0.6
2015-16,RegularSeason,200811,420,Lou Amundson,1610612752,NYK,29,204,19,53,0.358,0,0,0.0,14,27,0.519,23,26,49,12,6,7,15,44,52,64,0.8,0.4,2015,16,1.793103448275862,0.8,34,13,47,1.0425531914893618
2015-16,RegularSeason,203142,421,Chris Copeland,1610612749,MIL,24,156,17,51,0.333,10,36,0.278,6,7,0.857,1,9,10,11,2,0,6,17,50,32,1.83,0.33,2015,16,2.0833333333333335,1.8333333333333333,34,1,35,0.2857142857142857
2015-16,RegularSeason,2549,422,Chris Kaman,1610612757,POR,16,112,20,43,0.465,1,4,0.25,3,3,1.0,7,17,24,11,1,1,8,15,44,50,1.38,0.13,2015,16,2.75,1.375,23,0,23,1.0434782608695652
2015-16,RegularSeason,202962,423,Greg Smith,1610612750,MIN,18,192,18,32,0.563,0,0,0.0,7,17,0.412,12,30,42,6,4,1,7,28,43,65,0.86,0.57,2015,16,2.388888888888889,0.8571428571428571,14,10,24,1.75
2015-16,RegularSeason,203996,424,Damien Inglis,1610612749,MIL,20,156,13,37,0.351,3,13,0.231,7,8,0.875,2,29,31,10,6,3,11,11,36,50,0.91,0.55,2015,16,1.8,0.9090909090909091,24,1,25,1.24
2015-16,RegularSeason,202407,424,Elijah Millsap,1610612762,UTA,20,173,11,39,0.282,1,12,0.083,13,18,0.722,6,29,35,19,7,3,9,33,36,58,2.11,0.78,2015,16,1.8,2.111111111111111,28,5,33,1.0606060606060606
2015-16,RegularSeason,1626192,424,Pat Connaughton,1610612757,POR,34,143,13,49,0.265,5,21,0.238,5,5,1.0,11,21,32,10,2,0,10,6,36,34,1.0,0.2,2015,16,1.0588235294117647,1.0,36,0,36,0.8888888888888888
2015-16,RegularSeason,203946,427,Cameron Bairstow,1610612765,DET,18,103,13,40,0.325,1,5,0.2,7,8,0.875,4,24,28,6,2,3,4,19,34,41,1.5,0.5,2015,16,1.8888888888888888,1.5,27,1,28,1.0
2015-16,RegularSeason,1627362,428,Briante Weber,1610612748,MIA,7,169,14,39,0.359,0,5,0.0,3,4,0.75,8,17,25,21,9,3,9,12,31,54,2.33,1.0,2015,16,4.428571428571429,2.3333333333333335,25,1,26,0.9615384615384616
2015-16,RegularSeason,203921,428,Cleanthony Early,1610612752,NYK,17,154,12,40,0.3,4,15,0.267,3,4,0.75,4,22,26,6,2,3,9,16,31,30,0.67,0.22,2015,16,1.8235294117647058,0.6666666666666666,28,1,29,0.896551724137931
2015-16,RegularSeason,201965,430,Jeff Ayres,1610612746,LAC,17,107,12,23,0.522,0,1,0.0,6,6,1.0,4,18,22,5,0,3,6,18,30,43,0.83,0.0,2015,16,1.7647058823529411,0.8333333333333334,11,0,11,2.0
2015-16,RegularSeason,1626210,431,Alan Williams,1610612756,PHX,10,68,10,24,0.417,0,0,0.0,9,14,0.643,14,24,38,5,4,5,6,15,29,56,0.83,0.67,2015,16,2.9,0.8333333333333334,14,5,19,2.0
2015-16,RegularSeason,203923,431,James Young,1610612738,BOS,29,199,11,36,0.306,6,26,0.231,1,4,0.25,4,22,26,9,6,1,5,17,29,38,1.8,1.2,2015,16,1.0,1.8,25,3,28,0.9285714285714286
2015-16,RegularSeason,203461,433,Anthony Bennett,1610612761,TOR,19,84,8,27,0.296,3,14,0.214,9,10,0.9,6,17,23,0,5,0,4,8,28,32,0.0,1.25,2015,16,1.4736842105263157,0.0,19,1,20,1.15
2015-16,RegularSeason,203956,434,Mitch McGary,1610612760,OKC,20,72,11,23,0.478,0,4,0.0,4,10,0.4,4,14,18,3,1,2,7,10,26,25,0.43,0.14,2015,16,1.3,0.42857142857142855,12,6,18,1.0
2015-16,RegularSeason,203111,434,Orlando Johnson,1610612740,NOP,7,102,9,34,0.265,2,10,0.2,6,8,0.75,4,11,15,2,3,3,4,9,26,18,0.5,0.75,2015,16,3.7142857142857144,0.5,25,2,27,0.5555555555555556
2015-16,RegularSeason,204002,436,Edy Tavares,1610612737,ATL,11,73,11,19,0.579,0,0,0.0,3,8,0.375,7,14,21,3,1,6,5,8,25,38,0.6,0.2,2015,16,2.272727272727273,0.6,8,5,13,1.6153846153846154
2015-16,RegularSeason,200779,437,Steve Novak,1610612749,MIL,10,44,8,18,0.444,7,15,0.467,1,1,1.0,0,5,5,0,0,0,1,3,24,18,0.0,0.0,2015,16,2.4,0.0,10,0,10,0.5
2015-16,RegularSeason,202353,437,Tibor Pleiss,1610612762,UTA,12,82,11,25,0.44,0,2,0.0,2,2,1.0,6,9,15,2,1,2,8,19,24,22,0.25,0.13,2015,16,2.0,0.25,14,0,14,1.0714285714285714
2015-16,RegularSeason,203893,439,Russ Smith,1610612763,MEM,15,66,7,22,0.318,1,5,0.2,8,13,0.615,1,8,9,11,5,1,7,5,23,22,1.57,0.71,2015,16,1.5333333333333334,1.5714285714285714,15,5,20,0.45
2015-16,RegularSeason,201619,439,Sasha Kaun,1610612739,CLE,25,95,9,17,0.529,0,0,0.0,5,11,0.455,12,14,26,3,4,5,7,11,23,40,0.43,0.57,2015,16,0.92,0.42857142857142855,8,6,14,1.8571428571428572
2015-16,RegularSeason,1627293,441,Alex Stepheson,1610612763,MEM,8,72,9,27,0.333,0,0,0.0,4,12,0.333,19,9,28,2,1,5,0,12,22,32,0.0,0.0,2015,16,2.75,inf,18,8,26,1.0769230769230769
2015-16,RegularSeason,202726,441,Andrew Goudelock,1610612745,HOU,8,50,9,20,0.45,1,9,0.111,3,4,0.75,1,1,2,4,6,2,7,4,22,17,0.57,0.86,2015,16,2.75,0.5714285714285714,11,1,12,0.16666666666666666
2015-16,RegularSeason,203928,441,Cory Jefferson,1610612756,PHX,8,50,9,22,0.409,0,1,0.0,4,6,0.667,6,10,16,0,0,1,0,8,22,24,0.0,0.0,2015,16,2.75,,13,2,15,1.0666666666666667
2015-16,RegularSeason,201975,441,Jodie Meeks,1610612765,DET,3,43,7,20,0.35,4,9,0.444,4,4,1.0,1,4,5,3,0,0,1,2,22,16,3.0,0.0,2015,16,7.333333333333333,3.0,13,0,13,0.38461538461538464
2015-16,RegularSeason,203268,441,Jorge Gutierrez,1610612766,CHA,12,63,6,11,0.545,0,2,0.0,10,11,0.909,0,7,7,17,3,0,6,3,22,37,2.83,0.5,2015,16,1.8333333333333333,2.8333333333333335,5,1,6,1.1666666666666667
2015-16,RegularSeason,1626175,446,Jordan Mickey,1610612738,BOS,16,57,8,22,0.364,0,0,0.0,5,10,0.5,6,7,13,1,0,11,1,5,21,26,1.0,0.0,2015,16,1.3125,1.0,14,5,19,0.6842105263157895
2015-16,RegularSeason,203485,447,Lorenzo Brown,1610612765,DET,8,61,8,25,0.32,1,8,0.125,3,4,0.75,0,7,7,11,3,1,9,4,20,15,1.22,0.33,2015,16,2.5,1.2222222222222223,17,1,18,0.3888888888888889
2015-16,RegularSeason,1626151,448,Aaron Harrison,1610612766,CHA,21,93,5,19,0.263,3,10,0.3,5,12,0.417,4,11,15,2,6,0,4,10,18,16,0.5,1.5,2015,16,0.8571428571428571,0.5,14,7,21,0.7142857142857143
2015-16,RegularSeason,201202,448,Joel Anthony,1610612765,DET,19,96,6,10,0.6,0,0,0.0,6,8,0.75,8,13,21,1,2,12,2,15,18,46,0.5,1.0,2015,16,0.9473684210526315,0.5,4,2,6,3.5
2015-16,RegularSeason,203962,450,Josh Huestis,1610612760,OKC,5,55,5,12,0.417,4,6,0.667,0,4,0.0,2,8,10,0,1,2,3,3,14,13,0.0,0.33,2015,16,2.8,0.0,7,4,11,0.9090909090909091
2015-16,RegularSeason,1626242,450,Luis Montero,1610612757,POR,12,42,5,19,0.263,1,9,0.111,3,4,0.75,0,4,4,1,0,0,4,1,14,0,0.25,0.0,2015,16,1.1666666666666667,0.25,14,1,15,0.26666666666666666
2015-16,RegularSeason,2563,452,Dahntay Jones,1610612739,CLE,1,42,6,14,0.429,1,2,0.5,0,0,0.0,1,4,5,2,1,2,0,6,13,15,0.0,0.0,2015,16,13.0,inf,8,0,8,0.625
2015-16,RegularSeason,203475,452,Erick Green,1610612743,DEN,9,42,5,13,0.385,1,5,0.2,2,2,1.0,3,3,6,3,1,0,0,4,13,15,0.0,0.0,2015,16,1.4444444444444444,inf,8,0,8,0.75
2015-16,RegularSeason,202712,452,Justin Harper,1610612751,BKN,5,35,4,10,0.4,4,9,0.444,1,2,0.5,0,1,1,0,1,0,2,3,13,6,0.0,0.5,2015,16,2.6,0.0,6,1,7,0.14285714285714285
2015-16,RegularSeason,203963,455,Shayne Whittington,1610612754,IND,7,41,5,11,0.455,0,2,0.0,1,2,0.5,5,7,12,3,1,1,5,7,11,16,0.6,0.2,2015,16,1.5714285714285714,0.6,6,1,7,1.7142857142857142
2015-16,RegularSeason,1626146,456,Cliff Alexander,1610612757,POR,8,36,5,10,0.5,0,0,0.0,0,0,0.0,2,4,6,0,1,2,1,1,10,13,0.0,1.0,2015,16,1.25,0.0,5,0,5,1.2
2015-16,RegularSeason,202690,457,Jimmer Fredette,1610612759,SAS,6,18,2,5,0.4,1,2,0.5,4,5,0.8,0,0,0,1,1,0,2,2,9,5,0.5,0.5,2015,16,1.5,0.5,3,1,4,0.0
2015-16,RegularSeason,1626172,457,Kevon Looney,1610612744,GSW,5,21,4,7,0.571,1,2,0.5,0,0,0.0,4,6,10,0,0,0,1,2,9,15,0.0,0.0,2015,16,1.8,0.0,3,0,3,3.3333333333333335
2015-16,RegularSeason,203955,459,Bryce Cotton,1610612763,MEM,8,39,4,10,0.4,0,3,0.0,0,0,0.0,0,0,0,3,3,0,5,2,8,3,0.6,0.6,2015,16,1.0,0.6,6,0,6,0.0
2015-16,RegularSeason,202343,459,Elliot Williams,1610612766,CHA,5,45,2,10,0.2,1,4,0.25,3,4,0.75,1,3,4,4,0,0,1,2,8,6,4.0,0.0,2015,16,1.6,4.0,8,1,9,0.4444444444444444
2015-16,RegularSeason,203961,459,Eric Moreland,1610612758,SAC,8,48,3,6,0.5,0,0,0.0,2,4,0.5,3,8,11,1,0,4,3,4,8,16,0.33,0.0,2015,16,1.0,0.3333333333333333,3,2,5,2.2
2015-16,RegularSeason,1737,459,Nazr Mohammed,1610612760,OKC,5,19,3,5,0.6,0,0,0.0,2,2,1.0,1,3,4,0,0,0,3,4,8,7,0.0,0.0,2015,16,1.6,0.0,2,0,2,2.0
2015-16,RegularSeason,203950,463,Jarnell Stokes,1610612763,MEM,7,19,3,5,0.6,0,0,0.0,1,2,0.5,1,3,4,1,1,0,0,1,7,10,0.0,0.0,2015,16,1.0,inf,2,1,3,1.3333333333333333
2015-16,RegularSeason,203919,463,Jordan Adams,1610612763,MEM,2,15,2,6,0.333,0,1,0.0,3,5,0.6,0,2,2,3,3,0,2,2,7,7,1.5,1.5,2015,16,3.5,1.5,4,2,6,0.3333333333333333
2015-16,RegularSeason,1626262,465,Coty Clarke,1610612738,BOS,3,6,2,4,0.5,2,2,1.0,0,0,0.0,0,1,1,0,0,0,1,0,6,4,0.0,0.0,2015,16,2.0,0.0,2,0,2,0.5
2015-16,RegularSeason,1626251,465,Duje Dukan,1610612758,SAC,1,24,2,10,0.2,2,5,0.4,0,0,0.0,2,2,4,1,1,0,0,2,6,4,0.0,0.0,2015,16,6.0,inf,8,0,8,0.5
2015-16,RegularSeason,203951,465,Keith Appling,1610612753,ORL,5,27,2,8,0.25,0,3,0.0,2,2,1.0,0,1,1,1,1,0,3,5,6,0,0.33,0.33,2015,16,1.2,0.3333333333333333,6,0,6,0.16666666666666666
2015-16,RegularSeason,203648,465,Thanasis Antetokounmpo,1610612752,NYK,2,6,3,4,0.75,0,1,0.0,0,0,0.0,0,1,1,0,0,0,0,2,6,6,0.0,0.0,2015,16,3.0,,1,0,1,1.0
2015-16,RegularSeason,1626183,469,Branden Dawson,1610612746,LAC,6,29,2,5,0.4,0,0,0.0,1,1,1.0,2,2,4,0,0,1,0,2,5,7,0.0,0.0,2015,16,0.8333333333333334,,3,0,3,1.3333333333333333
2015-16,RegularSeason,101236,470,Chuck Hayes,1610612746,LAC,2,24,1,2,0.5,0,0,0.0,2,2,1.0,0,8,8,2,0,0,3,6,4,10,0.67,0.0,2015,16,2.0,0.6666666666666666,1,0,1,8.0
2015-16,RegularSeason,1626176,470,Rakeem Christmas,1610612754,IND,1,6,2,2,1.0,0,0,0.0,0,0,0.0,1,0,1,0,0,0,0,1,4,5,0.0,0.0,2015,16,4.0,,0,0,0,inf
2015-16,RegularSeason,203998,472,Bruno Caboclo,1610612761,TOR,6,43,1,12,0.083,1,7,0.143,0,0,0.0,1,1,2,1,2,1,4,2,3,-6,0.25,0.5,2015,16,0.5,0.25,11,0,11,0.18181818181818182
2015-16,RegularSeason,203925,472,Joe Harris,1610612739,CLE,5,15,1,4,0.25,1,4,0.25,0,0,0.0,0,3,3,2,0,0,1,1,3,4,2.0,0.0,2015,16,0.6,2.0,3,0,3,1.0
2015-16,RegularSeason,1626266,474,JJ O'Brien,1610612762,UTA,2,6,0,1,0.0,0,0,0.0,0,0,0.0,0,1,1,0,1,0,0,1,0,1,0.0,0.0,2015,16,0.0,,1,0,1,1.0
2015-16,RegularSeason,101126,474,Nate Robinson,1610612740,NOP,2,23,0,1,0.0,0,1,0.0,0,0,0.0,0,0,0,4,1,0,0,5,0,4,0.0,0.0,2015,16,0.0,inf,1,0,1,0.0
2015-16,RegularSeason,1626155,474,Sam Dekker,1610612745,HOU,3,6,0,0,0.0,0,0,0.0,0,0,0.0,0,1,1,0,1,0,0,0,0,2,0.0,0.0,2015,16,0.0,,0,0,0,inf
2015-16,Playoffs,202691,1,Klay Thompson,1610612744,GSW,24,849,201,453,0.444,98,231,0.424,82,96,0.854,15,73,88,54,26,9,47,53,582,446,1.15,0.55,2015,16,24.25,1.148936170212766,252,14,266,0.3308270676691729
2015-16,Playoffs,2544,2,LeBron James,1610612739,CLE,21,822,219,417,0.525,32,94,0.34,82,124,0.661,42,158,200,160,49,27,75,54,552,673,2.13,0.65,2015,16,26.285714285714285,2.1333333333333333,198,42,240,0.8333333333333334
2015-16,Playoffs,202681,3,Kyrie Irving,1610612739,CLE,21,774,201,423,0.475,51,116,0.44,77,88,0.875,15,47,62,98,36,13,48,46,530,458,2.04,0.75,2015,16,25.238095238095237,2.0416666666666665,222,11,233,0.26609442060085836
2015-16,Playoffs,201142,4,Kevin Durant,1610612760,OKC,18,726,175,407,0.43,31,110,0.282,130,146,0.89,13,115,128,60,18,18,65,37,511,422,0.92,0.28,2015,16,28.38888888888889,0.9230769230769231,232,16,248,0.5161290322580645
2015-16,Playoffs,201566,5,Russell Westbrook,1610612760,OKC,18,674,159,393,0.405,34,105,0.324,116,140,0.829,41,83,124,198,46,2,78,43,468,502,2.54,0.59,2015,16,26.0,2.5384615384615383,234,24,258,0.4806201550387597
2015-16,Playoffs,201939,6,Stephen Curry,1610612744,GSW,18,614,148,338,0.438,80,198,0.404,76,83,0.916,14,85,99,93,26,5,75,39,452,403,1.24,0.35,2015,16,25.11111111111111,1.24,190,7,197,0.5025380710659898
2015-16,Playoffs,201942,7,DeMar DeRozan,1610612761,TOR,20,746,157,398,0.394,4,26,0.154,100,123,0.813,13,70,83,54,22,3,45,52,418,271,1.2,0.49,2015,16,20.9,1.2,241,23,264,0.3143939393939394
2015-16,Playoffs,200768,8,Kyle Lowry,1610612761,TOR,20,766,131,330,0.397,42,138,0.304,78,104,0.75,18,76,94,119,32,3,63,73,382,342,1.89,0.51,2015,16,19.1,1.8888888888888888,199,26,225,0.4177777777777778
2015-16,Playoffs,203110,9,Draymond Green,1610612744,GSW,23,879,119,276,0.431,38,104,0.365,79,107,0.738,38,190,228,138,37,41,56,81,355,558,2.46,0.66,2015,16,15.434782608695652,2.4642857142857144,157,28,185,1.2324324324324325
2015-16,Playoffs,2548,10,Dwyane Wade,1610612748,MIA,14,473,119,254,0.469,12,23,0.522,50,64,0.781,12,67,79,60,11,13,38,22,300,276,1.58,0.29,2015,16,21.428571428571427,1.5789473684210527,135,14,149,0.5302013422818792
2015-16,Playoffs,201567,11,Kevin Love,1610612739,CLE,20,613,92,239,0.385,46,111,0.414,63,75,0.84,34,141,175,42,9,8,27,34,293,341,1.56,0.33,2015,16,14.65,1.5555555555555556,147,12,159,1.10062893081761
2015-16,Playoffs,203081,12,Damian Lillard,1610612757,POR,11,437,89,242,0.368,42,107,0.393,71,78,0.91,12,35,47,69,14,3,33,23,291,231,2.09,0.42,2015,16,26.454545454545453,2.090909090909091,153,7,160,0.29375
2015-16,Playoffs,2747,13,JR Smith,1610612739,CLE,21,730,82,188,0.436,65,151,0.43,13,21,0.619,7,60,67,29,26,5,11,55,242,244,2.64,2.36,2015,16,11.523809523809524,2.6363636363636362,106,8,114,0.5877192982456141
2015-16,Playoffs,201609,14,Goran Dragic,1610612748,MIA,14,472,91,206,0.442,16,46,0.348,33,43,0.767,11,58,69,54,6,3,31,46,231,207,1.74,0.19,2015,16,16.5,1.7419354838709677,115,10,125,0.552
2015-16,Playoffs,203468,15,CJ McCollum,1610612757,POR,11,442,84,197,0.426,20,58,0.345,37,46,0.804,7,33,40,36,10,5,20,30,225,174,1.8,0.5,2015,16,20.454545454545453,1.8,113,9,122,0.32786885245901637
2015-16,Playoffs,202695,15,Kawhi Leonard,1610612759,SAS,10,339,83,166,0.5,17,39,0.436,42,51,0.824,14,49,63,28,26,14,16,21,225,248,1.75,1.63,2015,16,22.5,1.75,83,9,92,0.6847826086956522
2015-16,Playoffs,200746,17,LaMarcus Aldridge,1610612759,SAS,10,337,88,169,0.521,2,2,1.0,41,46,0.891,22,61,83,10,4,14,11,18,219,233,0.91,0.36,2015,16,21.9,0.9090909090909091,81,5,86,0.9651162790697675
2015-16,Playoffs,203084,18,Harrison Barnes,1610612744,GSW,24,743,82,213,0.385,26,76,0.342,26,34,0.765,27,85,112,30,17,4,18,46,216,222,1.67,0.94,2015,16,9.0,1.6666666666666667,131,8,139,0.8057553956834532
2015-16,Playoffs,201586,18,Serge Ibaka,1610612760,OKC,18,602,85,163,0.521,31,69,0.449,15,20,0.75,23,90,113,10,14,24,9,51,216,285,1.11,1.56,2015,16,12.0,1.1111111111111112,78,5,83,1.3614457831325302
2015-16,Playoffs,2738,20,Andre Iguodala,1610612744,GSW,24,767,78,164,0.476,25,65,0.385,32,57,0.561,35,70,105,90,29,10,23,37,213,313,3.91,1.26,2015,16,8.875,3.9130434782608696,86,25,111,0.9459459459459459
2015-16,Playoffs,2733,21,Shaun Livingston,1610612744,GSW,24,514,82,168,0.488,0,1,0.0,32,37,0.865,13,63,76,80,12,5,29,48,196,249,2.76,0.41,2015,16,8.166666666666666,2.7586206896551726,86,5,91,0.8351648351648352
2015-16,Playoffs,202331,22,Paul George,1610612754,IND,7,275,56,123,0.455,18,43,0.419,61,64,0.953,9,44,53,30,14,5,23,24,191,200,1.3,0.61,2015,16,27.285714285714285,1.3043478260869565,67,3,70,0.7571428571428571
2015-16,Playoffs,2736,23,Luol Deng,1610612748,MIA,14,495,65,138,0.471,24,57,0.421,32,38,0.842,19,64,83,22,13,9,23,24,186,211,0.96,0.56,2015,16,13.285714285714286,0.9565217391304348,73,6,79,1.0506329113924051
2015-16,Playoffs,203500,24,Steven Adams,1610612760,OKC,18,553,68,111,0.613,0,1,0.0,46,73,0.63,62,109,171,13,9,14,17,55,182,302,0.77,0.53,2015,16,10.11111111111111,0.7647058823529411,43,27,70,2.442857142857143
2015-16,Playoffs,201960,25,DeMarre Carroll,1610612761,TOR,20,596,62,159,0.39,26,79,0.329,27,36,0.75,23,58,81,17,18,7,18,62,177,176,0.94,1.0,2015,16,8.85,0.9444444444444444,97,9,106,0.7641509433962265
2015-16,Playoffs,202709,26,Cory Joseph,1610612761,TOR,20,452,69,148,0.466,8,24,0.333,24,32,0.75,11,30,41,47,18,2,22,47,170,169,2.14,0.82,2015,16,8.5,2.1363636363636362,79,8,87,0.47126436781609193
2015-16,Playoffs,202683,26,Enes Freedom,1610612760,OKC,18,323,65,118,0.551,2,14,0.143,38,45,0.844,47,64,111,5,5,11,17,40,170,225,0.29,0.29,2015,16,9.444444444444445,0.29411764705882354,53,7,60,1.85
2015-16,Playoffs,2207,26,Joe Johnson,1610612748,MIA,14,492,68,158,0.43,13,46,0.283,21,24,0.875,7,59,66,35,8,3,18,27,170,171,1.94,0.44,2015,16,12.142857142857142,1.9444444444444444,90,3,93,0.7096774193548387
2015-16,Playoffs,200794,29,Paul Millsap,1610612737,ATL,10,365,59,137,0.431,8,33,0.242,41,55,0.745,28,66,94,27,13,23,26,29,167,206,1.04,0.5,2015,16,16.7,1.0384615384615385,78,14,92,1.0217391304347827
2015-16,Playoffs,202685,30,Jonas Valanciunas,1610612761,TOR,12,321,68,120,0.567,0,0,0.0,29,39,0.744,48,81,129,11,10,14,18,32,165,249,0.61,0.56,2015,16,13.75,0.6111111111111112,52,10,62,2.0806451612903225
2015-16,Playoffs,202329,31,Al-Farouq Aminu,1610612757,POR,11,372,56,128,0.438,28,70,0.4,21,29,0.724,23,72,95,20,8,10,21,31,161,193,0.95,0.38,2015,16,14.636363636363637,0.9523809523809523,72,8,80,1.1875
2015-16,Playoffs,202689,32,Kemba Walker,1610612766,CHA,7,260,56,153,0.366,14,43,0.326,33,35,0.943,3,18,21,28,9,4,12,10,159,110,2.33,0.75,2015,16,22.714285714285715,2.3333333333333335,97,2,99,0.21212121212121213
2015-16,Playoffs,202335,33,Patrick Patterson,1610612761,TOR,20,583,55,136,0.404,21,70,0.3,22,26,0.846,29,48,77,24,7,9,18,31,153,167,1.33,0.39,2015,16,7.65,1.3333333333333333,81,4,85,0.9058823529411765
2015-16,Playoffs,203079,34,Dion Waiters,1610612760,OKC,18,491,55,132,0.417,21,56,0.375,20,30,0.667,6,41,47,42,10,3,20,42,151,146,2.1,0.5,2015,16,8.38888888888889,2.1,77,10,87,0.5402298850574713
2015-16,Playoffs,202738,35,Isaiah Thomas,1610612738,BOS,6,220,47,119,0.395,13,46,0.283,38,47,0.809,2,16,18,30,4,5,14,18,145,107,2.14,0.29,2015,16,24.166666666666668,2.142857142857143,72,9,81,0.2222222222222222
2015-16,Playoffs,201952,35,Jeff Teague,1610612737,ATL,10,279,46,121,0.38,9,36,0.25,44,52,0.846,3,16,19,61,6,2,25,30,145,125,2.44,0.24,2015,16,14.5,2.44,75,8,83,0.2289156626506024
2015-16,Playoffs,202684,37,Tristan Thompson,1610612739,CLE,21,622,49,93,0.527,0,0,0.0,42,73,0.575,86,102,188,15,8,18,17,55,140,277,0.88,0.47,2015,16,6.666666666666667,0.8823529411764706,44,31,75,2.506666666666667
2015-16,Playoffs,201143,38,Al Horford,1610612737,ATL,10,327,54,116,0.466,11,28,0.393,15,16,0.938,13,52,65,31,12,24,17,25,134,186,1.82,0.71,2015,16,13.4,1.8235294117647058,62,1,63,1.0317460317460319
2015-16,Playoffs,201578,38,Marreese Speights,1610612744,GSW,24,201,46,118,0.39,18,43,0.419,24,31,0.774,15,32,47,11,3,8,20,43,134,104,0.55,0.15,2015,16,5.583333333333333,0.55,72,7,79,0.5949367088607594
2015-16,Playoffs,201935,40,James Harden,1610612745,HOU,5,193,41,100,0.41,13,42,0.31,38,45,0.844,7,19,26,38,12,1,26,13,133,118,1.46,0.46,2015,16,26.6,1.4615384615384615,59,7,66,0.3939393939393939
2015-16,Playoffs,2571,41,Leandro Barbosa,1610612744,GSW,23,254,51,88,0.58,11,28,0.393,16,21,0.762,11,16,27,15,11,1,11,24,129,130,1.36,1.0,2015,16,5.608695652173913,1.3636363636363635,37,5,42,0.6428571428571429
2015-16,Playoffs,203082,42,Terrence Ross,1610612761,TOR,20,335,46,119,0.387,21,64,0.328,13,20,0.65,4,28,32,11,13,5,16,28,126,91,0.69,0.81,2015,16,6.3,0.6875,73,7,80,0.4
2015-16,Playoffs,202687,43,Bismack Biyombo,1610612761,TOR,20,506,40,69,0.58,0,0,0.0,43,72,0.597,53,134,187,8,8,27,21,48,123,274,0.38,0.38,2015,16,6.15,0.38095238095238093,29,29,58,3.2241379310344827
2015-16,Playoffs,203090,44,Maurice Harkless,1610612757,POR,11,272,47,110,0.427,15,44,0.341,12,25,0.48,22,34,56,7,10,3,11,38,121,110,0.64,0.91,2015,16,11.0,0.6363636363636364,63,13,76,0.7368421052631579
2015-16,Playoffs,202355,45,Hassan Whiteside,1610612748,MIA,10,291,47,69,0.681,0,0,0.0,26,44,0.591,26,83,109,3,8,28,13,34,120,215,0.23,0.61,2015,16,12.0,0.23076923076923078,22,18,40,2.725
2015-16,Playoffs,203145,46,Kent Bazemore,1610612737,ATL,10,325,44,121,0.364,16,61,0.262,15,22,0.682,8,58,66,19,15,6,10,14,119,131,1.9,1.5,2015,16,11.9,1.9,77,7,84,0.7857142857142857
2015-16,Playoffs,203471,47,Dennis Schroder,1610612737,ATL,10,191,47,104,0.452,12,35,0.343,11,13,0.846,6,13,19,36,4,1,21,24,117,97,1.71,0.19,2015,16,11.7,1.7142857142857142,57,2,59,0.3220338983050847
2015-16,Playoffs,101112,48,Channing Frye,1610612739,CLE,17,237,41,69,0.594,26,46,0.565,6,7,0.857,5,36,41,5,6,9,5,37,114,141,1.0,1.2,2015,16,6.705882352941177,1.0,28,1,29,1.4137931034482758
2015-16,Playoffs,2210,48,Richard Jefferson,1610612739,CLE,21,381,44,84,0.524,11,28,0.393,15,20,0.75,16,58,74,14,10,1,13,34,114,155,1.08,0.77,2015,16,5.428571428571429,1.0769230769230769,40,5,45,1.6444444444444444
2015-16,Playoffs,203459,50,Allen Crabbe,1610612757,POR,11,302,38,73,0.521,15,35,0.429,14,19,0.737,5,27,32,15,7,1,6,23,105,114,2.5,1.17,2015,16,9.545454545454545,2.5,35,5,40,0.8
2015-16,Playoffs,2037,51,Jamal Crawford,1610612746,LAC,6,199,39,103,0.379,4,21,0.19,22,25,0.88,2,11,13,13,10,0,9,9,104,64,1.44,1.11,2015,16,17.333333333333332,1.4444444444444444,64,3,67,0.19402985074626866
2015-16,Playoffs,2225,51,Tony Parker,1610612759,SAS,10,264,44,98,0.449,4,16,0.25,12,14,0.857,1,21,22,53,6,2,18,15,104,113,2.94,0.33,2015,16,10.4,2.9444444444444446,54,2,56,0.39285714285714285
2015-16,Playoffs,2594,53,Kyle Korver,1610612737,ATL,10,316,35,75,0.467,24,54,0.444,9,9,1.0,3,45,48,10,9,4,8,23,103,126,1.25,1.13,2015,16,10.3,1.25,40,0,40,1.2
2015-16,Playoffs,1717,54,Dirk Nowitzki,1610612742,DAL,5,170,41,83,0.494,4,11,0.364,16,17,0.941,3,21,24,8,2,3,7,9,102,89,1.14,0.29,2015,16,20.4,1.1428571428571428,42,1,43,0.5581395348837209
2015-16,Playoffs,101106,55,Andrew Bogut,1610612744,GSW,22,365,48,77,0.623,0,2,0.0,5,14,0.357,47,78,125,30,14,35,19,72,101,248,1.58,0.74,2015,16,4.590909090909091,1.5789473684210527,29,9,38,3.289473684210526
2015-16,Playoffs,203460,56,Andre Roberson,1610612760,OKC,18,471,40,86,0.465,12,37,0.324,8,20,0.4,25,76,101,14,23,19,11,45,100,188,1.27,2.09,2015,16,5.555555555555555,1.2727272727272727,46,12,58,1.7413793103448276
2015-16,Playoffs,101108,57,Chris Paul,1610612746,LAC,4,125,37,76,0.487,6,20,0.3,15,15,1.0,4,12,16,29,9,0,4,12,95,106,7.25,2.25,2015,16,23.75,7.25,39,0,39,0.41025641025641024
2015-16,Playoffs,201588,57,George Hill,1610612754,IND,7,235,32,57,0.561,13,27,0.481,18,22,0.818,6,13,19,15,6,1,8,16,95,99,1.88,0.75,2015,16,13.571428571428571,1.875,25,4,29,0.6551724137931034
2015-16,Playoffs,2744,59,Al Jefferson,1610612766,CHA,7,168,42,83,0.506,0,0,0.0,9,13,0.692,14,29,43,8,4,3,6,12,93,100,1.33,0.67,2015,16,13.285714285714286,1.3333333333333333,41,4,45,0.9555555555555556
2015-16,Playoffs,203105,59,Festus Ezeli,1610612744,GSW,23,203,37,69,0.536,0,0,0.0,19,44,0.432,23,38,61,8,1,7,14,34,93,99,0.57,0.07,2015,16,4.043478260869565,0.5714285714285714,32,25,57,1.0701754385964912
2015-16,Playoffs,1626196,59,Josh Richardson,1610612748,MIA,14,387,33,89,0.371,17,46,0.37,10,14,0.714,10,40,50,22,6,13,12,37,93,112,1.83,0.5,2015,16,6.642857142857143,1.8333333333333333,56,4,60,0.8333333333333334
2015-16,Playoffs,1626159,62,Justise Winslow,1610612748,MIA,13,330,32,74,0.432,5,18,0.278,21,30,0.7,17,46,63,8,8,4,12,35,90,110,0.67,0.67,2015,16,6.923076923076923,0.6666666666666666,42,9,51,1.2352941176470589
2015-16,Playoffs,202391,63,Jeremy Lin,1610612766,CHA,7,189,26,63,0.413,3,14,0.214,32,39,0.821,3,13,16,18,5,0,11,21,87,71,1.64,0.46,2015,16,12.428571428571429,1.6363636363636365,37,7,44,0.36363636363636365
2015-16,Playoffs,201980,64,Danny Green,1610612759,SAS,10,267,30,65,0.462,24,48,0.5,2,3,0.667,0,31,31,7,21,8,6,20,86,111,1.17,3.5,2015,16,8.6,1.1666666666666667,35,1,36,0.8611111111111112
2015-16,Playoffs,200755,65,JJ Redick,1610612746,LAC,6,166,34,79,0.43,11,31,0.355,2,3,0.667,1,11,12,5,1,1,5,11,81,49,1.0,0.2,2015,16,13.5,1.0,45,1,46,0.2608695652173913
2015-16,Playoffs,101145,65,Monta Ellis,1610612754,IND,7,225,33,76,0.434,7,21,0.333,8,10,0.8,4,23,27,30,15,0,17,17,81,91,1.76,0.88,2015,16,11.571428571428571,1.7647058823529411,43,2,45,0.6
2015-16,Playoffs,202323,67,Evan Turner,1610612738,BOS,6,214,31,85,0.365,3,14,0.214,14,18,0.778,8,26,34,27,8,6,17,19,79,79,1.59,0.47,2015,16,13.166666666666666,1.588235294117647,54,4,58,0.5862068965517241
2015-16,Playoffs,203521,68,Matthew Dellavedova,1610612739,CLE,20,241,26,74,0.351,8,31,0.258,18,24,0.75,4,11,15,56,1,1,14,31,78,83,4.0,0.07,2015,16,3.9,4.0,48,6,54,0.2777777777777778
2015-16,Playoffs,203486,69,Mason Plumlee,1610612757,POR,11,306,28,70,0.4,0,0,0.0,21,33,0.636,37,93,130,53,7,11,25,42,77,199,2.12,0.28,2015,16,7.0,2.12,42,12,54,2.4074074074074074
2015-16,Playoffs,201945,70,Gerald Henderson,1610612757,POR,11,234,30,82,0.366,7,19,0.368,9,12,0.75,6,29,35,17,6,3,5,21,76,77,3.4,1.2,2015,16,6.909090909090909,3.4,52,3,55,0.6363636363636364
2015-16,Playoffs,101109,71,Raymond Felton,1610612742,DAL,5,172,32,69,0.464,4,14,0.286,7,11,0.636,2,21,23,23,6,0,12,14,75,74,1.92,0.5,2015,16,15.0,1.9166666666666667,37,4,41,0.5609756097560976
2015-16,Playoffs,203935,72,Marcus Smart,1610612738,BOS,6,193,22,60,0.367,11,32,0.344,17,21,0.81,8,19,27,18,10,5,15,17,72,75,1.2,0.67,2015,16,12.0,1.2,38,4,42,0.6428571428571429
2015-16,Playoffs,1626167,72,Myles Turner,1610612754,IND,7,197,33,71,0.465,0,2,0.0,6,9,0.667,16,29,45,3,2,23,12,24,72,92,0.25,0.17,2015,16,10.285714285714286,0.25,38,3,41,1.0975609756097562
2015-16,Playoffs,202694,74,Marcus Morris Sr.,1610612765,DET,4,144,22,47,0.468,7,18,0.389,20,23,0.87,2,11,13,10,2,0,5,17,71,63,2.0,0.4,2015,16,17.75,2.0,25,3,28,0.4642857142857143
2015-16,Playoffs,201599,75,DeAndre Jordan,1610612746,LAC,6,198,24,38,0.632,0,0,0.0,22,59,0.373,30,68,98,11,7,16,7,17,70,144,1.57,1.0,2015,16,11.666666666666666,1.5714285714285714,14,37,51,1.9215686274509804
2015-16,Playoffs,202697,75,Iman Shumpert,1610612739,CLE,21,367,25,60,0.417,13,34,0.382,7,11,0.636,10,37,47,17,10,3,13,36,70,95,1.31,0.77,2015,16,3.3333333333333335,1.3076923076923077,35,4,39,1.205128205128205
2015-16,Playoffs,1626181,77,Norman Powell,1610612761,TOR,18,206,27,70,0.386,7,26,0.269,7,8,0.875,4,23,27,6,13,2,5,18,68,67,1.2,2.6,2015,16,3.7777777777777777,1.2,43,1,44,0.6136363636363636
2015-16,Playoffs,203083,78,Andre Drummond,1610612765,DET,4,131,28,54,0.519,0,1,0.0,11,34,0.324,12,24,36,0,1,6,4,8,67,57,0.0,0.25,2015,16,16.75,0.0,26,23,49,0.7346938775510204
2015-16,Playoffs,1938,78,Manu Ginobili,1610612759,SAS,10,192,20,47,0.426,9,21,0.429,18,23,0.783,6,21,27,25,8,3,7,25,67,91,3.57,1.14,2015,16,6.7,3.5714285714285716,27,5,32,0.84375
2015-16,Playoffs,2730,80,Dwight Howard,1610612745,HOU,5,180,26,48,0.542,0,1,0.0,14,38,0.368,26,44,70,8,4,7,12,21,66,97,0.67,0.33,2015,16,13.2,0.6666666666666666,22,24,46,1.5217391304347827
2015-16,Playoffs,203546,80,Ian Clark,1610612744,GSW,16,154,26,53,0.491,6,18,0.333,8,10,0.8,2,15,17,16,8,0,9,18,66,69,1.78,0.89,2015,16,4.125,1.7777777777777777,27,2,29,0.5862068965517241
2015-16,Playoffs,201988,80,Patty Mills,1610612759,SAS,10,167,23,53,0.434,13,36,0.361,7,11,0.636,0,14,14,20,7,0,8,3,66,65,2.5,0.88,2015,16,6.6,2.5,30,4,34,0.4117647058823529
2015-16,Playoffs,203118,83,Mike Scott,1610612737,ATL,10,161,25,40,0.625,8,16,0.5,7,8,0.875,5,27,32,5,3,3,8,20,65,84,0.63,0.38,2015,16,6.5,0.625,15,1,16,2.0
2015-16,Playoffs,202083,83,Wesley Matthews,1610612742,DAL,5,173,20,60,0.333,10,35,0.286,15,19,0.789,4,14,18,6,6,0,4,14,65,47,1.5,1.5,2015,16,13.0,1.5,40,4,44,0.4090909090909091
2015-16,Playoffs,203085,85,Austin Rivers,1610612746,LAC,6,144,26,61,0.426,4,17,0.235,6,9,0.667,4,12,16,16,3,0,7,12,62,52,2.29,0.43,2015,16,10.333333333333334,2.2857142857142856,35,3,38,0.42105263157894735
2015-16,Playoffs,202334,86,Ed Davis,1610612757,POR,11,205,21,40,0.525,0,2,0.0,19,33,0.576,26,49,75,14,2,7,10,33,61,116,1.4,0.2,2015,16,5.545454545454546,1.4,19,14,33,2.272727272727273
2015-16,Playoffs,201145,86,Jeff Green,1610612746,LAC,6,159,21,46,0.457,4,10,0.4,15,25,0.6,3,16,19,4,6,2,3,12,61,54,1.33,2.0,2015,16,10.166666666666666,1.3333333333333333,25,10,35,0.5428571428571428
2015-16,Playoffs,203484,86,Kentavious Caldwell-Pope,1610612765,DET,4,161,22,50,0.44,12,27,0.444,5,7,0.714,2,15,17,11,7,1,2,7,61,65,5.5,3.5,2015,16,15.25,5.5,28,2,30,0.5666666666666667
2015-16,Playoffs,201933,89,Blake Griffin,1610612746,LAC,4,127,20,53,0.377,1,2,0.5,19,25,0.76,7,28,35,16,3,2,9,9,60,68,1.78,0.33,2015,16,15.0,1.7777777777777777,33,6,39,0.8974358974358975
2015-16,Playoffs,201584,89,Courtney Lee,1610612766,CHA,7,257,21,51,0.412,4,9,0.444,14,15,0.933,5,15,20,9,6,3,5,19,60,62,1.8,1.2,2015,16,8.571428571428571,1.8,30,1,31,0.6451612903225806
2015-16,Playoffs,203469,91,Cody Zeller,1610612766,CHA,7,137,21,38,0.553,0,0,0.0,17,21,0.81,9,28,37,2,1,3,7,20,59,74,0.29,0.14,2015,16,8.428571428571429,0.2857142857142857,17,4,21,1.7619047619047619
2015-16,Playoffs,200757,91,Thabo Sefolosha,1610612737,ATL,10,203,22,46,0.478,7,19,0.368,8,15,0.533,8,33,41,17,10,6,10,17,59,92,1.7,1.0,2015,16,5.9,1.7,24,7,31,1.3225806451612903
2015-16,Playoffs,1495,91,Tim Duncan,1610612759,SAS,10,218,22,52,0.423,0,0,0.0,15,21,0.714,10,38,48,14,2,13,10,18,59,90,1.4,0.2,2015,16,5.9,1.4,30,6,36,1.3333333333333333
2015-16,Playoffs,2561,94,David West,1610612759,SAS,10,176,25,55,0.455,3,6,0.5,5,9,0.556,13,24,37,13,6,7,7,19,58,80,1.86,0.86,2015,16,5.8,1.8571428571428572,30,4,34,1.088235294117647
2015-16,Playoffs,202699,94,Tobias Harris,1610612765,DET,4,156,21,46,0.457,4,12,0.333,12,13,0.923,6,32,38,12,3,3,6,11,58,82,2.0,0.5,2015,16,14.5,2.0,25,1,26,1.4615384615384615
2015-16,Playoffs,101133,96,Ian Mahinmi,1610612754,IND,7,172,21,42,0.5,0,0,0.0,15,25,0.6,12,24,36,8,5,6,14,25,57,67,0.57,0.36,2015,16,8.142857142857142,0.5714285714285714,21,10,31,1.1612903225806452
2015-16,Playoffs,203109,96,Jae Crowder,1610612738,BOS,6,197,20,72,0.278,10,41,0.244,7,11,0.636,5,34,39,13,9,3,7,17,57,58,1.86,1.29,2015,16,9.5,1.8571428571428572,52,4,56,0.6964285714285714
2015-16,Playoffs,201587,96,Nicolas Batum,1610612766,CHA,5,144,17,45,0.378,6,22,0.273,17,20,0.85,2,16,18,10,2,0,8,6,57,48,1.25,0.25,2015,16,11.4,1.25,28,3,31,0.5806451612903226
2015-16,Playoffs,202704,96,Reggie Jackson,1610612765,DET,4,147,25,55,0.455,3,18,0.167,4,4,1.0,2,11,13,37,6,2,10,10,57,75,3.7,0.6,2015,16,14.25,3.7,30,0,30,0.43333333333333335
2015-16,Playoffs,201973,100,Jonas Jerebko,1610612738,BOS,6,162,22,46,0.478,7,22,0.318,4,5,0.8,7,34,41,10,2,4,5,15,55,82,2.0,0.4,2015,16,9.166666666666666,2.0,24,1,25,1.64
2015-16,Playoffs,203524,101,Solomon Hill,1610612754,IND,7,198,14,31,0.452,11,19,0.579,15,16,0.938,5,23,28,8,2,0,3,20,54,71,2.67,0.67,2015,16,7.714285714285714,2.6666666666666665,17,1,18,1.5555555555555556
2015-16,Playoffs,202362,102,Lance Stephenson,1610612763,MEM,4,95,23,44,0.523,2,5,0.4,4,5,0.8,1,5,6,7,1,0,3,10,52,41,2.33,0.33,2015,16,13.0,2.3333333333333335,21,1,22,0.2727272727272727
2015-16,Playoffs,201563,102,Michael Beasley,1610612745,HOU,5,80,22,46,0.478,2,6,0.333,6,7,0.857,4,17,21,3,1,0,7,8,52,45,0.43,0.14,2015,16,10.4,0.42857142857142855,24,1,25,0.84
2015-16,Playoffs,2216,102,Zach Randolph,1610612763,MEM,4,120,23,62,0.371,0,0,0.0,6,7,0.857,15,20,35,7,1,0,7,10,52,48,1.0,0.14,2015,16,13.0,1.0,39,1,40,0.875
2015-16,Playoffs,101161,105,Amir Johnson,1610612738,BOS,6,134,22,33,0.667,0,2,0.0,7,9,0.778,11,32,43,4,1,8,10,13,51,84,0.4,0.1,2015,16,8.5,0.4,11,2,13,3.3076923076923075
2015-16,Playoffs,1626163,106,Frank Kaminsky,1610612766,CHA,7,190,14,46,0.304,5,17,0.294,17,21,0.81,3,27,30,8,6,5,2,15,50,61,4.0,3.0,2015,16,7.142857142857143,4.0,32,4,36,0.8333333333333334
2015-16,Playoffs,2564,107,Boris Diaw,1610612759,SAS,9,159,21,46,0.457,2,6,0.333,3,4,0.75,2,17,19,21,2,4,6,9,47,61,3.5,0.33,2015,16,5.222222222222222,3.5,25,1,26,0.7307692307692307
2015-16,Playoffs,1626147,107,Justin Anderson,1610612742,DAL,5,95,17,37,0.459,4,13,0.308,9,14,0.643,9,11,20,7,4,3,5,12,47,51,1.4,0.8,2015,16,9.4,1.4,20,5,25,0.8
2015-16,Playoffs,1713,109,Vince Carter,1610612763,MEM,4,91,15,33,0.455,7,10,0.7,8,8,1.0,5,10,15,5,2,1,3,9,45,47,1.67,0.67,2015,16,11.25,1.6666666666666667,18,0,18,0.8333333333333334
2015-16,Playoffs,202700,110,Donatas Motiejunas,1610612745,HOU,5,98,16,37,0.432,4,9,0.444,8,17,0.471,10,16,26,5,4,2,12,11,44,39,0.42,0.33,2015,16,8.8,0.4166666666666667,21,9,30,0.8666666666666667
2015-16,Playoffs,201155,110,Rodney Stuckey,1610612754,IND,7,125,17,43,0.395,5,10,0.5,5,9,0.556,1,14,15,14,4,1,6,9,44,42,2.33,0.67,2015,16,6.285714285714286,2.3333333333333335,26,4,30,0.5
2015-16,Playoffs,2440,112,Matt Barnes,1610612763,MEM,4,139,16,46,0.348,3,18,0.167,8,10,0.8,5,24,29,11,4,1,13,13,43,43,0.85,0.31,2015,16,10.75,0.8461538461538461,30,2,32,0.90625
2015-16,Playoffs,101123,113,Gerald Green,1610612748,MIA,12,110,16,49,0.327,4,14,0.286,4,5,0.8,2,15,17,1,4,1,2,14,40,27,0.5,2.0,2015,16,3.3333333333333335,0.5,33,1,34,0.5
2015-16,Playoffs,200751,113,Randy Foye,1610612760,OKC,16,190,14,41,0.341,8,26,0.308,4,4,1.0,2,18,20,13,2,3,11,18,40,40,1.18,0.18,2015,16,2.5,1.1818181818181819,27,0,27,0.7407407407407407
2015-16,Playoffs,2734,115,Devin Harris,1610612742,DAL,5,121,15,30,0.5,4,13,0.308,5,10,0.5,1,13,14,8,3,0,3,16,39,41,2.67,1.0,2015,16,7.8,2.6666666666666665,15,5,20,0.7
2015-16,Playoffs,201177,116,Josh McRoberts,1610612748,MIA,10,134,16,34,0.471,0,7,0.0,6,6,1.0,7,19,26,9,5,5,4,20,38,61,2.25,1.25,2015,16,3.8,2.25,18,0,18,1.4444444444444444
2015-16,Playoffs,201627,117,Anthony Morrow,1610612760,OKC,14,76,11,24,0.458,5,14,0.357,10,10,1.0,0,2,2,1,1,0,4,5,37,24,0.25,0.25,2015,16,2.642857142857143,0.25,13,0,13,0.15384615384615385
2015-16,Playoffs,2743,117,Kris Humphries,1610612737,ATL,4,56,13,28,0.464,5,10,0.5,6,6,1.0,8,16,24,4,2,5,2,9,37,55,2.0,1.0,2015,16,9.25,2.0,15,0,15,1.6
2015-16,Playoffs,101107,119,Marvin Williams,1610612766,CHA,7,228,14,51,0.275,6,17,0.353,2,4,0.5,7,41,48,6,6,3,2,11,36,58,3.0,3.0,2015,16,5.142857142857143,3.0,37,2,39,1.2307692307692308
2015-16,Playoffs,1891,120,Jason Terry,1610612745,HOU,5,124,13,38,0.342,6,19,0.316,3,3,1.0,1,10,11,6,2,1,3,13,35,27,2.0,0.67,2015,16,7.0,2.0,25,0,25,0.44
2015-16,Playoffs,2772,121,Trevor Ariza,1610612745,HOU,5,181,13,51,0.255,4,28,0.143,3,4,0.75,7,14,21,4,13,1,12,16,33,21,0.33,1.08,2015,16,6.6,0.3333333333333333,38,1,39,0.5384615384615384
2015-16,Playoffs,2585,121,Zaza Pachulia,1610612742,DAL,5,112,9,24,0.375,0,0,0.0,15,17,0.882,10,17,27,16,3,1,2,13,33,61,8.0,1.5,2015,16,6.6,8.0,15,2,17,1.588235294117647
2015-16,Playoffs,1626169,123,Stanley Johnson,1610612765,DET,4,81,12,23,0.522,6,10,0.6,2,2,1.0,0,16,16,0,1,0,3,10,32,35,0.0,0.33,2015,16,8.0,0.0,11,0,11,1.4545454545454546
2015-16,Playoffs,203096,124,Jared Sullinger,1610612738,BOS,6,81,13,42,0.31,2,4,0.5,3,4,0.75,10,17,27,7,1,0,6,16,31,30,1.17,0.17,2015,16,5.166666666666667,1.1666666666666667,29,1,30,0.9
2015-16,Playoffs,2405,125,Amar'e Stoudemire,1610612748,MIA,9,82,11,19,0.579,0,0,0.0,8,8,1.0,3,10,13,0,5,3,9,14,30,34,0.0,0.56,2015,16,3.3333333333333335,0.0,8,0,8,1.625
2015-16,Playoffs,201949,125,James Johnson,1610612761,TOR,10,98,12,25,0.48,4,9,0.444,2,3,0.667,3,12,15,6,3,0,7,13,30,33,0.86,0.43,2015,16,3.0,0.8571428571428571,13,1,14,1.0714285714285714
2015-16,Playoffs,2754,125,Tony Allen,1610612763,MEM,4,94,10,33,0.303,1,7,0.143,9,13,0.692,6,5,11,3,5,2,6,11,30,18,0.5,0.83,2015,16,7.5,0.5,23,4,27,0.4074074074074074
2015-16,Playoffs,201976,128,Patrick Beverley,1610612745,HOU,5,129,10,37,0.27,3,14,0.214,6,6,1.0,4,18,22,11,2,2,4,17,29,35,2.75,0.5,2015,16,5.8,2.75,27,0,27,0.8148148148148148
2015-16,Playoffs,2449,129,Luis Scola,1610612761,TOR,11,140,8,31,0.258,4,21,0.19,8,11,0.727,2,16,18,7,3,0,5,22,28,25,1.4,0.6,2015,16,2.5454545454545454,1.4,23,3,26,0.6923076923076923
2015-16,Playoffs,203210,130,JaMychal Green,1610612763,MEM,4,72,12,22,0.545,0,1,0.0,3,6,0.5,5,10,15,3,3,5,4,12,27,36,0.75,0.75,2015,16,6.75,0.75,10,3,13,1.1538461538461537
2015-16,Playoffs,200770,130,Jordan Farmar,1610612763,MEM,4,113,10,31,0.323,4,12,0.333,3,3,1.0,0,6,6,16,3,1,10,4,27,22,1.6,0.3,2015,16,6.75,1.6,21,0,21,0.2857142857142857
2015-16,Playoffs,200826,132,J.J. Barea,1610612742,DAL,4,100,11,34,0.324,1,8,0.125,2,2,1.0,0,6,6,20,0,0,11,8,25,17,1.82,0.0,2015,16,6.25,1.8181818181818181,23,0,23,0.2608695652173913
2015-16,Playoffs,1626246,133,Boban Marjanovic,1610612759,SAS,7,42,8,12,0.667,0,0,0.0,8,9,0.889,4,10,14,3,0,2,3,10,24,35,1.0,0.0,2015,16,3.4285714285714284,1.0,4,1,5,2.8
2015-16,Playoffs,101139,133,CJ Miles,1610612754,IND,7,92,10,38,0.263,2,20,0.1,2,3,0.667,4,20,24,4,1,1,3,7,24,22,1.33,0.33,2015,16,3.4285714285714284,1.3333333333333333,28,1,29,0.8275862068965517
2015-16,Playoffs,203939,133,Dwight Powell,1610612742,DAL,4,64,9,19,0.474,0,1,0.0,6,11,0.545,9,8,17,4,1,0,1,5,24,30,4.0,1.0,2015,16,6.0,4.0,10,5,15,1.1333333333333333
2015-16,Playoffs,203488,133,Mike Muscala,1610612737,ATL,9,67,10,20,0.5,2,6,0.333,2,2,1.0,7,10,17,3,0,1,3,6,24,32,1.0,0.0,2015,16,2.6666666666666665,1.0,10,0,10,1.7
2015-16,Playoffs,1626179,133,Terry Rozier,1610612738,BOS,5,99,9,23,0.391,4,11,0.364,2,2,1.0,3,14,17,6,1,3,2,5,24,35,3.0,0.5,2015,16,4.8,3.0,14,0,14,1.2142857142857142
2015-16,Playoffs,201575,138,Brandon Rush,1610612744,GSW,14,110,9,20,0.45,4,12,0.333,1,2,0.5,0,23,23,3,2,2,2,9,23,39,1.5,1.0,2015,16,1.6428571428571428,1.5,11,1,12,1.9166666666666667
2015-16,Playoffs,202332,138,Cole Aldrich,1610612746,LAC,6,77,10,15,0.667,0,0,0.0,3,6,0.5,8,22,30,3,6,3,2,11,23,55,1.5,3.0,2015,16,3.8333333333333335,1.5,5,3,8,3.75
2015-16,Playoffs,203937,138,Kyle Anderson,1610612759,SAS,10,129,8,25,0.32,1,3,0.333,6,7,0.857,2,22,24,7,6,3,4,11,23,41,1.75,1.5,2015,16,2.3,1.75,17,1,18,1.3333333333333333
2015-16,Playoffs,201147,141,Corey Brewer,1610612745,HOU,5,77,7,27,0.259,1,10,0.1,7,8,0.875,3,4,7,8,0,1,6,13,22,11,1.33,0.0,2015,16,4.4,1.3333333333333333,20,1,21,0.3333333333333333
2015-16,Playoffs,2755,141,Kevin Martin,1610612759,SAS,5,49,8,20,0.4,4,8,0.5,2,3,0.667,0,4,4,3,1,0,6,5,22,11,0.5,0.17,2015,16,4.4,0.5,12,1,13,0.3076923076923077
2015-16,Playoffs,204020,143,Tyler Johnson,1610612748,MIA,5,61,5,11,0.455,3,6,0.5,8,11,0.727,2,5,7,8,1,0,2,8,21,26,4.0,0.5,2015,16,4.2,4.0,6,3,9,0.7777777777777778
2015-16,Playoffs,2617,143,Udonis Haslem,1610612748,MIA,9,85,8,15,0.533,0,0,0.0,5,7,0.714,11,20,31,4,0,1,7,13,21,41,0.57,0.0,2015,16,2.3333333333333335,0.5714285714285714,7,2,9,3.4444444444444446
2015-16,Playoffs,2760,145,Anderson Varejao,1610612744,GSW,17,93,5,14,0.357,0,0,0.0,10,19,0.526,12,9,21,13,2,2,2,17,20,38,6.5,1.0,2015,16,1.1764705882352942,6.5,9,9,18,1.1666666666666667
2015-16,Playoffs,2590,145,Mo Williams,1610612739,CLE,13,68,8,28,0.286,3,13,0.231,1,2,0.5,0,6,6,3,4,0,10,8,20,2,0.3,0.4,2015,16,1.5384615384615385,0.3,20,1,21,0.2857142857142857
2015-16,Playoffs,203501,145,Tim Hardaway Jr.,1610612737,ATL,9,87,7,26,0.269,2,14,0.143,4,6,0.667,0,9,9,7,0,1,3,2,20,13,2.33,0.0,2015,16,2.2222222222222223,2.3333333333333335,19,2,21,0.42857142857142855
2015-16,Playoffs,1626257,148,Salah Mejri,1610612742,DAL,4,76,7,10,0.7,0,0,0.0,5,12,0.417,5,8,13,1,3,5,0,11,19,31,0.0,0.0,2015,16,4.75,inf,3,7,10,1.3
2015-16,Playoffs,204098,148,Xavier Munford,1610612763,MEM,4,89,9,28,0.321,1,8,0.125,0,2,0.0,1,8,9,10,6,3,5,8,19,21,2.0,1.2,2015,16,4.75,2.0,19,2,21,0.42857142857142855
2015-16,Playoffs,202340,150,Avery Bradley,1610612738,BOS,1,33,7,16,0.438,1,7,0.143,3,3,1.0,2,1,3,1,1,1,1,2,18,14,1.0,1.0,2015,16,18.0,1.0,9,0,9,0.3333333333333333
2015-16,Playoffs,1626166,150,Cameron Payne,1610612760,OKC,10,64,7,26,0.269,2,10,0.2,2,4,0.5,0,4,4,8,2,2,8,7,18,5,1.0,0.25,2015,16,1.8,1.0,19,2,21,0.19047619047619047
2015-16,Playoffs,201150,150,Spencer Hawes,1610612766,CHA,5,53,6,13,0.462,1,4,0.25,5,6,0.833,3,13,16,3,1,2,4,5,18,28,0.75,0.25,2015,16,3.6,0.75,7,1,8,2.0
2015-16,Playoffs,203092,150,Tyler Zeller,1610612738,BOS,3,38,7,15,0.467,0,0,0.0,4,6,0.667,4,11,15,2,0,2,2,1,18,25,1.0,0.0,2015,16,6.0,1.0,8,2,10,1.5
2015-16,Playoffs,2563,154,Dahntay Jones,1610612739,CLE,15,50,6,13,0.462,1,3,0.333,4,5,0.8,0,7,7,2,1,1,1,3,17,19,2.0,1.0,2015,16,1.1333333333333333,2.0,7,1,8,0.875
2015-16,Playoffs,2748,155,Dorell Wright,1610612748,MIA,5,19,5,10,0.5,2,5,0.4,4,4,1.0,0,6,6,2,0,0,0,2,16,19,0.0,0.0,2015,16,3.2,inf,5,0,5,1.2
2015-16,Playoffs,2746,155,Josh Smith,1610612745,HOU,4,38,6,13,0.462,4,8,0.5,0,2,0.0,1,1,2,4,1,1,5,7,16,10,0.8,0.2,2015,16,4.0,0.8,7,2,9,0.2222222222222222
2015-16,Playoffs,201951,155,Ty Lawson,1610612754,IND,7,74,6,18,0.333,0,3,0.0,4,6,0.667,1,6,7,10,3,0,6,8,16,16,1.67,0.5,2015,16,2.2857142857142856,1.6666666666666667,12,2,14,0.5
2015-16,Playoffs,202325,155,Wesley Johnson,1610612746,LAC,6,77,5,14,0.357,3,9,0.333,3,3,1.0,5,13,18,2,1,4,2,6,16,30,1.0,0.5,2015,16,2.6666666666666665,1.0,9,0,9,2.0
2015-16,Playoffs,2365,159,Chris Andersen,1610612763,MEM,4,79,5,12,0.417,0,0,0.0,5,8,0.625,13,18,31,3,2,3,5,4,15,39,0.6,0.4,2015,16,3.75,0.6,7,3,10,3.1
2015-16,Playoffs,101114,159,Deron Williams,1610612742,DAL,3,49,6,18,0.333,3,7,0.429,0,0,0.0,0,2,2,8,1,0,7,6,15,7,1.14,0.14,2015,16,5.0,1.1428571428571428,12,0,12,0.16666666666666666
2015-16,Playoffs,202389,159,Timofey Mozgov,1610612739,CLE,13,76,6,15,0.4,0,0,0.0,3,4,0.75,5,16,21,2,3,3,8,16,15,26,0.25,0.38,2015,16,1.1538461538461537,0.25,9,1,10,2.1
2015-16,Playoffs,2549,162,Chris Kaman,1610612757,POR,4,32,7,18,0.389,0,0,0.0,0,0,0.0,2,6,8,1,2,0,6,10,14,8,0.17,0.33,2015,16,3.5,0.16666666666666666,11,0,11,0.7272727272727273
2015-16,Playoffs,1626153,162,Delon Wright,1610612761,TOR,9,41,3,10,0.3,0,1,0.0,8,13,0.615,1,3,4,3,3,0,2,2,14,10,1.5,1.5,2015,16,1.5555555555555556,1.5,7,5,12,0.3333333333333333
2015-16,Playoffs,101135,164,David Lee,1610612742,DAL,2,33,6,8,0.75,0,0,0.0,0,0,0.0,1,5,6,1,0,0,0,7,12,17,0.0,0.0,2015,16,6.0,inf,2,0,2,3.0
2015-16,Playoffs,203493,164,Reggie Bullock Jr.,1610612765,DET,2,22,5,6,0.833,2,3,0.667,0,0,0.0,0,2,2,3,1,0,0,2,12,17,0.0,0.0,2015,16,6.0,inf,1,0,1,2.0
2015-16,Playoffs,203087,166,Jeremy Lamb,1610612766,CHA,3,12,5,9,0.556,1,1,1.0,0,0,0.0,1,3,4,1,0,0,0,0,11,12,0.0,0.0,2015,16,3.6666666666666665,inf,4,0,4,1.0
2015-16,Playoffs,203613,166,Jonathon Simmons,1610612759,SAS,3,26,4,10,0.4,2,3,0.667,1,2,0.5,3,1,4,2,2,0,1,4,11,11,2.0,2.0,2015,16,3.6666666666666665,2.0,6,1,7,0.5714285714285714
2015-16,Playoffs,203382,168,Aron Baynes,1610612765,DET,4,44,4,9,0.444,0,0,0.0,2,3,0.667,3,5,8,2,0,0,3,4,10,11,0.67,0.0,2015,16,2.5,0.6666666666666666,5,1,6,1.3333333333333333
2015-16,Playoffs,1889,169,Andre Miller,1610612759,SAS,5,35,3,7,0.429,1,3,0.333,2,2,1.0,2,3,5,7,0,0,0,4,9,17,0.0,0.0,2015,16,1.8,inf,4,0,4,1.25
2015-16,Playoffs,101111,169,Charlie Villanueva,1610612742,DAL,4,20,3,12,0.25,1,5,0.2,2,2,1.0,0,2,2,1,0,0,1,2,9,2,1.0,0.0,2015,16,2.25,1.0,9,0,9,0.2222222222222222
2015-16,Playoffs,1626185,169,Jarell Martin,1610612763,MEM,2,46,3,8,0.375,0,0,0.0,3,6,0.5,4,3,7,1,3,0,3,4,9,9,0.33,1.0,2015,16,4.5,0.3333333333333333,5,3,8,0.875
2015-16,Playoffs,1626202,169,Joe Young,1610612754,IND,4,10,3,8,0.375,1,4,0.25,2,2,1.0,0,1,1,1,0,0,2,3,9,4,0.5,0.0,2015,16,2.25,0.5,5,0,5,0.2
2015-16,Playoffs,203895,169,Jordan McRae,1610612739,CLE,2,4,4,4,1.0,1,1,1.0,0,0,0.0,0,2,2,0,0,0,0,0,9,11,0.0,0.0,2015,16,4.5,,0,0,0,inf
2015-16,Playoffs,203909,169,KJ McDaniels,1610612745,HOU,4,34,4,13,0.308,1,3,0.333,0,0,0.0,1,6,7,1,0,3,0,3,9,11,0.0,0.0,2015,16,2.25,inf,9,0,9,0.7777777777777778
2015-16,Playoffs,201601,169,Luc Mbah a Moute,1610612746,LAC,5,78,4,6,0.667,0,0,0.0,1,1,1.0,2,8,10,1,3,0,2,9,9,19,0.5,1.5,2015,16,1.8,0.5,2,0,2,5.0
2015-16,Playoffs,2555,169,Nick Collison,1610612760,OKC,9,79,4,6,0.667,0,0,0.0,1,2,0.5,3,8,11,5,8,0,1,17,9,29,5.0,8.0,2015,16,1.0,5.0,2,1,3,3.6666666666666665
2015-16,Playoffs,203148,177,Brian Roberts,1610612757,POR,10,36,2,9,0.222,0,4,0.0,4,6,0.667,1,0,1,3,0,0,1,5,8,2,3.0,0.0,2015,16,0.8,3.0,7,2,9,0.1111111111111111
2015-16,Playoffs,203991,177,Clint Capela,1610612745,HOU,5,43,3,9,0.333,0,0,0.0,2,5,0.4,8,12,20,2,3,2,3,5,8,23,0.67,1.0,2015,16,1.6,0.6666666666666666,6,3,9,2.2222222222222223
2015-16,Playoffs,201574,177,Jason Thompson,1610612761,TOR,10,55,4,9,0.444,0,1,0.0,0,3,0.0,6,5,11,1,0,1,1,6,8,12,1.0,0.0,2015,16,0.8,1.0,5,3,8,1.375
2015-16,Playoffs,202713,177,Kyle Singler,1610612760,OKC,6,51,3,9,0.333,2,4,0.5,0,2,0.0,1,6,7,0,1,0,0,4,8,8,0.0,0.0,2015,16,1.3333333333333333,,6,2,8,0.875
2015-16,Playoffs,1626242,177,Luis Montero,1610612757,POR,6,8,3,3,1.0,2,2,1.0,0,0,0.0,0,0,0,0,0,0,0,1,8,8,0.0,0.0,2015,16,1.3333333333333333,,0,0,0,
2015-16,Playoffs,1626192,177,Pat Connaughton,1610612757,POR,6,8,3,5,0.6,2,3,0.667,0,0,0.0,0,1,1,0,0,0,0,0,8,7,0.0,0.0,2015,16,1.3333333333333333,,2,0,2,0.5
2015-16,Playoffs,203922,183,Glenn Robinson III,1610612754,IND,4,10,3,4,0.75,0,0,0.0,1,1,1.0,0,0,0,0,0,1,0,0,7,7,0.0,0.0,2015,16,1.75,,1,0,1,0.0
2015-16,Playoffs,202726,184,Andrew Goudelock,1610612745,HOU,2,11,3,6,0.5,0,1,0.0,0,0,0.0,0,2,2,0,0,0,3,0,6,2,0.0,0.0,2015,16,3.0,0.0,3,0,3,0.6666666666666666
2015-16,Playoffs,2592,184,James Jones,1610612739,CLE,12,55,2,10,0.2,1,7,0.143,1,4,0.25,1,3,4,3,0,0,1,3,6,1,3.0,0.0,2015,16,0.5,3.0,8,3,11,0.36363636363636365
2015-16,Playoffs,203934,184,Lamar Patterson,1610612737,ATL,4,20,2,7,0.286,1,3,0.333,1,1,1.0,0,5,5,3,1,0,4,1,6,6,0.75,0.25,2015,16,1.5,0.75,5,0,5,1.0
2015-16,Playoffs,202730,184,Lavoy Allen,1610612754,IND,6,51,3,10,0.3,0,0,0.0,0,0,0.0,4,10,14,2,1,1,1,2,6,16,2.0,1.0,2015,16,1.0,2.0,7,0,7,2.0
2015-16,Playoffs,203512,184,Lucas Nogueira,1610612761,TOR,5,29,3,4,0.75,0,0,0.0,0,0,0.0,1,7,8,0,0,0,0,3,6,13,0.0,0.0,2015,16,1.2,,1,0,1,8.0
2015-16,Playoffs,1718,184,Paul Pierce,1610612746,LAC,5,54,2,12,0.167,1,5,0.2,1,4,0.25,0,6,6,1,2,0,2,6,6,0,0.5,1.0,2015,16,1.2,0.5,10,3,13,0.46153846153846156
2015-16,Playoffs,203949,190,James Michael McAdoo,1610612744,GSW,8,38,2,4,0.5,0,0,0.0,1,4,0.25,0,8,8,2,3,2,1,6,5,14,2.0,3.0,2015,16,0.625,2.0,2,3,5,1.6
2015-16,Playoffs,2550,190,Kirk Hinrich,1610612737,ATL,6,27,2,7,0.286,1,3,0.333,0,0,0.0,0,4,4,3,0,0,0,2,5,7,0.0,0.0,2015,16,0.8333333333333334,inf,5,0,5,0.8
2015-16,Playoffs,203798,190,PJ Hairston,1610612763,MEM,2,22,2,6,0.333,1,3,0.333,0,2,0.0,0,0,0,0,1,0,1,1,5,-1,0.0,1.0,2015,16,2.5,0.0,4,2,6,0.0
2015-16,Playoffs,1626154,190,RJ Hunter,1610612738,BOS,5,41,2,9,0.222,1,5,0.2,0,0,0.0,1,5,6,3,0,1,1,3,5,7,3.0,0.0,2015,16,1.0,3.0,7,0,7,0.8571428571428571
2015-16,Playoffs,201229,194,Anthony Tolliver,1610612765,DET,3,26,2,4,0.5,0,2,0.0,0,0,0.0,1,3,4,1,0,1,0,0,4,8,0.0,0.0,2015,16,1.3333333333333333,inf,2,0,2,2.0
2015-16,Playoffs,201580,194,JaVale McGee,1610612742,DAL,2,14,1,2,0.5,0,0,0.0,2,6,0.333,2,1,3,0,1,0,3,3,4,0,0.0,0.33,2015,16,2.0,0.0,1,4,5,0.6
2015-16,Playoffs,1626175,194,Jordan Mickey,1610612738,BOS,2,10,2,4,0.5,0,0,0.0,0,0,0.0,1,1,2,2,0,1,0,0,4,7,0.0,0.0,2015,16,2.0,inf,2,0,2,1.0
2015-16,Playoffs,2581,194,Steve Blake,1610612765,DET,4,43,1,5,0.2,1,2,0.5,1,2,0.5,0,4,4,10,0,0,5,7,4,8,2.0,0.0,2015,16,1.0,2.0,4,1,5,0.8
2015-16,Playoffs,201965,198,Jeff Ayres,1610612746,LAC,2,2,1,1,1.0,0,0,0.0,1,1,1.0,0,0,0,0,0,0,0,0,3,3,0.0,0.0,2015,16,1.5,,0,0,0,
2015-16,Playoffs,203962,198,Josh Huestis,1610612760,OKC,2,10,1,3,0.333,1,2,0.5,0,0,0.0,1,2,3,0,0,0,0,1,3,4,0.0,0.0,2015,16,1.5,,2,0,2,1.5
2015-16,Playoffs,1626149,198,Montrezl Harrell,1610612745,HOU,2,12,1,3,0.333,0,1,0.0,1,2,0.5,0,2,2,0,0,0,1,1,3,1,0.0,0.0,2015,16,1.5,0.0,2,1,3,0.6666666666666666
2015-16,Playoffs,203923,201,James Young,1610612738,BOS,3,10,1,3,0.333,0,1,0.0,0,0,0.0,0,0,0,0,0,0,1,1,2,-1,0.0,0.0,2015,16,0.6666666666666666,0.0,2,0,2,0.0
2015-16,Playoffs,201975,201,Jodie Meeks,1610612765,DET,1,2,1,1,1.0,0,0,0.0,0,0,0.0,0,0,0,0,0,0,0,0,2,2,0.0,0.0,2015,16,2.0,,0,0,0,
2015-16,Playoffs,203482,201,Kelly Olynyk,1610612738,BOS,4,32,1,9,0.111,0,3,0.0,0,0,0.0,2,2,4,3,1,0,4,5,2,-2,0.75,0.25,2015,16,0.5,0.75,8,0,8,0.5
2015-16,Playoffs,1737,201,Nazr Mohammed,1610612760,OKC,5,10,1,2,0.5,0,0,0.0,0,0,0.0,1,2,3,0,0,1,1,1,2,4,0.0,0.0,2015,16,0.4,0.0,1,0,1,3.0
2015-16,Playoffs,203915,201,Spencer Dinwiddie,1610612741,CHI,1,2,1,1,1.0,0,0,0.0,0,0,0.0,0,0,0,1,0,0,0,0,2,3,0.0,0.0,2015,16,2.0,inf,0,0,0,
2015-16,Playoffs,203584,201,Troy Daniels,1610612766,CHA,4,18,1,8,0.125,0,3,0.0,0,0,0.0,0,2,2,0,0,0,0,2,2,-3,0.0,0.0,2015,16,0.5,,7,0,7,0.2857142857142857
2015-16,Playoffs,1626151,207,Aaron Harrison,1610612766,CHA,2,7,0,0,0.0,0,0,0.0,0,0,0.0,0,1,1,0,0,0,0,1,0,1,0.0,0.0,2015,16,0.0,,0,0,0,inf
2015-16,Playoffs,1627362,207,Briante Weber,1610612748,MIA,2,6,0,1,0.0,0,0,0.0,0,0,0.0,0,0,0,1,1,0,0,1,0,1,0.0,0.0,2015,16,0.0,inf,1,0,1,0.0
2015-16,Playoffs,203912,207,C.J. Wilcox,1610612746,LAC,2,7,0,1,0.0,0,0,0.0,0,0,0.0,0,1,1,1,0,0,0,1,0,1,0.0,0.0,2015,16,0.0,inf,1,0,1,1.0
2015-16,Playoffs,204066,207,John Holland,1610612738,BOS,1,1,0,1,0.0,0,1,0.0,0,0,0.0,0,0,0,0,0,0,0,0,0,-1,0.0,0.0,2015,16,0.0,,1,0,1,0.0
2015-16,Playoffs,201941,207,Jordan Hill,1610612754,IND,5,15,0,3,0.0,0,0,0.0,0,0,0.0,2,4,6,2,0,0,0,1,0,5,0.0,0.0,2015,16,0.0,inf,3,0,3,2.0
2015-16,Playoffs,203268,207,Jorge Gutierrez,1610612766,CHA,3,12,0,3,0.0,0,0,0.0,0,0,0.0,0,2,2,2,0,0,1,0,0,0,2.0,0.0,2015,16,0.0,2.0,3,0,3,0.6666666666666666
2015-16,Playoffs,203943,207,Noah Vonleh,1610612757,POR,6,12,0,3,0.0,0,0,0.0,0,0,0.0,1,3,4,2,2,0,0,1,0,5,0.0,0.0,2015,16,0.0,inf,3,0,3,1.3333333333333333
2015-16,Playoffs,203143,207,Pablo Prigioni,1610612746,LAC,5,26,0,5,0.0,0,2,0.0,0,0,0.0,2,1,3,7,0,0,3,8,0,2,2.33,0.0,2015,16,0.0,2.3333333333333335,5,0,5,0.6
2015-16,Playoffs,201946,207,Tyler Hansbrough,1610612766,CHA,2,6,0,0,0.0,0,0,0.0,0,0,0.0,0,0,0,0,0,0,0,0,0,0,0.0,0.0,2015,16,0.0,,0,0,0,
2016-17,RegularSeason,201566,1,Russell Westbrook,1610612760,OKC,81,2802,824,1941,0.425,200,583,0.343,710,840,0.845,137,727,864,840,132,31,438,190,2558,2740,1.92,0.3,2016,17,31.580246913580247,1.917808219178082,1117,130,1247,0.6928628708901363
2016-17,RegularSeason,201935,2,James Harden,1610612745,HOU,81,2947,674,1533,0.44,262,756,0.347,746,881,0.847,95,564,659,907,121,38,464,215,2356,2623,1.96,0.26,2016,17,29.08641975308642,1.9547413793103448,859,135,994,0.6629778672032193
2016-17,RegularSeason,202738,3,Isaiah Thomas,1610612738,BOS,76,2569,682,1473,0.463,245,646,0.379,590,649,0.909,42,162,204,448,70,13,210,167,2199,1874,2.13,0.33,2016,17,28.93421052631579,2.1333333333333333,791,59,850,0.24
2016-17,RegularSeason,203076,4,Anthony Davis,1610612740,NOP,75,2708,770,1526,0.505,40,134,0.299,519,647,0.802,172,712,884,157,94,167,181,168,2099,2336,0.87,0.52,2016,17,27.986666666666668,0.8674033149171271,756,128,884,1.0
2016-17,RegularSeason,1626157,5,Karl-Anthony Towns,1610612750,MIN,82,3030,802,1480,0.542,101,275,0.367,356,428,0.832,296,711,1007,220,56,103,212,241,2061,2485,1.04,0.26,2016,17,25.134146341463413,1.0377358490566038,678,72,750,1.3426666666666667
2016-17,RegularSeason,203081,6,Damian Lillard,1610612757,POR,75,2693,661,1488,0.444,214,579,0.37,488,545,0.895,46,322,368,440,68,20,197,152,2024,1839,2.23,0.34,2016,17,26.986666666666668,2.233502538071066,827,57,884,0.416289592760181
2016-17,RegularSeason,201942,7,DeMar DeRozan,1610612761,TOR,74,2620,721,1545,0.467,33,124,0.266,545,647,0.842,70,316,386,290,78,13,180,134,2020,1681,1.61,0.43,2016,17,27.2972972972973,1.6111111111111112,824,102,926,0.4168466522678186
2016-17,RegularSeason,201939,8,Stephen Curry,1610612744,GSW,79,2639,675,1443,0.468,324,789,0.411,325,362,0.898,61,292,353,524,142,17,239,183,1999,1991,2.19,0.59,2016,17,25.303797468354432,2.192468619246862,768,37,805,0.43850931677018634
2016-17,RegularSeason,2544,9,LeBron James,1610612739,CLE,74,2795,736,1344,0.548,124,342,0.363,358,531,0.674,97,542,639,646,92,44,303,134,1954,2291,2.13,0.3,2016,17,26.405405405405407,2.132013201320132,608,173,781,0.8181818181818182
2016-17,RegularSeason,202326,10,DeMarcus Cousins,1610612740,NOP,72,2465,647,1432,0.452,131,363,0.361,517,670,0.772,152,642,794,332,100,93,269,278,1942,2054,1.23,0.37,2016,17,26.97222222222222,1.2342007434944238,785,153,938,0.8464818763326226
2016-17,RegularSeason,203952,11,Andrew Wiggins,1610612750,MIN,82,3048,709,1570,0.452,103,289,0.356,412,542,0.76,102,226,328,189,82,30,187,183,1933,1384,1.01,0.44,2016,17,23.573170731707318,1.0106951871657754,861,130,991,0.33097880928355194
2016-17,RegularSeason,202695,12,Kawhi Leonard,1610612759,SAS,74,2475,636,1312,0.485,147,387,0.38,469,533,0.88,80,350,430,260,133,55,154,122,1888,1872,1.69,0.86,2016,17,25.513513513513512,1.6883116883116882,676,64,740,0.581081081081081
2016-17,RegularSeason,203468,13,CJ McCollum,1610612757,POR,80,2796,692,1441,0.48,185,439,0.421,268,294,0.912,60,229,289,285,72,42,172,202,1837,1578,1.66,0.42,2016,17,22.9625,1.6569767441860466,749,26,775,0.37290322580645163
2016-17,RegularSeason,203507,14,Giannis Antetokounmpo,1610612749,MIL,80,2845,656,1259,0.521,49,180,0.272,471,612,0.77,142,558,700,434,131,151,234,246,1832,2270,1.85,0.56,2016,17,22.9,1.8547008547008548,603,141,744,0.9408602150537635
2016-17,RegularSeason,202689,15,Kemba Walker,1610612766,CHA,79,2739,643,1449,0.444,240,602,0.399,304,359,0.847,45,263,308,434,85,22,168,119,1830,1650,2.58,0.51,2016,17,23.164556962025316,2.5833333333333335,806,55,861,0.35772357723577236
2016-17,RegularSeason,202710,16,Jimmy Butler,1610612741,CHI,76,2809,570,1252,0.455,91,248,0.367,585,676,0.865,129,341,470,417,143,32,159,112,1816,1946,2.62,0.9,2016,17,23.894736842105264,2.6226415094339623,682,91,773,0.6080206985769728
2016-17,RegularSeason,202681,16,Kyrie Irving,1610612739,CLE,72,2525,671,1420,0.473,177,441,0.401,297,328,0.905,52,178,230,418,83,24,180,157,1816,1611,2.32,0.46,2016,17,25.22222222222222,2.3222222222222224,749,31,780,0.2948717948717949
2016-17,RegularSeason,202322,18,John Wall,1610612764,WAS,78,2836,647,1435,0.451,89,272,0.327,422,527,0.801,59,267,326,831,157,49,322,151,1805,1953,2.58,0.49,2016,17,23.141025641025642,2.580745341614907,788,105,893,0.3650615901455767
2016-17,RegularSeason,203078,19,Bradley Beal,1610612764,WAS,77,2684,637,1322,0.482,223,552,0.404,282,342,0.825,53,187,240,267,83,21,156,169,1779,1489,1.71,0.53,2016,17,23.103896103896105,1.7115384615384615,685,60,745,0.3221476510067114
2016-17,RegularSeason,202331,20,Paul George,1610612754,IND,75,2689,622,1348,0.461,195,496,0.393,336,374,0.898,58,434,492,251,119,27,220,206,1775,1680,1.14,0.54,2016,17,23.666666666666668,1.1409090909090909,726,38,764,0.643979057591623
2016-17,RegularSeason,202691,21,Klay Thompson,1610612744,GSW,78,2649,644,1376,0.468,268,647,0.414,186,218,0.853,49,236,285,160,66,40,128,139,1742,1401,1.25,0.52,2016,17,22.333333333333332,1.25,732,32,764,0.3730366492146597
2016-17,RegularSeason,1626164,22,Devin Booker,1610612756,PHX,78,2731,606,1431,0.423,147,405,0.363,367,441,0.832,46,203,249,268,72,21,241,242,1726,1196,1.11,0.3,2016,17,22.128205128205128,1.112033195020747,825,74,899,0.27697441601779754
2016-17,RegularSeason,2546,23,Carmelo Anthony,1610612752,NYK,74,2538,602,1389,0.433,151,421,0.359,304,365,0.833,62,376,438,213,60,34,153,198,1659,1403,1.39,0.39,2016,17,22.41891891891892,1.392156862745098,787,61,848,0.5165094339622641
2016-17,RegularSeason,202330,24,Gordon Hayward,1610612762,UTA,73,2516,545,1156,0.471,149,374,0.398,362,429,0.844,49,345,394,252,73,20,140,117,1601,1522,1.8,0.52,2016,17,21.931506849315067,1.8,611,67,678,0.5811209439528023
2016-17,RegularSeason,201142,25,Kevin Durant,1610612744,GSW,62,2070,551,1026,0.537,117,312,0.375,336,384,0.875,39,474,513,300,66,99,138,117,1555,1872,2.17,0.48,2016,17,25.080645161290324,2.1739130434782608,475,48,523,0.9808795411089866
2016-17,RegularSeason,201572,26,Brook Lopez,1610612751,BKN,75,2222,555,1172,0.474,134,387,0.346,295,364,0.81,121,282,403,176,38,124,184,192,1539,1410,0.96,0.21,2016,17,20.52,0.9565217391304348,617,69,686,0.5874635568513119
2016-17,RegularSeason,203084,27,Harrison Barnes,1610612742,DAL,79,2804,599,1280,0.468,78,222,0.351,242,281,0.861,93,301,394,116,65,15,102,128,1518,1286,1.14,0.64,2016,17,19.21518987341772,1.1372549019607843,681,39,720,0.5472222222222223
2016-17,RegularSeason,201609,28,Goran Dragic,1610612748,MIA,73,2459,534,1124,0.475,117,289,0.405,298,377,0.79,62,217,279,423,89,13,212,199,1483,1406,2.0,0.42,2016,17,20.315068493150687,1.9952830188679245,590,79,669,0.4170403587443946
2016-17,RegularSeason,201188,29,Marc Gasol,1610612763,MEM,74,2531,532,1160,0.459,104,268,0.388,278,332,0.837,60,404,464,338,67,99,166,171,1446,1566,2.04,0.4,2016,17,19.54054054054054,2.036144578313253,628,54,682,0.6803519061583577
2016-17,RegularSeason,101150,30,Lou Williams,1610612745,HOU,81,1993,428,998,0.429,163,446,0.365,402,457,0.88,26,176,202,239,80,20,160,92,1421,1177,1.49,0.5,2016,17,17.54320987654321,1.49375,570,55,625,0.3232
2016-17,RegularSeason,201144,31,Mike Conley,1610612763,MEM,69,2292,464,1009,0.46,171,419,0.408,316,368,0.859,31,210,241,433,92,19,156,126,1415,1447,2.78,0.59,2016,17,20.507246376811594,2.7756410256410255,545,52,597,0.4036850921273032
2016-17,RegularSeason,203471,32,Dennis Schroder,1610612737,ATL,79,2485,548,1214,0.451,100,294,0.34,218,255,0.855,42,206,248,499,74,16,258,149,1414,1290,1.93,0.29,2016,17,17.89873417721519,1.934108527131783,666,37,703,0.352773826458037
2016-17,RegularSeason,202339,33,Eric Bledsoe,1610612756,PHX,66,2176,449,1034,0.434,104,310,0.335,388,458,0.847,52,268,320,418,91,31,224,164,1390,1371,1.87,0.41,2016,17,21.060606060606062,1.8660714285714286,585,70,655,0.48854961832061067
2016-17,RegularSeason,200768,34,Kyle Lowry,1610612761,TOR,60,2244,426,918,0.464,193,468,0.412,299,365,0.819,48,238,286,417,88,19,173,170,1344,1423,2.41,0.51,2016,17,22.4,2.4104046242774566,492,66,558,0.5125448028673835
2016-17,RegularSeason,202699,35,Tobias Harris,1610612765,DET,82,2566,511,1063,0.481,109,314,0.347,190,226,0.841,63,353,416,142,60,39,96,133,1321,1294,1.48,0.63,2016,17,16.109756097560975,1.4791666666666667,552,36,588,0.7074829931972789
2016-17,RegularSeason,201933,36,Blake Griffin,1610612746,LAC,61,2076,479,971,0.493,38,113,0.336,320,421,0.76,112,385,497,300,57,22,142,157,1316,1457,2.11,0.4,2016,17,21.57377049180328,2.112676056338028,492,101,593,0.8381112984822934
2016-17,RegularSeason,202355,37,Hassan Whiteside,1610612748,MIA,77,2513,542,973,0.557,0,0,0.0,225,358,0.628,293,795,1088,57,57,161,154,226,1309,1954,0.37,0.37,2016,17,17.0,0.37012987012987014,431,133,564,1.929078014184397
2016-17,RegularSeason,201952,38,Jeff Teague,1610612754,IND,82,2657,402,909,0.442,90,252,0.357,360,415,0.867,33,297,330,639,100,32,216,165,1254,1577,2.96,0.46,2016,17,15.292682926829269,2.9583333333333335,507,55,562,0.5871886120996441
2016-17,RegularSeason,200794,39,Paul Millsap,1610612737,ATL,69,2343,430,972,0.442,75,241,0.311,311,405,0.768,111,422,533,252,90,62,158,186,1246,1389,1.59,0.57,2016,17,18.057971014492754,1.5949367088607596,542,94,636,0.8380503144654088
2016-17,RegularSeason,200746,40,LaMarcus Aldridge,1610612759,SAS,72,2335,500,1049,0.477,23,56,0.411,220,271,0.812,172,351,523,139,46,88,98,158,1243,1341,1.42,0.47,2016,17,17.26388888888889,1.4183673469387754,549,51,600,0.8716666666666667
2016-17,RegularSeason,203999,41,Nikola Jokic,1610612743,DEN,73,2038,494,854,0.578,45,139,0.324,188,228,0.825,212,506,718,359,61,55,171,214,1221,1843,2.1,0.36,2016,17,16.726027397260275,2.0994152046783627,360,40,400,1.795
2016-17,RegularSeason,201569,42,Eric Gordon,1610612745,HOU,75,2323,412,1016,0.406,246,661,0.372,147,175,0.84,29,172,201,188,48,41,121,150,1217,942,1.55,0.4,2016,17,16.226666666666667,1.5537190082644627,604,28,632,0.3180379746835443
2016-17,RegularSeason,203903,43,Jordan Clarkson,1610612747,LAL,82,2397,477,1071,0.445,117,356,0.329,134,168,0.798,49,197,246,213,88,8,164,150,1205,968,1.3,0.54,2016,17,14.695121951219512,1.298780487804878,594,34,628,0.39171974522292996
2016-17,RegularSeason,204001,44,Kristaps Porzingis,1610612752,NYK,66,2164,443,985,0.45,112,314,0.357,198,252,0.786,111,364,475,97,47,129,118,244,1196,1230,0.82,0.4,2016,17,18.12121212121212,0.8220338983050848,542,54,596,0.7969798657718121
2016-17,RegularSeason,200755,45,JJ Redick,1610612746,LAC,78,2198,396,890,0.445,201,468,0.429,180,202,0.891,11,160,171,110,54,13,98,125,1173,907,1.12,0.55,2016,17,15.038461538461538,1.1224489795918366,494,22,516,0.3313953488372093
2016-17,RegularSeason,1626167,45,Myles Turner,1610612754,IND,81,2541,444,869,0.511,40,115,0.348,245,303,0.809,139,450,589,106,74,172,105,262,1173,1526,1.01,0.7,2016,17,14.481481481481481,1.0095238095238095,425,58,483,1.2194616977225672
2016-17,RegularSeason,201586,45,Serge Ibaka,1610612761,TOR,79,2422,471,982,0.48,124,317,0.391,107,125,0.856,129,409,538,75,41,124,105,215,1173,1317,0.71,0.39,2016,17,14.848101265822784,0.7142857142857143,511,18,529,1.0170132325141776
2016-17,RegularSeason,203095,48,Evan Fournier,1610612753,ORL,68,2234,408,930,0.439,128,360,0.356,223,277,0.805,44,165,209,202,66,4,141,180,1167,931,1.43,0.47,2016,17,17.16176470588235,1.4326241134751774,522,54,576,0.3628472222222222
2016-17,RegularSeason,201587,49,Nicolas Batum,1610612766,CHA,77,2617,393,975,0.403,135,405,0.333,243,284,0.856,46,435,481,456,86,29,194,109,1164,1399,2.35,0.44,2016,17,15.116883116883116,2.350515463917526,582,41,623,0.7720706260032103
2016-17,RegularSeason,201565,50,Derrick Rose,1610612752,NYK,64,2082,460,977,0.471,13,60,0.217,221,253,0.874,66,180,246,283,44,17,147,84,1154,1048,1.93,0.3,2016,17,18.03125,1.9251700680272108,517,32,549,0.44808743169398907
2016-17,RegularSeason,201568,51,Danilo Gallinari,1610612743,DEN,63,2134,335,750,0.447,126,324,0.389,349,387,0.902,39,286,325,135,40,15,82,93,1145,1125,1.65,0.49,2016,17,18.174603174603174,1.646341463414634,415,38,453,0.717439293598234
2016-17,RegularSeason,203501,52,Tim Hardaway Jr.,1610612737,ATL,79,2154,415,912,0.455,149,417,0.357,164,214,0.766,35,189,224,182,55,15,106,103,1143,966,1.72,0.52,2016,17,14.468354430379748,1.7169811320754718,497,50,547,0.40950639853747717
2016-17,RegularSeason,201567,53,Kevin Love,1610612739,CLE,60,1885,370,867,0.427,145,389,0.373,257,295,0.871,148,518,666,116,53,21,122,125,1142,1341,0.95,0.43,2016,17,19.033333333333335,0.9508196721311475,497,38,535,1.2448598130841122
2016-17,RegularSeason,203497,54,Rudy Gobert,1610612762,UTA,81,2744,413,625,0.661,0,1,0.0,311,476,0.653,314,721,1035,97,49,214,147,246,1137,2008,0.66,0.33,2016,17,14.037037037037036,0.6598639455782312,212,165,377,2.7453580901856762
2016-17,RegularSeason,201163,55,Wilson Chandler,1610612743,DEN,71,2197,433,939,0.461,110,326,0.337,141,194,0.727,103,357,460,141,51,30,114,172,1117,1126,1.24,0.45,2016,17,15.732394366197184,1.236842105263158,506,53,559,0.8228980322003577
2016-17,RegularSeason,202711,56,Bojan Bogdanovic,1610612764,WAS,81,2083,376,845,0.445,144,392,0.367,217,243,0.893,37,240,277,111,34,7,131,146,1113,916,0.85,0.26,2016,17,13.74074074074074,0.8473282442748091,469,26,495,0.5595959595959596
2016-17,RegularSeason,203083,57,Andre Drummond,1610612765,DET,81,2409,483,911,0.53,2,7,0.286,137,355,0.386,345,770,1115,90,124,89,152,237,1105,1725,0.59,0.82,2016,17,13.641975308641975,0.5921052631578947,428,218,646,1.7260061919504643
2016-17,RegularSeason,202694,57,Marcus Morris Sr.,1610612765,DET,79,2565,421,1007,0.418,118,357,0.331,145,185,0.784,77,289,366,160,52,25,87,168,1105,995,1.84,0.6,2016,17,13.987341772151899,1.839080459770115,586,40,626,0.5846645367412141
2016-17,RegularSeason,101108,59,Chris Paul,1610612746,LAC,61,1921,374,785,0.476,124,302,0.411,232,260,0.892,40,264,304,563,119,8,147,146,1104,1512,3.83,0.81,2016,17,18.098360655737704,3.8299319727891157,411,28,439,0.6924829157175398
2016-17,RegularSeason,2548,60,Dwyane Wade,1610612741,CHI,60,1792,414,955,0.434,45,145,0.31,223,281,0.794,63,207,270,228,86,41,138,112,1096,984,1.65,0.62,2016,17,18.266666666666666,1.6521739130434783,541,58,599,0.4507512520868113
2016-17,RegularSeason,202696,60,Nikola Vucevic,1610612753,ORL,75,2163,483,1031,0.468,23,75,0.307,107,160,0.669,176,603,779,208,76,74,117,180,1096,1515,1.78,0.65,2016,17,14.613333333333333,1.7777777777777777,548,53,601,1.2961730449251248
2016-17,RegularSeason,203490,62,Otto Porter Jr.,1610612764,WAS,80,2605,414,803,0.516,148,341,0.434,99,119,0.832,118,396,514,121,116,42,44,193,1075,1415,2.75,2.64,2016,17,13.4375,2.75,389,20,409,1.256723716381418
2016-17,RegularSeason,101141,63,Ersan Ilyasova,1610612737,ATL,82,2142,384,890,0.431,142,402,0.353,161,207,0.778,115,366,481,141,58,23,116,211,1071,1106,1.22,0.5,2016,17,13.060975609756097,1.2155172413793103,506,46,552,0.8713768115942029
2016-17,RegularSeason,203506,64,Victor Oladipo,1610612760,OKC,67,2223,412,932,0.442,127,352,0.361,116,154,0.753,39,252,291,176,78,21,119,155,1067,956,1.48,0.66,2016,17,15.925373134328359,1.4789915966386555,520,38,558,0.521505376344086
2016-17,RegularSeason,202693,65,Markieff Morris,1610612764,WAS,76,2374,406,889,0.457,71,196,0.362,180,215,0.837,107,386,493,126,82,42,129,254,1063,1159,0.98,0.64,2016,17,13.986842105263158,0.9767441860465116,483,35,518,0.9517374517374517
2016-17,RegularSeason,203484,66,Kentavious Caldwell-Pope,1610612765,DET,76,2529,370,928,0.399,153,437,0.35,154,185,0.832,55,193,248,193,89,12,86,118,1047,914,2.24,1.03,2016,17,13.776315789473685,2.244186046511628,558,31,589,0.42105263157894735
2016-17,RegularSeason,203901,67,Elfrid Payton,1610612753,ORL,82,2412,430,912,0.471,40,146,0.274,146,211,0.692,89,298,387,529,88,40,178,177,1046,1365,2.97,0.49,2016,17,12.75609756097561,2.9719101123595504,482,65,547,0.7074954296160878
2016-17,RegularSeason,203967,68,Dario Saric,1610612755,PHI,81,2129,381,927,0.411,106,341,0.311,172,220,0.782,112,401,513,182,57,30,183,162,1040,1045,0.99,0.31,2016,17,12.839506172839506,0.994535519125683,546,48,594,0.8636363636363636
2016-17,RegularSeason,202683,69,Enes Freedom,1610612760,OKC,72,1533,402,737,0.545,5,38,0.132,224,285,0.786,195,287,482,67,32,38,123,154,1033,1133,0.55,0.26,2016,17,14.347222222222221,0.5447154471544715,335,61,396,1.2171717171717171
2016-17,RegularSeason,201599,70,DeAndre Jordan,1610612746,LAC,81,2570,412,577,0.714,0,2,0.0,205,425,0.482,298,816,1114,96,51,134,115,212,1029,1924,0.83,0.44,2016,17,12.703703703703704,0.8347826086956521,165,220,385,2.8935064935064934
2016-17,RegularSeason,201950,70,Jrue Holiday,1610612740,NOP,67,2190,405,893,0.454,100,281,0.356,119,168,0.708,46,218,264,488,100,44,194,133,1029,1194,2.52,0.52,2016,17,15.35820895522388,2.515463917525773,488,49,537,0.49162011173184356
2016-17,RegularSeason,2216,72,Zach Randolph,1610612763,MEM,73,1786,433,964,0.449,21,94,0.223,141,193,0.731,182,416,598,122,38,10,99,136,1028,1114,1.23,0.38,2016,17,14.082191780821917,1.2323232323232323,531,52,583,1.0257289879931388
2016-17,RegularSeason,203953,73,Jabari Parker,1610612749,MIL,51,1728,399,814,0.49,65,178,0.365,162,218,0.743,79,235,314,142,50,22,93,111,1025,989,1.53,0.54,2016,17,20.098039215686274,1.5268817204301075,415,56,471,0.6666666666666666
2016-17,RegularSeason,203932,74,Aaron Gordon,1610612753,ORL,80,2298,393,865,0.454,77,267,0.288,156,217,0.719,116,289,405,150,65,40,89,172,1019,1057,1.69,0.73,2016,17,12.7375,1.6853932584269662,472,61,533,0.7598499061913696
2016-17,RegularSeason,2037,75,Jamal Crawford,1610612746,LAC,82,2157,359,870,0.413,116,322,0.36,174,203,0.857,17,112,129,214,61,14,134,115,1008,752,1.6,0.46,2016,17,12.292682926829269,1.5970149253731343,511,29,540,0.2388888888888889
2016-17,RegularSeason,2730,76,Dwight Howard,1610612737,ATL,74,2199,388,613,0.633,0,2,0.0,226,424,0.533,296,644,940,104,64,92,170,203,1002,1609,0.61,0.38,2016,17,13.54054054054054,0.611764705882353,225,198,423,2.2222222222222223
2016-17,RegularSeason,204020,76,Tyler Johnson,1610612748,MIA,73,2177,357,824,0.433,93,250,0.372,195,254,0.768,50,243,293,233,84,44,90,176,1002,1040,2.59,0.93,2016,17,13.726027397260275,2.588888888888889,467,59,526,0.5570342205323194
2016-17,RegularSeason,203109,78,Jae Crowder,1610612738,BOS,72,2335,333,720,0.463,157,394,0.398,176,217,0.811,48,367,415,155,73,23,80,161,999,1157,1.94,0.91,2016,17,13.875,1.9375,387,41,428,0.969626168224299
2016-17,RegularSeason,202083,79,Wesley Matthews,1610612742,DAL,73,2495,333,847,0.393,174,479,0.363,146,179,0.816,18,241,259,210,77,15,102,161,986,898,2.06,0.76,2016,17,13.506849315068493,2.0588235294117645,514,33,547,0.473491773308958
2016-17,RegularSeason,1626156,80,D'Angelo Russell,1610612747,LAL,63,1811,351,867,0.405,135,384,0.352,147,188,0.782,31,190,221,303,87,16,176,130,984,878,1.72,0.49,2016,17,15.619047619047619,1.7215909090909092,516,41,557,0.39676840215439857
2016-17,RegularSeason,201583,81,Ryan Anderson,1610612745,HOU,72,2116,323,773,0.418,204,506,0.403,129,150,0.86,112,218,330,68,31,14,55,142,979,896,1.24,0.56,2016,17,13.597222222222221,1.2363636363636363,450,21,471,0.7006369426751592
2016-17,RegularSeason,201949,82,James Johnson,1610612748,MIA,76,2085,368,769,0.479,87,256,0.34,152,215,0.707,66,310,376,276,76,86,171,197,975,1154,1.61,0.44,2016,17,12.828947368421053,1.6140350877192982,401,63,464,0.8103448275862069
2016-17,RegularSeason,203944,82,Julius Randle,1610612747,LAL,74,2132,377,773,0.488,17,63,0.27,204,282,0.723,150,486,636,264,49,37,173,248,975,1314,1.53,0.28,2016,17,13.175675675675675,1.5260115606936415,396,78,474,1.3417721518987342
2016-17,RegularSeason,202685,84,Jonas Valanciunas,1610612761,TOR,80,2066,391,702,0.557,1,2,0.5,176,217,0.811,226,533,759,57,37,63,106,216,959,1417,0.54,0.35,2016,17,11.9875,0.5377358490566038,311,41,352,2.15625
2016-17,RegularSeason,201143,85,Al Horford,1610612738,BOS,68,2193,379,801,0.473,86,242,0.355,108,135,0.8,95,370,465,337,52,86,115,138,952,1328,2.93,0.45,2016,17,14.0,2.9304347826086956,422,27,449,1.0356347438752784
2016-17,RegularSeason,202328,86,Greg Monroe,1610612749,MIL,81,1823,387,726,0.533,0,4,0.0,177,239,0.741,167,365,532,187,92,38,140,168,951,1259,1.34,0.66,2016,17,11.74074074074074,1.3357142857142856,339,62,401,1.3266832917705735
2016-17,RegularSeason,203933,86,T.J. Warren,1610612756,PHX,66,2048,403,814,0.495,26,98,0.265,119,154,0.773,125,214,339,75,76,39,57,175,951,977,1.32,1.33,2016,17,14.409090909090908,1.3157894736842106,411,35,446,0.7600896860986547
2016-17,RegularSeason,2772,88,Trevor Ariza,1610612745,HOU,80,2773,326,798,0.409,191,555,0.344,93,126,0.738,54,404,458,175,147,20,73,133,936,1158,2.4,2.01,2016,17,11.7,2.3972602739726026,472,33,505,0.906930693069307
2016-17,RegularSeason,203930,89,Sean Kilpatrick,1610612751,BKN,70,1754,305,735,0.415,105,308,0.341,204,242,0.843,22,258,280,157,45,6,135,118,919,804,1.16,0.33,2016,17,13.128571428571428,1.162962962962963,430,38,468,0.5982905982905983
2016-17,RegularSeason,203500,90,Steven Adams,1610612760,OKC,80,2389,374,655,0.571,0,1,0.0,157,257,0.611,281,332,613,86,89,78,146,195,905,1244,0.59,0.61,2016,17,11.3125,0.589041095890411,281,100,381,1.6089238845144358
2016-17,RegularSeason,201954,91,Darren Collison,1610612758,SAC,68,2063,340,714,0.476,73,175,0.417,147,171,0.86,23,129,152,312,67,9,114,119,900,928,2.74,0.59,2016,17,13.235294117647058,2.736842105263158,374,24,398,0.38190954773869346
2016-17,RegularSeason,203552,92,Seth Curry,1610612742,DAL,70,2029,338,703,0.481,137,322,0.425,85,100,0.85,25,154,179,189,79,7,92,126,898,880,2.05,0.86,2016,17,12.82857142857143,2.0543478260869565,365,15,380,0.4710526315789474
2016-17,RegularSeason,202340,93,Avery Bradley,1610612738,BOS,55,1835,359,775,0.463,108,277,0.39,68,93,0.731,65,269,334,122,68,11,88,141,894,900,1.39,0.77,2016,17,16.254545454545454,1.3863636363636365,416,25,441,0.7573696145124716
2016-17,RegularSeason,203085,94,Austin Rivers,1610612746,LAC,74,2054,323,731,0.442,111,299,0.371,132,191,0.691,20,141,161,204,48,10,115,187,889,730,1.77,0.42,2016,17,12.013513513513514,1.7739130434782608,408,59,467,0.34475374732334046
2016-17,RegularSeason,203897,94,Zach LaVine,1610612750,MIN,47,1749,326,710,0.459,120,310,0.387,117,140,0.836,19,141,160,139,41,10,85,104,889,747,1.64,0.48,2016,17,18.914893617021278,1.6352941176470588,384,23,407,0.3931203931203931
2016-17,RegularSeason,101162,96,Marcin Gortat,1610612764,WAS,82,2556,390,674,0.579,0,2,0.0,103,159,0.648,238,611,849,121,40,61,119,213,883,1495,1.02,0.34,2016,17,10.768292682926829,1.0168067226890756,284,56,340,2.4970588235294118
2016-17,RegularSeason,1626163,97,Frank Kaminsky,1610612766,CHA,75,1954,320,802,0.399,116,354,0.328,118,156,0.756,57,279,336,162,46,34,76,139,874,856,2.13,0.6,2016,17,11.653333333333334,2.1315789473684212,482,38,520,0.6461538461538462
2016-17,RegularSeason,1627741,98,Buddy Hield,1610612758,SAC,82,1888,327,767,0.426,148,379,0.391,64,76,0.842,35,234,269,121,38,9,101,115,866,750,1.2,0.38,2016,17,10.560975609756097,1.198019801980198,440,12,452,0.5951327433628318
2016-17,RegularSeason,203496,99,Robert Covington,1610612755,PHI,67,2119,292,732,0.399,137,412,0.333,143,174,0.822,92,344,436,102,127,69,131,203,864,996,0.78,0.97,2016,17,12.895522388059701,0.7786259541984732,440,31,471,0.9256900212314225
2016-17,RegularSeason,203082,100,Terrence Ross,1610612753,ORL,78,1955,326,746,0.437,142,391,0.363,64,77,0.831,18,188,206,88,87,33,68,143,858,771,1.29,1.28,2016,17,11.0,1.2941176470588236,420,13,433,0.47575057736720555
2016-17,RegularSeason,203914,101,Gary Harris,1610612743,DEN,57,1782,320,637,0.502,107,255,0.42,104,134,0.776,48,130,178,164,71,8,76,92,851,849,2.16,0.93,2016,17,14.929824561403509,2.1578947368421053,317,30,347,0.5129682997118156
2016-17,RegularSeason,101107,102,Marvin Williams,1610612766,CHA,76,2295,297,704,0.422,124,354,0.35,131,150,0.873,89,411,500,106,58,53,60,134,849,1080,1.77,0.97,2016,17,11.171052631578947,1.7666666666666666,407,19,426,1.1737089201877935
2016-17,RegularSeason,201959,103,Taj Gibson,1610612760,OKC,78,1989,365,709,0.515,3,13,0.231,113,158,0.715,158,327,485,73,41,65,105,163,846,1016,0.69,0.39,2016,17,10.846153846153847,0.6952380952380952,344,45,389,1.2467866323907455
2016-17,RegularSeason,203459,104,Allen Crabbe,1610612757,POR,79,2254,303,647,0.468,134,302,0.444,105,124,0.847,19,207,226,94,54,20,62,171,845,814,1.52,0.87,2016,17,10.69620253164557,1.5161290322580645,344,19,363,0.6225895316804407
2016-17,RegularSeason,203486,105,Mason Plumlee,1610612743,DEN,81,2148,334,623,0.536,0,6,0.0,174,300,0.58,170,435,605,284,69,92,134,226,842,1343,2.12,0.52,2016,17,10.395061728395062,2.1194029850746268,289,126,415,1.4578313253012047
2016-17,RegularSeason,201577,106,Robin Lopez,1610612741,CHI,81,2271,382,775,0.493,0,2,0.0,75,104,0.721,244,276,520,80,18,117,91,151,839,1061,0.88,0.2,2016,17,10.358024691358025,0.8791208791208791,393,29,422,1.2322274881516588
2016-17,RegularSeason,201937,107,Ricky Rubio,1610612750,MIN,75,2469,261,650,0.402,60,196,0.306,254,285,0.891,68,237,305,682,128,10,195,202,836,1346,3.5,0.66,2016,17,11.146666666666667,3.4974358974358974,389,31,420,0.7261904761904762
2016-17,RegularSeason,201584,108,Courtney Lee,1610612752,NYK,77,2459,321,704,0.456,108,269,0.401,85,98,0.867,53,206,259,179,81,24,69,141,835,913,2.59,1.17,2016,17,10.844155844155845,2.5942028985507246,383,13,396,0.6540404040404041
2016-17,RegularSeason,203935,108,Marcus Smart,1610612738,BOS,79,2399,269,749,0.359,94,332,0.283,203,250,0.812,78,227,305,364,125,34,159,192,835,977,2.29,0.79,2016,17,10.569620253164556,2.289308176100629,480,47,527,0.5787476280834914
2016-17,RegularSeason,201588,110,George Hill,1610612762,UTA,49,1544,289,606,0.477,94,233,0.403,157,196,0.801,23,144,167,204,50,11,85,114,829,820,2.4,0.59,2016,17,16.918367346938776,2.4,317,39,356,0.4691011235955056
2016-17,RegularSeason,203115,111,Will Barton,1610612743,DEN,60,1705,295,666,0.443,87,235,0.37,143,190,0.753,58,201,259,206,48,28,97,110,820,846,2.12,0.49,2016,17,13.666666666666666,2.1237113402061856,371,47,418,0.6196172248803827
2016-17,RegularSeason,203991,112,Clint Capela,1610612745,HOU,65,1551,362,563,0.643,0,0,0.0,94,177,0.531,178,348,526,63,34,79,87,179,818,1149,0.72,0.39,2016,17,12.584615384615384,0.7241379310344828,201,83,284,1.852112676056338
2016-17,RegularSeason,203476,113,Gorgui Dieng,1610612750,MIN,82,2653,332,661,0.502,16,43,0.372,136,167,0.814,188,459,647,158,88,95,107,254,816,1337,1.48,0.82,2016,17,9.951219512195122,1.4766355140186915,329,31,360,1.7972222222222223
2016-17,RegularSeason,101139,114,CJ Miles,1610612754,IND,76,1776,281,647,0.434,169,409,0.413,84,93,0.903,30,199,229,48,46,25,40,151,815,748,1.2,1.15,2016,17,10.723684210526315,1.2,366,9,375,0.6106666666666667
2016-17,RegularSeason,201152,115,Thaddeus Young,1610612754,IND,74,2237,362,687,0.527,45,118,0.381,45,86,0.523,131,317,448,122,113,29,95,135,814,1065,1.28,1.19,2016,17,11.0,1.2842105263157895,325,41,366,1.2240437158469946
2016-17,RegularSeason,1627750,116,Jamal Murray,1610612743,DEN,82,1765,295,730,0.404,115,344,0.334,106,120,0.883,41,173,214,170,51,24,113,124,811,708,1.5,0.45,2016,17,9.890243902439025,1.5044247787610618,435,14,449,0.4766146993318486
2016-17,RegularSeason,203145,117,Kent Bazemore,1610612737,ATL,73,1963,295,721,0.409,92,266,0.346,119,168,0.708,45,186,231,177,91,52,125,165,801,752,1.42,0.73,2016,17,10.972602739726028,1.416,426,49,475,0.4863157894736842
2016-17,RegularSeason,2200,118,Pau Gasol,1610612759,SAS,64,1627,303,604,0.502,56,104,0.538,130,184,0.707,107,394,501,150,24,70,81,110,792,1101,1.85,0.3,2016,17,12.375,1.8518518518518519,301,54,355,1.4112676056338027
2016-17,RegularSeason,201156,119,Nick Young,1610612747,LAL,60,1556,272,633,0.43,170,421,0.404,77,90,0.856,25,113,138,58,37,14,36,137,791,628,1.61,1.03,2016,17,13.183333333333334,1.6111111111111112,361,13,374,0.3689839572192513
2016-17,RegularSeason,201158,120,Marco Belinelli,1610612766,CHA,74,1778,264,615,0.429,102,283,0.36,150,168,0.893,14,164,178,147,44,9,70,90,780,719,2.1,0.63,2016,17,10.54054054054054,2.1,351,18,369,0.4823848238482385
2016-17,RegularSeason,203110,121,Draymond Green,1610612744,GSW,76,2471,272,650,0.418,81,263,0.308,151,213,0.709,98,501,599,533,154,106,184,217,776,1544,2.9,0.84,2016,17,10.210526315789474,2.8967391304347827,378,62,440,1.3613636363636363
2016-17,RegularSeason,203090,122,Maurice Harkless,1610612757,POR,77,2223,314,624,0.503,68,194,0.351,77,124,0.621,125,216,341,88,85,70,86,214,773,914,1.02,0.99,2016,17,10.03896103896104,1.0232558139534884,310,47,357,0.9551820728291317
2016-17,RegularSeason,203498,123,Shabazz Muhammad,1610612750,MIN,78,1516,288,598,0.482,49,145,0.338,147,190,0.774,84,136,220,35,22,6,56,86,772,646,0.63,0.39,2016,17,9.897435897435898,0.625,310,43,353,0.623229461756374
2016-17,RegularSeason,1717,124,Dirk Nowitzki,1610612742,DAL,54,1424,296,678,0.437,79,209,0.378,98,112,0.875,23,330,353,82,30,38,51,113,769,825,1.61,0.59,2016,17,14.24074074074074,1.607843137254902,382,14,396,0.8914141414141414
2016-17,RegularSeason,202720,125,Jon Leuer,1610612765,DET,75,1944,310,646,0.48,49,167,0.293,98,113,0.867,102,300,402,111,31,26,66,145,767,920,1.68,0.47,2016,17,10.226666666666667,1.6818181818181819,336,15,351,1.1452991452991452
2016-17,RegularSeason,1627763,125,Malcolm Brogdon,1610612749,MIL,75,1982,290,635,0.457,78,193,0.404,109,126,0.865,47,166,213,317,84,12,113,140,767,918,2.81,0.74,2016,17,10.226666666666667,2.8053097345132745,345,17,362,0.5883977900552486
2016-17,RegularSeason,201988,127,Patty Mills,1610612759,SAS,80,1754,273,621,0.44,147,355,0.414,66,80,0.825,24,117,141,280,65,3,101,109,759,785,2.77,0.64,2016,17,9.4875,2.772277227722772,348,14,362,0.38950276243093923
2016-17,RegularSeason,202397,128,Ish Smith,1610612765,DET,81,1955,329,749,0.439,28,105,0.267,72,102,0.706,21,214,235,418,61,33,112,127,758,943,3.73,0.55,2016,17,9.358024691358025,3.732142857142857,420,30,450,0.5222222222222223
2016-17,RegularSeason,203917,129,Nik Stauskas,1610612755,PHI,80,2188,251,634,0.396,132,359,0.368,122,150,0.813,21,205,226,188,45,32,128,144,756,708,1.47,0.35,2016,17,9.45,1.46875,383,28,411,0.5498783454987834
2016-17,RegularSeason,1627737,130,Marquese Chriss,1610612756,PHX,82,1743,284,632,0.449,72,224,0.321,113,181,0.624,96,252,348,60,67,70,108,263,753,774,0.56,0.62,2016,17,9.182926829268293,0.5555555555555556,348,68,416,0.8365384615384616
2016-17,RegularSeason,202704,131,Reggie Jackson,1610612765,DET,52,1424,284,677,0.419,66,184,0.359,118,136,0.868,21,93,114,270,35,5,114,129,752,651,2.37,0.31,2016,17,14.461538461538462,2.3684210526315788,393,18,411,0.2773722627737226
2016-17,RegularSeason,203918,132,Rodney Hood,1610612762,UTA,59,1593,272,666,0.408,114,307,0.371,90,115,0.783,16,186,202,96,38,11,65,132,748,611,1.48,0.58,2016,17,12.677966101694915,1.476923076923077,394,25,419,0.4821002386634845
2016-17,RegularSeason,202703,133,Nikola Mirotic,1610612741,CHI,70,1679,258,625,0.413,129,377,0.342,99,128,0.773,61,323,384,75,53,55,80,128,744,835,0.94,0.66,2016,17,10.628571428571428,0.9375,367,29,396,0.9696969696969697
2016-17,RegularSeason,203077,134,Michael Kidd-Gilchrist,1610612766,CHA,81,2349,295,618,0.477,1,9,0.111,152,194,0.784,156,409,565,114,81,77,56,187,743,1159,2.04,1.45,2016,17,9.17283950617284,2.0357142857142856,323,42,365,1.547945205479452
2016-17,RegularSeason,1627742,135,Brandon Ingram,1610612747,LAL,79,2279,276,686,0.402,55,187,0.294,133,214,0.621,60,256,316,166,50,36,116,158,740,701,1.43,0.43,2016,17,9.367088607594937,1.4310344827586208,410,81,491,0.6435845213849287
2016-17,RegularSeason,202709,135,Cory Joseph,1610612761,TOR,80,2003,299,661,0.452,48,135,0.356,94,122,0.77,51,184,235,265,66,13,108,140,740,821,2.45,0.61,2016,17,9.25,2.4537037037037037,362,28,390,0.6025641025641025
2016-17,RegularSeason,203079,137,Dion Waiters,1610612748,MIA,46,1384,281,663,0.424,85,215,0.395,82,127,0.646,18,135,153,200,42,20,103,95,729,614,1.94,0.41,2016,17,15.847826086956522,1.941747572815534,382,45,427,0.3583138173302108
2016-17,RegularSeason,2207,138,Joe Johnson,1610612762,UTA,78,1843,273,626,0.436,106,258,0.411,63,77,0.818,33,210,243,144,36,18,69,93,715,720,2.09,0.52,2016,17,9.166666666666666,2.0869565217391304,353,14,367,0.662125340599455
2016-17,RegularSeason,201578,139,Marreese Speights,1610612746,LAC,82,1286,244,548,0.445,103,277,0.372,120,137,0.876,88,285,373,65,23,41,69,229,711,823,0.94,0.33,2016,17,8.670731707317072,0.9420289855072463,304,17,321,1.161993769470405
2016-17,RegularSeason,202344,140,Trevor Booker,1610612751,BKN,71,1754,305,591,0.516,25,78,0.321,74,110,0.673,143,428,571,138,75,28,127,152,709,1072,1.09,0.59,2016,17,9.985915492957746,1.0866141732283465,286,36,322,1.7732919254658386
2016-17,RegularSeason,101114,141,Deron Williams,1610612739,CLE,64,1657,263,600,0.438,85,234,0.363,90,109,0.826,14,133,147,360,31,8,138,138,701,753,2.61,0.23,2016,17,10.953125,2.608695652173913,337,19,356,0.41292134831460675
2016-17,RegularSeason,202734,142,E'Twaun Moore,1610612740,NOP,73,1820,283,619,0.457,77,208,0.37,57,74,0.77,33,119,152,164,50,32,62,131,700,683,2.65,0.81,2016,17,9.58904109589041,2.6451612903225805,336,17,353,0.43059490084985835
2016-17,RegularSeason,203210,143,JaMychal Green,1610612763,MEM,77,2101,250,500,0.5,55,145,0.379,134,167,0.802,167,377,544,84,47,34,94,248,689,1021,0.89,0.5,2016,17,8.948051948051948,0.8936170212765957,250,33,283,1.9222614840989398
2016-17,RegularSeason,2749,144,Jameer Nelson,1610612743,DEN,75,2045,268,604,0.444,106,273,0.388,45,63,0.714,28,164,192,385,54,8,128,197,687,844,3.01,0.42,2016,17,9.16,3.0078125,336,18,354,0.5423728813559322
2016-17,RegularSeason,203503,145,Tony Snell,1610612749,MIL,80,2336,246,541,0.455,144,355,0.406,47,58,0.81,22,226,248,96,55,14,55,125,683,735,1.75,1.0,2016,17,8.5375,1.7454545454545454,295,11,306,0.8104575163398693
2016-17,RegularSeason,201951,146,Ty Lawson,1610612758,SAC,69,1732,237,522,0.454,34,118,0.288,173,217,0.797,44,135,179,334,74,6,129,119,681,816,2.59,0.57,2016,17,9.869565217391305,2.5891472868217056,285,44,329,0.5440729483282675
2016-17,RegularSeason,203482,147,Kelly Olynyk,1610612738,BOS,75,1538,260,508,0.512,68,192,0.354,90,123,0.732,73,288,361,148,44,29,96,207,678,883,1.54,0.46,2016,17,9.04,1.5416666666666667,248,33,281,1.2846975088967971
2016-17,RegularSeason,2594,147,Kyle Korver,1610612739,CLE,67,1753,239,515,0.464,162,359,0.451,38,42,0.905,7,179,186,110,34,21,69,107,678,680,1.59,0.49,2016,17,10.119402985074627,1.5942028985507246,276,4,280,0.6642857142857143
2016-17,RegularSeason,101112,149,Channing Frye,1610612739,CLE,74,1398,238,520,0.458,137,335,0.409,63,74,0.851,37,253,290,45,33,37,53,138,676,735,0.85,0.62,2016,17,9.135135135135135,0.8490566037735849,282,11,293,0.9897610921501706
2016-17,RegularSeason,1626178,150,Rondae Hollis-Jefferson,1610612751,BKN,78,1761,235,542,0.434,15,67,0.224,190,253,0.751,96,356,452,154,82,44,116,177,675,921,1.33,0.71,2016,17,8.653846153846153,1.3275862068965518,307,63,370,1.2216216216216216
2016-17,RegularSeason,201945,151,Gerald Henderson,1610612755,PHI,72,1667,234,553,0.423,61,173,0.353,133,165,0.806,34,151,185,112,40,15,62,129,662,601,1.81,0.65,2016,17,9.194444444444445,1.8064516129032258,319,32,351,0.5270655270655271
2016-17,RegularSeason,203994,151,Jusuf Nurkic,1610612757,POR,65,1391,271,534,0.507,0,1,0.0,120,210,0.571,154,313,467,123,50,74,143,161,662,880,0.86,0.35,2016,17,10.184615384615384,0.8601398601398601,263,90,353,1.3229461756373937
2016-17,RegularSeason,201961,153,Wayne Ellington,1610612748,MIA,62,1500,231,555,0.416,149,394,0.378,37,43,0.86,18,114,132,70,35,4,30,70,648,529,2.33,1.17,2016,17,10.451612903225806,2.3333333333333335,324,6,330,0.4
2016-17,RegularSeason,2754,154,Tony Allen,1610612763,MEM,71,1914,274,595,0.461,15,54,0.278,80,130,0.615,166,225,391,98,115,29,100,178,643,805,0.98,1.15,2016,17,9.056338028169014,0.98,321,50,371,1.0539083557951483
2016-17,RegularSeason,203469,155,Cody Zeller,1610612766,CHA,62,1725,253,443,0.571,0,1,0.0,133,196,0.679,135,270,405,99,62,58,65,189,639,945,1.52,0.95,2016,17,10.306451612903226,1.523076923076923,190,63,253,1.6007905138339922
2016-17,RegularSeason,201976,155,Patrick Beverley,1610612745,HOU,67,2058,228,543,0.42,110,288,0.382,73,95,0.768,95,298,393,281,99,25,100,222,639,1000,2.81,0.99,2016,17,9.537313432835822,2.81,315,22,337,1.1661721068249258
2016-17,RegularSeason,201960,157,DeMarre Carroll,1610612761,TOR,72,1881,220,550,0.4,109,320,0.341,89,117,0.761,63,212,275,74,81,27,54,143,638,683,1.37,1.5,2016,17,8.86111111111111,1.3703703703703705,330,28,358,0.7681564245810056
2016-17,RegularSeason,201145,157,Jeff Green,1610612753,ORL,69,1534,220,558,0.394,53,193,0.275,145,168,0.863,39,175,214,81,37,13,75,103,638,547,1.08,0.49,2016,17,9.246376811594203,1.08,338,23,361,0.592797783933518
2016-17,RegularSeason,2225,157,Tony Parker,1610612759,SAS,63,1587,265,569,0.466,23,69,0.333,85,117,0.726,9,104,113,285,34,2,89,92,638,647,3.2,0.38,2016,17,10.126984126984127,3.202247191011236,304,32,336,0.33630952380952384
2016-17,RegularSeason,1626181,160,Norman Powell,1610612761,TOR,76,1368,227,506,0.449,56,173,0.324,126,159,0.792,26,143,169,82,52,14,70,127,636,571,1.17,0.74,2016,17,8.368421052631579,1.1714285714285715,279,33,312,0.5416666666666666
2016-17,RegularSeason,101145,161,Monta Ellis,1610612754,IND,74,1998,247,557,0.443,43,135,0.319,93,128,0.727,19,185,204,236,78,27,135,149,630,695,1.75,0.58,2016,17,8.513513513513514,1.7481481481481482,310,35,345,0.591304347826087
2016-17,RegularSeason,202684,161,Tristan Thompson,1610612739,CLE,78,2336,262,437,0.6,0,3,0.0,106,213,0.498,286,429,715,77,39,84,64,176,630,1199,1.2,0.61,2016,17,8.076923076923077,1.203125,175,107,282,2.5354609929078014
2016-17,RegularSeason,203200,163,Justin Holiday,1610612752,NYK,82,1639,233,538,0.433,97,273,0.355,66,80,0.825,27,198,225,102,65,31,66,109,629,667,1.54,0.98,2016,17,7.670731707317073,1.5454545454545454,305,14,319,0.7053291536050157
2016-17,RegularSeason,203954,164,Joel Embiid,1610612755,PHI,31,786,200,429,0.466,36,98,0.367,191,244,0.783,61,182,243,66,27,76,117,112,627,640,0.56,0.23,2016,17,20.225806451612904,0.5641025641025641,229,53,282,0.8617021276595744
2016-17,RegularSeason,201571,165,D.J. Augustin,1610612753,ORL,78,1538,195,517,0.377,95,274,0.347,131,161,0.814,15,102,117,209,31,1,90,101,616,532,2.32,0.34,2016,17,7.897435897435898,2.3222222222222224,322,30,352,0.33238636363636365
2016-17,RegularSeason,203458,166,Alex Len,1610612756,PHX,77,1560,230,463,0.497,3,12,0.25,150,208,0.721,156,354,510,44,38,98,102,242,613,910,0.43,0.37,2016,17,7.961038961038961,0.43137254901960786,233,58,291,1.7525773195876289
2016-17,RegularSeason,1626161,167,Willie Cauley-Stein,1610612758,SAC,75,1421,255,481,0.53,0,2,0.0,101,151,0.669,85,254,339,80,53,44,69,147,611,782,1.16,0.77,2016,17,8.146666666666667,1.1594202898550725,226,50,276,1.2282608695652173
2016-17,RegularSeason,2403,168,Nene,1610612745,HOU,67,1198,245,397,0.617,3,9,0.333,116,197,0.589,95,187,282,65,56,39,73,163,609,745,0.89,0.77,2016,17,9.08955223880597,0.8904109589041096,152,81,233,1.2103004291845494
2016-17,RegularSeason,1626144,169,Emmanuel Mudiay,1610612743,DEN,55,1406,208,551,0.377,56,178,0.315,131,167,0.784,29,149,178,217,41,13,123,95,603,550,1.76,0.33,2016,17,10.963636363636363,1.7642276422764227,343,36,379,0.46965699208443273
2016-17,RegularSeason,203087,169,Jeremy Lamb,1610612766,CHA,62,1143,226,491,0.46,41,146,0.281,110,129,0.853,30,234,264,75,27,23,40,98,603,668,1.88,0.68,2016,17,9.725806451612904,1.875,265,19,284,0.9295774647887324
2016-17,RegularSeason,202688,171,Brandon Knight,1610612756,PHX,54,1140,209,525,0.398,45,139,0.324,132,154,0.857,25,93,118,130,27,5,88,87,595,449,1.48,0.31,2016,17,11.018518518518519,1.4772727272727273,316,22,338,0.34911242603550297
2016-17,RegularSeason,203926,172,Doug McDermott,1610612760,OKC,66,1508,222,497,0.447,77,208,0.37,71,84,0.845,20,159,179,58,13,5,38,79,592,521,1.53,0.34,2016,17,8.969696969696969,1.5263157894736843,275,13,288,0.6215277777777778
2016-17,RegularSeason,1626143,173,Jahlil Okafor,1610612755,PHI,50,1134,242,471,0.514,0,0,0.0,106,158,0.671,81,159,240,58,20,49,91,122,590,585,0.64,0.22,2016,17,11.8,0.6373626373626373,229,52,281,0.8540925266903915
2016-17,RegularSeason,202702,174,Kenneth Faried,1610612743,DEN,61,1296,228,416,0.548,0,6,0.0,131,189,0.693,183,279,462,55,43,40,59,124,587,882,0.93,0.73,2016,17,9.62295081967213,0.9322033898305084,188,58,246,1.8780487804878048
2016-17,RegularSeason,1626195,174,Willy Hernangomez,1610612752,NYK,72,1324,246,465,0.529,4,15,0.267,91,125,0.728,170,332,502,96,41,36,100,150,587,909,0.96,0.41,2016,17,8.152777777777779,0.96,219,34,253,1.9841897233201582
2016-17,RegularSeason,202323,176,Evan Turner,1610612757,POR,65,1659,235,552,0.426,31,118,0.263,85,103,0.825,36,211,247,205,53,24,100,121,586,680,2.05,0.53,2016,17,9.015384615384615,2.05,317,18,335,0.7373134328358208
2016-17,RegularSeason,1713,176,Vince Carter,1610612763,MEM,73,1800,193,490,0.394,112,296,0.378,88,115,0.765,36,191,227,133,60,36,50,163,586,668,2.66,1.2,2016,17,8.027397260273972,2.66,297,27,324,0.7006172839506173
2016-17,RegularSeason,204038,178,Langston Galloway,1610612758,SAC,74,1494,207,545,0.38,120,308,0.39,51,64,0.797,27,129,156,93,46,6,46,96,585,489,2.02,1.0,2016,17,7.905405405405405,2.0217391304347827,338,13,351,0.4444444444444444
2016-17,RegularSeason,203093,179,Terrence Jones,1610612749,MIL,54,1271,231,492,0.47,19,75,0.253,103,170,0.606,65,241,306,59,40,54,48,67,584,667,1.23,0.83,2016,17,10.814814814814815,1.2291666666666667,261,67,328,0.9329268292682927
2016-17,RegularSeason,204060,180,Joe Ingles,1610612762,UTA,82,1972,204,451,0.452,123,279,0.441,50,68,0.735,23,238,261,225,96,8,107,163,581,799,2.1,0.9,2016,17,7.085365853658536,2.102803738317757,247,18,265,0.9849056603773585
2016-17,RegularSeason,201943,181,Brandon Jennings,1610612764,WAS,81,1801,192,535,0.359,79,252,0.313,114,152,0.75,29,167,196,395,70,4,128,116,577,733,3.09,0.55,2016,17,7.1234567901234565,3.0859375,343,38,381,0.5144356955380578
2016-17,RegularSeason,203521,181,Matthew Dellavedova,1610612749,MIL,76,1986,208,534,0.39,79,215,0.367,82,96,0.854,24,123,147,357,53,0,133,153,577,661,2.68,0.4,2016,17,7.592105263157895,2.6842105263157894,326,14,340,0.4323529411764706
2016-17,RegularSeason,101135,183,David Lee,1610612759,SAS,79,1477,248,420,0.59,0,0,0.0,80,113,0.708,149,292,441,124,31,40,82,125,576,925,1.51,0.38,2016,17,7.291139240506329,1.5121951219512195,172,33,205,2.151219512195122
2016-17,RegularSeason,2738,184,Andre Iguodala,1610612744,GSW,76,1998,219,415,0.528,64,177,0.362,72,102,0.706,51,253,304,261,76,39,58,97,574,970,4.5,1.31,2016,17,7.552631578947368,4.5,196,30,226,1.345132743362832
2016-17,RegularSeason,202697,185,Iman Shumpert,1610612739,CLE,76,1937,201,489,0.411,94,261,0.36,71,90,0.789,39,179,218,109,62,27,78,150,567,598,1.4,0.8,2016,17,7.4605263157894735,1.3974358974358974,288,19,307,0.7100977198697068
2016-17,RegularSeason,203524,186,Solomon Hill,1610612740,NOP,80,2374,183,478,0.383,94,270,0.348,103,128,0.805,51,256,307,141,72,32,82,182,563,713,1.72,0.88,2016,17,7.0375,1.7195121951219512,295,25,320,0.959375
2016-17,RegularSeason,200752,187,Rudy Gay,1610612758,SAC,30,1013,201,442,0.455,42,113,0.372,118,138,0.855,35,155,190,83,44,26,74,79,562,570,1.12,0.59,2016,17,18.733333333333334,1.1216216216216217,241,20,261,0.7279693486590039
2016-17,RegularSeason,1626158,188,Richaun Holmes,1610612755,PHI,57,1193,230,412,0.558,27,77,0.351,72,103,0.699,94,217,311,58,42,55,55,136,559,757,1.05,0.76,2016,17,9.807017543859649,1.0545454545454545,182,31,213,1.460093896713615
2016-17,RegularSeason,204456,189,T.J. McConnell,1610612755,PHI,81,2133,236,512,0.461,11,55,0.2,73,90,0.811,39,212,251,534,134,10,159,139,556,1033,3.36,0.84,2016,17,6.864197530864198,3.358490566037736,276,17,293,0.856655290102389
2016-17,RegularSeason,203584,190,Troy Daniels,1610612763,MEM,67,1183,185,495,0.374,138,355,0.389,43,54,0.796,22,78,100,46,20,4,45,90,551,355,1.02,0.44,2016,17,8.223880597014926,1.0222222222222221,310,11,321,0.3115264797507788
2016-17,RegularSeason,1627785,191,Isaiah Whitehead,1610612751,BKN,73,1643,204,508,0.402,44,149,0.295,91,113,0.805,32,152,184,192,42,36,142,175,543,529,1.35,0.3,2016,17,7.438356164383562,1.352112676056338,304,22,326,0.5644171779141104
2016-17,RegularSeason,200782,192,P.J. Tucker,1610612761,TOR,81,2236,199,482,0.413,70,196,0.357,72,93,0.774,117,354,471,99,116,19,66,196,540,875,1.5,1.76,2016,17,6.666666666666667,1.5,283,21,304,1.549342105263158
2016-17,RegularSeason,1626196,193,Josh Richardson,1610612748,MIA,53,1614,202,513,0.394,75,227,0.33,60,77,0.779,35,133,168,140,60,39,65,132,539,553,2.15,0.92,2016,17,10.169811320754716,2.1538461538461537,311,17,328,0.5121951219512195
2016-17,RegularSeason,200765,194,Rajon Rondo,1610612741,CHI,69,1843,229,561,0.408,50,133,0.376,30,50,0.6,73,282,355,461,99,11,169,144,538,943,2.73,0.59,2016,17,7.797101449275362,2.727810650887574,332,20,352,1.0085227272727273
2016-17,RegularSeason,101109,194,Raymond Felton,1610612746,LAC,80,1700,221,514,0.43,46,144,0.319,50,64,0.781,33,185,218,191,66,22,83,125,538,645,2.3,0.8,2016,17,6.725,2.3012048192771086,293,14,307,0.7100977198697068
2016-17,RegularSeason,2744,196,Al Jefferson,1610612754,IND,66,931,235,471,0.499,0,1,0.0,65,85,0.765,75,203,278,57,19,16,33,125,535,616,1.73,0.58,2016,17,8.106060606060606,1.7272727272727273,236,20,256,1.0859375
2016-17,RegularSeason,202329,197,Al-Farouq Aminu,1610612757,POR,61,1773,183,466,0.393,70,212,0.33,96,136,0.706,77,374,451,99,60,44,94,102,532,769,1.05,0.64,2016,17,8.721311475409836,1.053191489361702,283,40,323,1.3962848297213621
2016-17,RegularSeason,1626147,197,Justin Anderson,1610612755,PHI,75,1227,186,439,0.424,58,194,0.299,102,129,0.791,69,176,245,66,41,23,66,109,532,561,1.0,0.62,2016,17,7.093333333333334,1.0,253,27,280,0.875
2016-17,RegularSeason,200771,199,Sergio Rodriguez,1610612755,PHI,68,1517,210,536,0.392,92,252,0.365,18,27,0.667,21,136,157,344,49,4,128,95,530,621,2.69,0.38,2016,17,7.794117647058823,2.6875,326,9,335,0.46865671641791046
2016-17,RegularSeason,201563,200,Michael Beasley,1610612749,MIL,56,935,216,406,0.532,18,43,0.419,78,105,0.743,40,153,193,53,27,27,66,92,528,545,0.8,0.41,2016,17,9.428571428571429,0.803030303030303,190,27,217,0.8894009216589862
2016-17,RegularSeason,203546,201,Ian Clark,1610612744,GSW,77,1137,211,433,0.487,61,163,0.374,44,58,0.759,22,99,121,90,39,8,55,77,527,494,1.64,0.71,2016,17,6.8441558441558445,1.6363636363636365,222,14,236,0.5127118644067796
2016-17,RegularSeason,2440,201,Matt Barnes,1610612744,GSW,74,1776,185,473,0.391,87,263,0.331,70,89,0.787,70,314,384,195,48,26,107,185,527,766,1.82,0.45,2016,17,7.121621621621622,1.8224299065420562,288,19,307,1.250814332247557
2016-17,RegularSeason,1626149,201,Montrezl Harrell,1610612745,HOU,58,1064,225,345,0.652,1,7,0.143,76,121,0.628,81,138,219,64,20,42,44,126,527,663,1.46,0.46,2016,17,9.086206896551724,1.4545454545454546,120,45,165,1.3272727272727274
2016-17,RegularSeason,202391,204,Jeremy Lin,1610612751,BKN,36,883,175,400,0.438,58,156,0.372,115,141,0.816,11,124,135,184,42,14,86,79,523,561,2.14,0.49,2016,17,14.527777777777779,2.13953488372093,225,26,251,0.5378486055776892
2016-17,RegularSeason,203460,205,Andre Roberson,1610612760,OKC,79,2376,215,463,0.464,45,184,0.245,47,111,0.423,98,305,403,79,94,79,51,204,522,814,1.55,1.84,2016,17,6.6075949367088604,1.5490196078431373,248,64,312,1.2916666666666667
2016-17,RegularSeason,101161,206,Amir Johnson,1610612738,BOS,80,1608,213,370,0.576,27,66,0.409,67,100,0.67,118,248,366,140,51,62,77,211,520,872,1.82,0.66,2016,17,6.5,1.8181818181818181,157,33,190,1.9263157894736842
2016-17,RegularSeason,1938,207,Manu Ginobili,1610612759,SAS,69,1291,171,439,0.39,89,227,0.392,86,107,0.804,28,129,157,183,82,16,96,119,517,570,1.91,0.85,2016,17,7.492753623188406,1.90625,268,21,289,0.5432525951557093
2016-17,RegularSeason,203939,208,Dwight Powell,1610612742,DAL,77,1333,194,377,0.515,21,74,0.284,107,141,0.759,93,213,306,49,61,39,34,135,516,720,1.44,1.79,2016,17,6.701298701298701,1.4411764705882353,183,34,217,1.4101382488479262
2016-17,RegularSeason,201167,209,Arron Afflalo,1610612758,SAC,61,1580,185,420,0.44,62,151,0.411,83,93,0.892,9,116,125,78,21,6,42,104,515,458,1.86,0.5,2016,17,8.442622950819672,1.8571428571428572,235,10,245,0.5102040816326531
2016-17,RegularSeason,1627759,209,Jaylen Brown,1610612738,BOS,78,1341,192,422,0.455,46,134,0.343,85,124,0.685,45,175,220,64,35,18,68,142,515,515,0.94,0.52,2016,17,6.602564102564102,0.9411764705882353,230,39,269,0.8178438661710037
2016-17,RegularSeason,202066,211,Garrett Temple,1610612758,SAC,65,1728,183,432,0.424,82,220,0.373,58,74,0.784,32,152,184,168,84,28,78,141,506,627,2.15,1.08,2016,17,7.7846153846153845,2.1538461538461537,249,16,265,0.6943396226415094
2016-17,RegularSeason,1626155,212,Sam Dekker,1610612745,HOU,77,1419,203,429,0.473,60,187,0.321,38,68,0.559,94,190,284,76,38,21,41,83,504,626,1.85,0.93,2016,17,6.545454545454546,1.853658536585366,226,30,256,1.109375
2016-17,RegularSeason,1626162,213,Kelly Oubre Jr.,1610612764,WAS,79,1605,186,442,0.421,54,188,0.287,75,99,0.758,61,200,261,47,58,17,50,195,501,554,0.94,1.16,2016,17,6.341772151898734,0.94,256,24,280,0.9321428571428572
2016-17,RegularSeason,201980,214,Danny Green,1610612759,SAS,68,1807,176,449,0.392,118,311,0.379,27,32,0.844,31,193,224,124,70,57,76,120,497,618,1.63,0.92,2016,17,7.3088235294117645,1.631578947368421,273,5,278,0.8057553956834532
2016-17,RegularSeason,203585,214,Rodney McGruder,1610612748,MIA,78,1966,190,460,0.413,73,220,0.332,44,71,0.62,94,162,256,124,46,18,56,140,497,588,2.21,0.82,2016,17,6.371794871794871,2.2142857142857144,270,27,297,0.8619528619528619
2016-17,RegularSeason,203124,216,Kyle O'Quinn,1610612752,NYK,79,1229,215,413,0.521,2,17,0.118,64,83,0.771,157,282,439,117,36,104,76,174,496,899,1.54,0.47,2016,17,6.2784810126582276,1.5394736842105263,198,19,217,2.0230414746543777
2016-17,RegularSeason,203463,217,Ben McLemore,1610612758,SAC,61,1176,180,419,0.43,65,170,0.382,70,93,0.753,19,110,129,51,29,6,62,108,495,386,0.82,0.47,2016,17,8.114754098360656,0.8225806451612904,239,23,262,0.49236641221374045
2016-17,RegularSeason,201601,218,Luc Mbah a Moute,1610612746,LAC,80,1787,191,378,0.505,43,110,0.391,59,87,0.678,44,126,170,39,81,35,46,122,484,548,0.85,1.76,2016,17,6.05,0.8478260869565217,187,28,215,0.7906976744186046
2016-17,RegularSeason,202687,219,Bismack Biyombo,1610612753,ORL,81,1793,179,339,0.528,0,0,0.0,125,234,0.534,157,410,567,74,25,91,95,202,483,876,0.78,0.26,2016,17,5.962962962962963,0.7789473684210526,160,109,269,2.107806691449814
2016-17,RegularSeason,203613,219,Jonathon Simmons,1610612759,SAS,78,1392,177,421,0.42,30,102,0.294,99,132,0.75,20,140,160,126,47,25,76,146,483,488,1.66,0.62,2016,17,6.1923076923076925,1.6578947368421053,244,33,277,0.5776173285198556
2016-17,RegularSeason,1627734,221,Domantas Sabonis,1610612760,OKC,81,1631,192,481,0.399,51,159,0.321,44,67,0.657,46,242,288,82,39,32,83,200,479,525,0.99,0.47,2016,17,5.91358024691358,0.9879518072289156,289,23,312,0.9230769230769231
2016-17,RegularSeason,202324,222,Derrick Favors,1610612762,UTA,50,1186,203,417,0.487,3,10,0.3,67,109,0.615,92,213,305,56,45,40,60,103,476,606,0.93,0.75,2016,17,9.52,0.9333333333333333,214,42,256,1.19140625
2016-17,RegularSeason,201580,223,JaVale McGee,1610612744,GSW,77,739,208,319,0.652,0,3,0.0,56,111,0.505,100,144,244,17,19,67,40,109,472,613,0.42,0.47,2016,17,6.12987012987013,0.425,111,55,166,1.4698795180722892
2016-17,RegularSeason,201585,224,Kosta Koufos,1610612758,SAC,71,1419,216,392,0.551,0,1,0.0,38,62,0.613,118,285,403,47,36,48,61,172,470,743,0.77,0.59,2016,17,6.619718309859155,0.7704918032786885,176,24,200,2.015
2016-17,RegularSeason,1627747,225,Caris LeVert,1610612751,BKN,57,1237,171,380,0.45,59,184,0.321,67,93,0.72,23,165,188,110,49,8,59,91,468,529,1.86,0.83,2016,17,8.210526315789474,1.8644067796610169,209,26,235,0.8
2016-17,RegularSeason,204025,226,Tim Frazier,1610612740,NOP,65,1525,163,404,0.403,40,128,0.313,98,129,0.76,34,139,173,335,56,6,101,133,464,661,3.32,0.55,2016,17,7.138461538461539,3.3168316831683167,241,31,272,0.6360294117647058
2016-17,RegularSeason,1627812,227,Yogi Ferrell,1610612742,DAL,46,1197,160,394,0.406,68,176,0.386,74,89,0.831,20,91,111,172,42,9,70,90,462,477,2.46,0.6,2016,17,10.043478260869565,2.4571428571428573,234,15,249,0.4457831325301205
2016-17,RegularSeason,201229,228,Anthony Tolliver,1610612758,SAC,65,1477,155,351,0.442,90,230,0.391,61,82,0.744,51,186,237,77,34,20,56,109,461,556,1.38,0.61,2016,17,7.092307692307692,1.375,196,21,217,1.0921658986175116
2016-17,RegularSeason,203141,229,Mirza Teletovic,1610612749,MIL,70,1133,156,418,0.373,104,305,0.341,35,45,0.778,11,151,162,48,12,13,37,109,451,377,1.3,0.32,2016,17,6.442857142857143,1.2972972972972974,262,10,272,0.5955882352941176
2016-17,RegularSeason,1626204,230,Larry Nance Jr.,1610612747,LAL,63,1442,190,361,0.526,10,36,0.278,59,80,0.738,120,249,369,96,82,39,56,149,449,787,1.71,1.46,2016,17,7.126984126984127,1.7142857142857142,171,21,192,1.921875
2016-17,RegularSeason,2210,231,Richard Jefferson,1610612739,CLE,79,1614,153,343,0.446,62,186,0.333,80,108,0.741,28,175,203,78,26,10,52,153,448,495,1.5,0.5,2016,17,5.670886075949367,1.5,190,28,218,0.9311926605504587
2016-17,RegularSeason,203457,232,Nerlens Noel,1610612742,DAL,51,1047,184,309,0.595,0,1,0.0,77,111,0.694,93,201,294,50,65,50,51,126,445,694,0.98,1.27,2016,17,8.72549019607843,0.9803921568627451,125,34,159,1.849056603773585
2016-17,RegularSeason,202335,232,Patrick Patterson,1610612761,TOR,65,1599,154,384,0.401,94,253,0.372,43,60,0.717,62,231,293,76,40,23,38,120,445,592,2.0,1.05,2016,17,6.846153846153846,2.0,230,17,247,1.1862348178137652
2016-17,RegularSeason,1627789,232,Timothe Luwawu-Cabarrot,1610612755,PHI,69,1190,145,361,0.402,50,161,0.311,105,123,0.854,25,124,149,75,32,10,73,154,445,404,1.03,0.44,2016,17,6.449275362318841,1.0273972602739727,216,18,234,0.6367521367521367
2016-17,RegularSeason,200757,235,Thabo Sefolosha,1610612737,ATL,62,1596,174,395,0.441,41,120,0.342,55,75,0.733,54,216,270,107,96,31,58,97,444,649,1.84,1.66,2016,17,7.161290322580645,1.8448275862068966,221,20,241,1.120331950207469
2016-17,RegularSeason,1627755,235,Tyler Ulis,1610612756,PHX,61,1123,184,437,0.421,21,79,0.266,55,71,0.775,20,75,95,226,48,5,77,73,444,472,2.94,0.62,2016,17,7.278688524590164,2.935064935064935,253,16,269,0.35315985130111527
2016-17,RegularSeason,203120,237,Justin Hamilton,1610612751,BKN,64,1177,174,379,0.459,55,180,0.306,39,52,0.75,71,191,262,55,29,43,43,91,442,570,1.28,0.67,2016,17,6.90625,1.2790697674418605,205,13,218,1.201834862385321
2016-17,RegularSeason,1626168,238,Trey Lyles,1610612762,UTA,71,1158,159,439,0.362,65,204,0.319,57,79,0.722,48,187,235,69,26,20,64,97,440,424,1.08,0.41,2016,17,6.197183098591549,1.078125,280,22,302,0.7781456953642384
2016-17,RegularSeason,1626171,239,Bobby Portis,1610612741,CHI,64,1001,183,375,0.488,32,96,0.333,39,59,0.661,75,221,296,35,16,11,37,94,437,546,0.95,0.43,2016,17,6.828125,0.9459459459459459,192,20,212,1.3962264150943395
2016-17,RegularSeason,2734,239,Devin Harris,1610612742,DAL,65,1087,136,341,0.399,58,177,0.328,107,129,0.829,11,116,127,136,43,7,57,101,437,466,2.39,0.75,2016,17,6.723076923076923,2.3859649122807016,205,22,227,0.5594713656387665
2016-17,RegularSeason,203924,239,Jerami Grant,1610612760,OKC,80,1531,152,328,0.463,43,116,0.371,90,147,0.612,38,167,205,46,33,79,44,149,437,523,1.04,0.75,2016,17,5.4625,1.0454545454545454,176,57,233,0.8798283261802575
2016-17,RegularSeason,201967,242,Dante Cunningham,1610612740,NOP,66,1649,174,359,0.485,71,181,0.392,16,27,0.593,56,221,277,37,39,28,28,100,435,592,1.32,1.39,2016,17,6.590909090909091,1.3214285714285714,185,11,196,1.413265306122449
2016-17,RegularSeason,203488,242,Mike Muscala,1610612737,ATL,70,1237,170,337,0.504,46,110,0.418,49,64,0.766,76,164,240,95,30,41,55,97,435,604,1.73,0.55,2016,17,6.214285714285714,1.7272727272727273,167,15,182,1.3186813186813187
2016-17,RegularSeason,201162,244,Jared Dudley,1610612756,PHX,64,1362,157,346,0.454,77,203,0.379,43,65,0.662,31,194,225,121,42,16,73,154,434,554,1.66,0.57,2016,17,6.78125,1.6575342465753424,189,22,211,1.066350710900474
2016-17,RegularSeason,203915,245,Spencer Dinwiddie,1610612751,BKN,59,1334,134,302,0.444,38,101,0.376,126,159,0.792,27,137,164,185,44,23,66,119,432,581,2.8,0.67,2016,17,7.322033898305085,2.803030303030303,168,33,201,0.8159203980099502
2016-17,RegularSeason,202714,246,Shelvin Mack,1610612762,UTA,55,1205,170,381,0.446,37,120,0.308,53,77,0.688,20,105,125,154,42,3,90,100,430,429,1.71,0.47,2016,17,7.818181818181818,1.711111111111111,211,24,235,0.5319148936170213
2016-17,RegularSeason,203516,247,James Ennis III,1610612763,MEM,64,1501,146,321,0.455,51,137,0.372,86,110,0.782,69,190,259,64,46,19,59,165,429,559,1.08,0.78,2016,17,6.703125,1.0847457627118644,175,24,199,1.3015075376884422
2016-17,RegularSeason,203925,248,Joe Harris,1610612751,BKN,52,1138,154,362,0.425,85,221,0.385,35,49,0.714,16,131,147,54,30,8,55,121,428,390,0.98,0.55,2016,17,8.23076923076923,0.9818181818181818,208,14,222,0.6621621621621622
2016-17,RegularSeason,203114,249,Khris Middleton,1610612749,MIL,29,889,150,333,0.45,45,104,0.433,81,92,0.88,11,112,123,99,41,7,65,79,426,437,1.52,0.63,2016,17,14.689655172413794,1.523076923076923,183,11,194,0.634020618556701
2016-17,RegularSeason,2585,249,Zaza Pachulia,1610612744,GSW,70,1268,164,307,0.534,0,2,0.0,98,126,0.778,140,270,410,132,59,33,87,166,426,802,1.52,0.68,2016,17,6.085714285714285,1.5172413793103448,143,28,171,2.3976608187134505
2016-17,RegularSeason,1626150,251,Andrew Harrison,1610612763,MEM,72,1474,117,360,0.325,43,156,0.276,148,194,0.763,23,113,136,198,53,21,85,194,425,459,2.33,0.62,2016,17,5.902777777777778,2.3294117647058825,243,46,289,0.47058823529411764
2016-17,RegularSeason,2736,251,Luol Deng,1610612747,LAL,56,1486,164,424,0.387,51,165,0.309,46,63,0.73,63,232,295,74,48,20,43,61,425,542,1.72,1.12,2016,17,7.589285714285714,1.7209302325581395,260,17,277,1.0649819494584838
2016-17,RegularSeason,1627851,251,Mindaugas Kuzminskas,1610612752,NYK,68,1016,158,369,0.428,54,168,0.321,55,68,0.809,47,79,126,69,29,11,51,79,425,385,1.35,0.57,2016,17,6.25,1.3529411764705883,211,13,224,0.5625
2016-17,RegularSeason,201160,254,Jason Smith,1610612764,WAS,74,1068,174,329,0.529,37,78,0.474,35,51,0.686,64,194,258,37,21,54,58,168,420,561,0.64,0.36,2016,17,5.675675675675675,0.6379310344827587,155,16,171,1.5087719298245614
2016-17,RegularSeason,203922,255,Glenn Robinson III,1610612754,IND,69,1427,158,338,0.467,49,125,0.392,54,76,0.711,57,189,246,47,41,20,37,63,419,534,1.27,1.11,2016,17,6.072463768115942,1.2702702702702702,180,22,202,1.2178217821782178
2016-17,RegularSeason,2571,255,Leandro Barbosa,1610612756,PHX,67,963,172,392,0.439,35,98,0.357,40,45,0.889,15,89,104,81,31,8,48,82,419,370,1.69,0.65,2016,17,6.253731343283582,1.6875,220,5,225,0.4622222222222222
2016-17,RegularSeason,203957,257,Dante Exum,1610612762,UTA,66,1228,155,363,0.427,44,149,0.295,58,73,0.795,30,102,132,111,21,12,80,146,412,385,1.39,0.26,2016,17,6.242424242424242,1.3875,208,15,223,0.5919282511210763
2016-17,RegularSeason,201936,258,Tyreke Evans,1610612758,SAC,40,788,150,370,0.405,42,118,0.356,69,92,0.75,13,124,137,124,35,9,61,60,411,412,2.03,0.57,2016,17,10.275,2.0327868852459017,220,23,243,0.5637860082304527
2016-17,RegularSeason,1626179,259,Terry Rozier,1610612738,BOS,74,1263,151,411,0.367,57,179,0.318,51,66,0.773,40,187,227,131,45,11,47,69,410,502,2.79,0.96,2016,17,5.54054054054054,2.7872340425531914,260,15,275,0.8254545454545454
2016-17,RegularSeason,203518,260,Alex Abrines,1610612760,OKC,68,1055,134,341,0.393,94,247,0.381,44,49,0.898,18,68,86,40,37,8,33,114,406,332,1.21,1.12,2016,17,5.970588235294118,1.2121212121212122,207,5,212,0.4056603773584906
2016-17,RegularSeason,202357,261,Nemanja Bjelica,1610612750,MIN,65,1190,151,356,0.424,56,177,0.316,45,61,0.738,57,187,244,79,40,20,59,154,403,506,1.34,0.68,2016,17,6.2,1.3389830508474576,205,16,221,1.1040723981900453
2016-17,RegularSeason,203086,262,Meyers Leonard,1610612757,POR,74,1222,146,378,0.386,74,213,0.347,35,40,0.875,27,210,237,71,13,28,35,172,401,478,2.03,0.37,2016,17,5.418918918918919,2.0285714285714285,232,5,237,1.0
2016-17,RegularSeason,202389,262,Timofey Mozgov,1610612747,LAL,54,1104,169,328,0.515,0,1,0.0,63,78,0.808,104,160,264,43,16,31,72,133,401,509,0.6,0.22,2016,17,7.425925925925926,0.5972222222222222,159,15,174,1.5172413793103448
2016-17,RegularSeason,2199,264,Tyson Chandler,1610612756,PHX,47,1298,153,228,0.671,0,0,0.0,91,124,0.734,153,386,539,30,33,24,65,126,397,850,0.46,0.51,2016,17,8.446808510638299,0.46153846153846156,75,33,108,4.9907407407407405
2016-17,RegularSeason,203089,265,John Henson,1610612749,MIL,58,1123,159,309,0.515,0,1,0.0,74,107,0.692,92,203,295,57,29,78,52,151,392,616,1.1,0.56,2016,17,6.758620689655173,1.0961538461538463,150,33,183,1.6120218579234973
2016-17,RegularSeason,1627098,266,Malcolm Delaney,1610612737,ATL,73,1248,145,388,0.374,26,110,0.236,75,93,0.806,10,113,123,193,39,1,95,112,391,391,2.03,0.41,2016,17,5.3561643835616435,2.031578947368421,243,18,261,0.47126436781609193
2016-17,RegularSeason,2733,267,Shaun Livingston,1610612744,GSW,76,1345,173,316,0.547,1,3,0.333,42,60,0.7,28,123,151,139,38,20,62,120,389,514,2.24,0.61,2016,17,5.118421052631579,2.2419354838709675,143,18,161,0.937888198757764
2016-17,RegularSeason,203473,268,Dewayne Dedmon,1610612759,SAS,76,1330,161,259,0.622,0,0,0.0,65,93,0.699,129,367,496,44,37,61,61,180,387,838,0.72,0.61,2016,17,5.092105263157895,0.7213114754098361,98,28,126,3.9365079365079363
2016-17,RegularSeason,204028,269,Tarik Black,1610612747,LAL,67,1091,150,294,0.51,1,2,0.5,82,109,0.752,144,199,343,39,29,44,58,173,383,609,0.67,0.5,2016,17,5.7164179104477615,0.6724137931034483,144,27,171,2.0058479532163744
2016-17,RegularSeason,200826,270,J.J. Barea,1610612742,DAL,35,771,142,343,0.414,53,148,0.358,44,51,0.863,9,75,84,193,14,1,63,30,381,402,3.06,0.22,2016,17,10.885714285714286,3.0634920634920637,201,7,208,0.40384615384615385
2016-17,RegularSeason,203530,271,Joffrey Lauvergne,1610612741,CHI,70,980,148,336,0.44,33,98,0.337,46,73,0.63,72,179,251,70,25,6,56,83,375,456,1.25,0.45,2016,17,5.357142857142857,1.25,188,27,215,1.1674418604651162
2016-17,RegularSeason,203186,272,Willie Reed,1610612748,MIA,71,1031,162,285,0.568,1,4,0.25,49,88,0.557,129,203,332,26,18,47,31,137,374,604,0.84,0.58,2016,17,5.267605633802817,0.8387096774193549,123,39,162,2.049382716049383
2016-17,RegularSeason,201147,273,Corey Brewer,1610612747,LAL,82,1281,147,348,0.422,27,118,0.229,50,68,0.735,32,134,166,97,61,20,55,133,371,441,1.76,1.11,2016,17,4.524390243902439,1.7636363636363637,201,18,219,0.7579908675799086
2016-17,RegularSeason,1626170,274,Jerian Grant,1610612741,CHI,63,1028,128,301,0.425,49,134,0.366,65,73,0.89,17,94,111,121,47,8,44,93,370,432,2.75,1.07,2016,17,5.873015873015873,2.75,173,8,181,0.6132596685082873
2016-17,RegularSeason,203382,275,Aron Baynes,1610612765,DET,75,1163,143,279,0.513,0,0,0.0,79,94,0.84,111,222,333,32,17,39,50,166,365,585,0.64,0.34,2016,17,4.866666666666666,0.64,136,15,151,2.205298013245033
2016-17,RegularSeason,200751,276,Randy Foye,1610612751,BKN,69,1284,118,325,0.363,67,203,0.33,54,63,0.857,9,146,155,135,35,9,80,99,357,395,1.69,0.44,2016,17,5.173913043478261,1.6875,207,9,216,0.7175925925925926
2016-17,RegularSeason,2747,277,JR Smith,1610612739,CLE,41,1187,123,356,0.346,95,271,0.351,10,15,0.667,17,96,113,62,40,11,26,77,351,313,2.38,1.54,2016,17,8.560975609756097,2.3846153846153846,233,5,238,0.47478991596638653
2016-17,RegularSeason,1627827,278,Dorian Finney-Smith,1610612742,DAL,81,1642,124,333,0.372,56,191,0.293,46,61,0.754,55,167,222,67,52,25,45,125,350,447,1.49,1.16,2016,17,4.320987654320987,1.488888888888889,209,15,224,0.9910714285714286
2016-17,RegularSeason,1626210,279,Alan Williams,1610612756,PHX,47,708,138,267,0.517,0,1,0.0,70,112,0.625,94,198,292,23,27,32,37,125,346,512,0.62,0.73,2016,17,7.361702127659575,0.6216216216216216,129,42,171,1.7076023391812865
2016-17,RegularSeason,1626169,280,Stanley Johnson,1610612765,DET,77,1371,129,365,0.353,45,154,0.292,36,53,0.679,36,153,189,105,56,24,71,121,339,389,1.48,0.79,2016,17,4.402597402597403,1.4788732394366197,236,17,253,0.7470355731225297
2016-17,RegularSeason,2564,281,Boris Diaw,1610612762,UTA,73,1283,146,327,0.446,20,81,0.247,26,35,0.743,46,112,158,170,18,9,87,83,338,416,1.95,0.21,2016,17,4.63013698630137,1.9540229885057472,181,9,190,0.8315789473684211
2016-17,RegularSeason,201150,282,Spencer Hawes,1610612749,MIL,54,797,134,277,0.484,25,81,0.309,44,52,0.846,38,153,191,81,15,30,49,77,337,454,1.65,0.31,2016,17,6.2407407407407405,1.653061224489796,143,8,151,1.2649006622516556
2016-17,RegularSeason,1627752,283,Taurean Prince,1610612737,ATL,59,981,114,285,0.4,33,102,0.324,74,94,0.787,25,132,157,55,43,27,61,96,335,365,0.9,0.7,2016,17,5.677966101694915,0.9016393442622951,171,20,191,0.8219895287958116
2016-17,RegularSeason,201975,284,Jodie Meeks,1610612753,ORL,36,738,103,256,0.402,56,137,0.409,65,74,0.878,5,72,77,45,34,4,36,41,327,289,1.25,0.94,2016,17,9.083333333333334,1.25,153,9,162,0.47530864197530864
2016-17,RegularSeason,203943,284,Noah Vonleh,1610612757,POR,74,1265,130,270,0.481,7,20,0.35,60,94,0.638,131,256,387,31,30,27,64,154,327,564,0.48,0.47,2016,17,4.418918918918919,0.484375,140,34,174,2.2241379310344827
2016-17,RegularSeason,202337,286,Luke Babbitt,1610612748,MIA,68,1065,113,281,0.402,87,210,0.414,11,15,0.733,12,129,141,36,20,11,25,118,324,335,1.44,0.8,2016,17,4.764705882352941,1.44,168,4,172,0.8197674418604651
2016-17,RegularSeason,201166,287,Aaron Brooks,1610612754,IND,65,894,121,300,0.403,48,128,0.375,32,40,0.8,18,51,69,125,25,9,66,93,322,297,1.89,0.38,2016,17,4.953846153846154,1.893939393939394,179,8,187,0.3689839572192513
2016-17,RegularSeason,1626209,288,Mario Hezonja,1610612753,ORL,65,960,117,330,0.355,43,144,0.299,40,50,0.8,20,126,146,62,30,15,58,74,317,289,1.07,0.52,2016,17,4.876923076923077,1.0689655172413792,213,10,223,0.6547085201793722
2016-17,RegularSeason,1626245,289,Cristiano Felicio,1610612741,CHI,66,1040,128,221,0.579,0,0,0.0,60,93,0.645,124,187,311,40,25,17,33,110,316,550,1.21,0.76,2016,17,4.787878787878788,1.2121212121212122,93,33,126,2.4682539682539684
2016-17,RegularSeason,2561,289,David West,1610612744,GSW,68,854,135,252,0.536,3,8,0.375,43,56,0.768,47,156,203,151,42,48,78,105,316,552,1.94,0.54,2016,17,4.647058823529412,1.935897435897436,117,13,130,1.5615384615384615
2016-17,RegularSeason,201196,291,Ramon Sessions,1610612766,CHA,50,811,100,263,0.38,21,62,0.339,91,118,0.771,11,62,73,129,27,3,46,43,312,308,2.8,0.59,2016,17,6.24,2.8043478260869565,163,27,190,0.38421052631578945
2016-17,RegularSeason,1891,292,Jason Terry,1610612749,MIL,74,1365,105,243,0.432,73,171,0.427,24,29,0.828,15,91,106,98,46,20,36,95,307,398,2.72,1.28,2016,17,4.148648648648648,2.7222222222222223,138,5,143,0.7412587412587412
2016-17,RegularSeason,1627823,293,Juancho Hernangomez,1610612743,DEN,62,842,101,224,0.451,46,113,0.407,57,76,0.75,43,144,187,29,30,12,31,62,305,390,0.94,0.97,2016,17,4.919354838709677,0.9354838709677419,123,19,142,1.3169014084507042
2016-17,RegularSeason,202682,294,Derrick Williams,1610612739,CLE,50,804,108,244,0.443,30,97,0.309,58,89,0.652,19,111,130,28,14,7,28,60,304,288,1.0,0.5,2016,17,6.08,1.0,136,31,167,0.7784431137724551
2016-17,RegularSeason,202722,295,Dāvis Bertāns,1610612759,SAS,67,808,103,234,0.44,69,173,0.399,28,34,0.824,22,76,98,46,20,28,32,75,303,326,1.44,0.63,2016,17,4.522388059701493,1.4375,131,6,137,0.7153284671532847
2016-17,RegularSeason,201973,296,Jonas Jerebko,1610612738,BOS,78,1232,114,262,0.435,45,130,0.346,26,37,0.703,59,213,272,71,25,17,39,122,299,486,1.82,0.64,2016,17,3.8333333333333335,1.8205128205128205,148,11,159,1.7106918238993711
2016-17,RegularSeason,203487,297,Michael Carter-Williams,1610612741,CHI,45,846,112,306,0.366,15,64,0.234,58,77,0.753,24,129,153,113,38,23,66,102,297,345,1.71,0.58,2016,17,6.6,1.7121212121212122,194,19,213,0.7183098591549296
2016-17,RegularSeason,1627739,298,Kris Dunn,1610612750,MIN,78,1333,118,313,0.377,21,73,0.288,36,59,0.61,24,142,166,188,78,36,89,178,293,454,2.11,0.88,2016,17,3.7564102564102564,2.1123595505617976,195,23,218,0.7614678899082569
2016-17,RegularSeason,101138,299,Brandon Bass,1610612746,LAC,52,577,107,186,0.575,1,3,0.333,77,88,0.875,43,86,129,21,14,11,29,45,292,348,0.72,0.48,2016,17,5.615384615384615,0.7241379310344828,79,11,90,1.4333333333333333
2016-17,RegularSeason,1627756,300,Denzel Valentine,1610612741,CHI,57,977,102,288,0.354,73,208,0.351,14,18,0.778,11,140,151,63,30,7,49,86,291,303,1.29,0.61,2016,17,5.105263157894737,1.2857142857142858,186,4,190,0.7947368421052632
2016-17,RegularSeason,1627746,301,Skal Labissiere,1610612758,SAC,33,612,117,218,0.537,3,8,0.375,52,74,0.703,51,111,162,27,16,13,37,64,289,347,0.73,0.43,2016,17,8.757575757575758,0.7297297297297297,101,22,123,1.3170731707317074
2016-17,RegularSeason,203504,302,Trey Burke,1610612764,WAS,57,703,116,255,0.455,31,70,0.443,22,29,0.759,7,40,47,100,11,5,48,54,285,254,2.08,0.23,2016,17,5.0,2.0833333333333335,139,7,146,0.3219178082191781
2016-17,RegularSeason,1627826,303,Ivica Zubac,1610612747,LAL,38,609,126,238,0.529,0,3,0.0,32,49,0.653,41,118,159,30,14,33,30,66,284,361,1.0,0.47,2016,17,7.473684210526316,1.0,112,17,129,1.2325581395348837
2016-17,RegularSeason,202692,304,Alec Burks,1610612762,UTA,42,653,99,248,0.399,25,76,0.329,60,78,0.769,17,103,120,30,18,5,35,50,283,254,0.86,0.51,2016,17,6.738095238095238,0.8571428571428571,149,18,167,0.718562874251497
2016-17,RegularSeason,1627775,305,Patrick McCaw,1610612744,GSW,71,1074,106,245,0.433,41,123,0.333,29,37,0.784,21,79,100,77,32,15,36,62,282,323,2.14,0.89,2016,17,3.971830985915493,2.138888888888889,139,8,147,0.6802721088435374
2016-17,RegularSeason,201228,306,C.J. Watson,1610612753,ORL,62,1013,96,248,0.387,32,105,0.305,57,66,0.864,16,73,89,114,43,2,47,84,281,321,2.43,0.92,2016,17,4.532258064516129,2.425531914893617,152,9,161,0.5527950310559007
2016-17,RegularSeason,201155,306,Rodney Stuckey,1610612754,IND,39,696,91,244,0.373,19,60,0.317,80,107,0.748,6,78,84,84,16,0,53,44,281,232,1.58,0.3,2016,17,7.205128205128205,1.5849056603773586,153,27,180,0.4666666666666667
2016-17,RegularSeason,202498,308,Lance Thomas,1610612752,NYK,46,968,97,244,0.398,38,85,0.447,43,51,0.843,32,110,142,35,21,5,25,85,275,298,1.4,0.84,2016,17,5.978260869565218,1.4,147,8,155,0.9161290322580645
2016-17,RegularSeason,2399,308,Mike Dunleavy,1610612737,ATL,53,841,93,220,0.423,53,134,0.396,36,45,0.8,18,97,115,50,15,7,28,67,275,298,1.79,0.54,2016,17,5.188679245283019,1.7857142857142858,127,9,136,0.8455882352941176
2016-17,RegularSeason,201627,310,Anthony Morrow,1610612741,CHI,49,714,98,252,0.389,41,133,0.308,34,37,0.919,12,19,31,25,24,2,6,44,271,190,4.17,4.0,2016,17,5.530612244897959,4.166666666666667,154,3,157,0.19745222929936307
2016-17,RegularSeason,202348,311,Jordan Crawford,1610612740,NOP,19,442,105,218,0.482,37,95,0.389,20,26,0.769,4,30,34,57,11,2,25,30,267,227,2.28,0.44,2016,17,14.052631578947368,2.28,113,6,119,0.2857142857142857
2016-17,RegularSeason,201589,312,Darrell Arthur,1610612743,DEN,41,639,95,215,0.442,53,117,0.453,19,22,0.864,25,87,112,42,19,21,36,76,262,297,1.17,0.53,2016,17,6.390243902439025,1.1666666666666667,120,3,123,0.9105691056910569
2016-17,RegularSeason,101123,312,Gerald Green,1610612738,BOS,47,538,95,232,0.409,39,111,0.351,33,41,0.805,16,68,84,33,9,7,25,48,262,225,1.32,0.36,2016,17,5.574468085106383,1.32,137,8,145,0.5793103448275863
2016-17,RegularSeason,2743,314,Kris Humphries,1610612737,ATL,56,689,87,214,0.407,19,54,0.352,64,82,0.78,60,146,206,29,15,21,28,69,257,355,1.04,0.54,2016,17,4.589285714285714,1.0357142857142858,127,18,145,1.4206896551724137
2016-17,RegularSeason,203512,315,Lucas Nogueira,1610612761,TOR,57,1088,103,156,0.66,3,12,0.25,44,67,0.657,82,162,244,42,52,89,46,137,253,558,0.91,1.13,2016,17,4.43859649122807,0.9130434782608695,53,23,76,3.210526315789474
2016-17,RegularSeason,203937,316,Kyle Anderson,1610612759,SAS,72,1020,93,209,0.445,15,40,0.375,45,57,0.789,33,175,208,91,51,26,39,63,246,455,2.33,1.31,2016,17,3.4166666666666665,2.3333333333333335,116,12,128,1.625
2016-17,RegularSeason,203080,317,Thomas Robinson,1610612747,LAL,48,560,105,196,0.536,0,1,0.0,31,66,0.47,84,139,223,31,26,9,46,76,241,358,0.67,0.56,2016,17,5.020833333333333,0.6739130434782609,91,35,126,1.7698412698412698
2016-17,RegularSeason,1627835,318,Paul Zipser,1610612741,CHI,44,843,88,221,0.398,33,99,0.333,31,40,0.775,15,110,125,36,15,16,40,78,240,250,0.9,0.38,2016,17,5.454545454545454,0.9,133,9,142,0.8802816901408451
2016-17,RegularSeason,201149,319,Joakim Noah,1610612752,NYK,46,1015,99,202,0.49,0,1,0.0,34,78,0.436,162,241,403,103,30,37,58,127,232,600,1.78,0.52,2016,17,5.043478260869565,1.7758620689655173,103,44,147,2.741496598639456
2016-17,RegularSeason,202338,319,Kevin Seraphin,1610612754,IND,49,559,109,198,0.551,0,2,0.0,14,22,0.636,41,101,142,23,7,20,29,66,232,298,0.79,0.24,2016,17,4.73469387755102,0.7931034482758621,89,8,97,1.4639175257731958
2016-17,RegularSeason,1627783,321,Pascal Siakam,1610612761,TOR,55,859,103,205,0.502,1,7,0.143,22,32,0.688,64,121,185,17,26,45,33,109,229,357,0.52,0.79,2016,17,4.163636363636364,0.5151515151515151,102,10,112,1.6517857142857142
2016-17,RegularSeason,203898,322,Tyler Ennis,1610612747,LAL,53,588,90,208,0.433,27,70,0.386,21,25,0.84,9,36,45,86,25,2,45,58,228,219,1.91,0.56,2016,17,4.30188679245283,1.9111111111111112,118,4,122,0.36885245901639346
2016-17,RegularSeason,2757,323,Beno Udrih,1610612765,DET,39,560,92,197,0.467,11,32,0.344,32,34,0.941,6,51,57,131,13,0,36,29,227,285,3.64,0.36,2016,17,5.82051282051282,3.638888888888889,105,2,107,0.5327102803738317
2016-17,RegularSeason,1627748,324,Thon Maker,1610612749,MIL,57,562,83,181,0.459,28,74,0.378,32,49,0.653,40,74,114,23,10,26,17,84,226,267,1.35,0.59,2016,17,3.9649122807017543,1.3529411764705883,98,17,115,0.991304347826087
2016-17,RegularSeason,203112,325,Quincy Acy,1610612751,BKN,38,558,70,170,0.412,37,90,0.411,45,60,0.75,20,95,115,18,14,15,21,67,222,248,0.86,0.67,2016,17,5.842105263157895,0.8571428571428571,100,15,115,1.0
2016-17,RegularSeason,201579,326,Roy Hibbert,1610612743,DEN,48,682,80,147,0.544,0,0,0.0,61,75,0.813,54,98,152,21,8,46,32,100,221,335,0.66,0.25,2016,17,4.604166666666667,0.65625,67,14,81,1.876543209876543
2016-17,RegularSeason,201977,327,Marcus Thornton,1610612764,WAS,33,575,84,210,0.4,28,80,0.35,23,27,0.852,22,54,76,41,19,3,25,48,219,203,1.64,0.76,2016,17,6.636363636363637,1.64,126,4,130,0.5846153846153846
2016-17,RegularSeason,203894,328,Shabazz Napier,1610612757,POR,53,512,73,183,0.399,34,92,0.37,38,49,0.776,8,53,61,67,32,2,41,38,218,218,1.63,0.78,2016,17,4.113207547169812,1.6341463414634145,110,11,121,0.5041322314049587
2016-17,RegularSeason,1627758,329,Ron Baker,1610612752,NYK,52,857,82,217,0.378,23,86,0.267,28,43,0.651,12,86,98,107,34,8,56,74,215,256,1.91,0.61,2016,17,4.134615384615385,1.9107142857142858,135,15,150,0.6533333333333333
2016-17,RegularSeason,1626257,330,Salah Mejri,1610612742,DAL,73,905,88,137,0.642,1,3,0.333,36,61,0.59,97,211,308,14,32,61,40,152,213,514,0.35,0.8,2016,17,2.9178082191780823,0.35,49,25,74,4.162162162162162
2016-17,RegularSeason,202718,331,Chandler Parsons,1610612763,MEM,34,675,75,222,0.338,25,93,0.269,35,43,0.814,6,78,84,55,20,5,24,52,210,195,2.29,0.83,2016,17,6.176470588235294,2.2916666666666665,147,8,155,0.5419354838709678
2016-17,RegularSeason,1626145,332,Tyus Jones,1610612750,MIN,60,774,75,181,0.414,26,73,0.356,33,43,0.767,10,57,67,156,48,5,38,50,209,331,4.11,1.26,2016,17,3.4833333333333334,4.105263157894737,106,10,116,0.5775862068965517
2016-17,RegularSeason,201582,333,Alexis Ajinca,1610612740,NOP,39,584,89,178,0.5,0,4,0.0,29,40,0.725,46,131,177,12,20,22,31,77,207,307,0.39,0.65,2016,17,5.3076923076923075,0.3870967741935484,89,11,100,1.77
2016-17,RegularSeason,203909,334,KJ McDaniels,1610612751,BKN,49,506,77,169,0.456,20,66,0.303,32,38,0.842,15,67,82,13,19,18,29,49,206,211,0.45,0.66,2016,17,4.204081632653061,0.4482758620689655,92,6,98,0.8367346938775511
2016-17,RegularSeason,203138,335,Hollis Thompson,1610612740,NOP,40,752,77,200,0.385,32,95,0.337,19,29,0.655,19,93,112,35,20,6,11,69,205,234,3.18,1.82,2016,17,5.125,3.1818181818181817,123,10,133,0.8421052631578947
2016-17,RegularSeason,202334,336,Ed Davis,1610612757,POR,46,789,75,142,0.528,0,0,0.0,50,81,0.617,96,148,244,26,15,22,37,137,200,372,0.7,0.41,2016,17,4.3478260869565215,0.7027027027027027,67,31,98,2.489795918367347
2016-17,RegularSeason,201575,337,Brandon Rush,1610612750,MIN,47,1030,70,187,0.374,44,114,0.386,13,18,0.722,16,83,99,45,22,23,28,42,197,236,1.61,0.79,2016,17,4.191489361702128,1.6071428571428572,117,5,122,0.8114754098360656
2016-17,RegularSeason,1626159,338,Justise Winslow,1610612748,MIA,18,625,80,225,0.356,7,35,0.2,29,47,0.617,23,71,94,66,26,6,33,52,196,192,2.0,0.79,2016,17,10.88888888888889,2.0,145,18,163,0.5766871165644172
2016-17,RegularSeason,1626246,339,Boban Marjanovic,1610612765,DET,35,293,72,132,0.545,0,0,0.0,47,58,0.81,46,84,130,9,6,12,10,25,191,267,0.9,0.6,2016,17,5.457142857142857,0.9,60,11,71,1.8309859154929577
2016-17,RegularSeason,201148,340,Brandan Wright,1610612763,MEM,28,447,83,135,0.615,0,1,0.0,23,35,0.657,31,47,78,15,11,20,10,42,189,239,1.5,1.1,2016,17,6.75,1.5,52,12,64,1.21875
2016-17,RegularSeason,201956,341,Omri Casspi,1610612750,MIN,36,642,77,164,0.47,15,43,0.349,17,29,0.586,27,85,112,37,23,3,29,50,186,233,1.28,0.79,2016,17,5.166666666666667,1.2758620689655173,87,12,99,1.1313131313131313
2016-17,RegularSeason,202325,341,Wesley Johnson,1610612746,LAC,68,810,73,200,0.365,29,118,0.246,11,17,0.647,26,155,181,23,29,30,18,83,186,298,1.28,1.61,2016,17,2.735294117647059,1.2777777777777777,127,6,133,1.3609022556390977
2016-17,RegularSeason,1627786,343,Troy Williams,1610612745,HOU,30,557,73,167,0.437,18,62,0.29,21,32,0.656,15,54,69,25,27,10,32,60,185,179,0.78,0.84,2016,17,6.166666666666667,0.78125,94,11,105,0.6571428571428571
2016-17,RegularSeason,2449,344,Luis Scola,1610612751,BKN,36,461,71,151,0.47,17,50,0.34,25,37,0.676,51,88,139,37,14,4,34,63,184,252,1.09,0.41,2016,17,5.111111111111111,1.088235294117647,80,12,92,1.5108695652173914
2016-17,RegularSeason,203902,345,Semaj Christon,1610612760,OKC,64,973,77,223,0.345,12,63,0.19,17,31,0.548,19,68,87,130,28,7,43,79,183,232,3.02,0.65,2016,17,2.859375,3.0232558139534884,146,14,160,0.54375
2016-17,RegularSeason,203477,346,Isaiah Canaan,1610612741,CHI,39,592,63,173,0.364,25,94,0.266,30,33,0.909,6,44,50,37,22,1,21,35,181,157,1.76,1.05,2016,17,4.641025641025641,1.7619047619047619,110,3,113,0.4424778761061947
2016-17,RegularSeason,203092,347,Tyler Zeller,1610612738,BOS,51,525,78,158,0.494,0,1,0.0,22,39,0.564,43,81,124,42,7,21,20,61,178,255,2.1,0.35,2016,17,3.4901960784313726,2.1,80,17,97,1.2783505154639174
2016-17,RegularSeason,202730,348,Lavoy Allen,1610612754,IND,61,871,77,168,0.458,0,1,0.0,23,33,0.697,105,114,219,57,18,24,29,78,177,365,1.97,0.62,2016,17,2.901639344262295,1.9655172413793103,91,10,101,2.1683168316831685
2016-17,RegularSeason,101133,349,Ian Mahinmi,1610612764,WAS,31,555,65,111,0.586,0,0,0.0,43,75,0.573,47,103,150,19,33,24,34,90,173,287,0.56,0.97,2016,17,5.580645161290323,0.5588235294117647,46,32,78,1.9230769230769231
2016-17,RegularSeason,1627884,350,Derrick Jones Jr.,1610612756,PHX,32,545,68,121,0.562,3,11,0.273,29,41,0.707,39,40,79,12,14,13,13,63,168,208,0.92,1.08,2016,17,5.25,0.9230769230769231,53,12,65,1.2153846153846153
2016-17,RegularSeason,1627770,351,Kay Felder,1610612739,CLE,42,386,62,158,0.392,7,22,0.318,35,49,0.714,3,38,41,58,18,7,30,38,166,150,1.93,0.6,2016,17,3.9523809523809526,1.9333333333333333,96,14,110,0.37272727272727274
2016-17,RegularSeason,1627751,352,Jakob Poeltl,1610612761,TOR,54,626,67,115,0.583,0,0,0.0,31,57,0.544,78,87,165,12,17,20,29,113,165,276,0.41,0.59,2016,17,3.0555555555555554,0.41379310344827586,48,26,74,2.22972972972973
2016-17,RegularSeason,1626185,352,Jarell Martin,1610612763,MEM,42,558,58,151,0.384,9,25,0.36,40,50,0.8,42,120,162,8,17,9,28,91,165,230,0.29,0.61,2016,17,3.9285714285714284,0.2857142857142857,93,10,103,1.5728155339805825
2016-17,RegularSeason,203895,354,Jordan McRae,1610612739,CLE,37,384,58,150,0.387,18,51,0.353,27,34,0.794,6,35,41,19,8,6,14,31,161,122,1.36,0.57,2016,17,4.351351351351352,1.3571428571428572,92,7,99,0.41414141414141414
2016-17,RegularSeason,1626166,355,Cameron Payne,1610612741,CHI,31,462,64,193,0.332,27,86,0.314,5,8,0.625,3,45,48,55,14,4,29,52,160,120,1.9,0.48,2016,17,5.161290322580645,1.896551724137931,129,3,132,0.36363636363636365
2016-17,RegularSeason,203107,356,Tomas Satoransky,1610612764,WAS,57,719,61,147,0.415,9,37,0.243,23,33,0.697,25,58,83,92,26,6,38,60,154,227,2.42,0.68,2016,17,2.7017543859649122,2.4210526315789473,86,10,96,0.8645833333333334
2016-17,RegularSeason,202732,357,DeAndre Liggins,1610612742,DAL,62,777,55,142,0.387,17,46,0.37,25,40,0.625,20,88,108,54,47,14,42,81,152,231,1.29,1.12,2016,17,2.4516129032258065,1.2857142857142858,87,15,102,1.0588235294117647
2016-17,RegularSeason,1626153,358,Delon Wright,1610612761,TOR,27,446,49,116,0.422,10,30,0.333,42,55,0.764,16,32,48,57,27,11,25,31,150,188,2.28,1.08,2016,17,5.555555555555555,2.28,67,13,80,0.6
2016-17,RegularSeason,202700,358,Donatas Motiejunas,1610612740,NOP,34,479,57,138,0.413,11,47,0.234,25,49,0.51,26,75,101,32,18,11,31,55,150,176,1.03,0.58,2016,17,4.411764705882353,1.032258064516129,81,24,105,0.9619047619047619
2016-17,RegularSeason,1627852,358,Nicolas Brussino,1610612742,DAL,54,521,52,141,0.369,29,95,0.305,17,22,0.773,26,69,95,47,17,8,26,43,150,197,1.81,0.65,2016,17,2.7777777777777777,1.8076923076923077,89,5,94,1.0106382978723405
2016-17,RegularSeason,1627848,361,Shawn Long,1610612755,PHI,18,234,61,109,0.56,7,19,0.368,19,35,0.543,41,44,85,13,9,9,13,49,148,187,1.0,0.69,2016,17,8.222222222222221,1.0,48,16,64,1.328125
2016-17,RegularSeason,203949,362,James Michael McAdoo,1610612744,GSW,52,457,62,117,0.53,2,8,0.25,21,42,0.5,34,57,91,18,18,29,19,47,147,208,0.95,0.95,2016,17,2.826923076923077,0.9473684210526315,55,21,76,1.1973684210526316
2016-17,RegularSeason,1627733,363,Dragan Bender,1610612756,PHX,43,574,57,161,0.354,28,101,0.277,4,11,0.364,23,80,103,23,10,22,32,74,146,161,0.72,0.31,2016,17,3.395348837209302,0.71875,104,7,111,0.9279279279279279
2016-17,RegularSeason,203481,363,Jeff Withey,1610612762,UTA,51,432,55,103,0.534,0,1,0.0,36,48,0.75,52,69,121,7,16,32,14,52,146,248,0.5,1.14,2016,17,2.8627450980392157,0.5,48,12,60,2.0166666666666666
2016-17,RegularSeason,203148,365,Brian Roberts,1610612766,CHA,41,416,46,122,0.377,17,44,0.386,33,39,0.846,5,34,39,52,9,1,26,18,142,135,2.0,0.35,2016,17,3.4634146341463414,2.0,76,6,82,0.47560975609756095
2016-17,RegularSeason,1626173,365,Rashad Vaughn,1610612749,MIL,41,459,57,156,0.365,26,81,0.321,2,5,0.4,4,45,49,23,19,10,14,32,142,127,1.64,1.36,2016,17,3.4634146341463414,1.6428571428571428,99,3,102,0.4803921568627451
2016-17,RegularSeason,101181,367,Jose Calderon,1610612737,ATL,41,539,55,134,0.41,20,64,0.313,11,12,0.917,15,59,74,88,11,1,41,36,141,194,2.15,0.27,2016,17,3.4390243902439024,2.1463414634146343,79,1,80,0.925
2016-17,RegularSeason,203493,367,Reggie Bullock Jr.,1610612765,DET,31,467,54,128,0.422,28,73,0.384,5,7,0.714,13,51,64,29,18,3,10,22,141,169,2.9,1.8,2016,17,4.548387096774194,2.9,74,2,76,0.8421052631578947
2016-17,RegularSeason,1626184,369,Chasson Randle,1610612752,NYK,26,299,40,98,0.408,16,47,0.34,41,43,0.953,6,26,32,34,9,2,19,39,137,135,1.79,0.47,2016,17,5.269230769230769,1.7894736842105263,58,2,60,0.5333333333333333
2016-17,RegularSeason,1626172,370,Kevon Looney,1610612744,GSW,53,447,56,107,0.523,2,9,0.222,21,34,0.618,44,80,124,29,15,17,17,64,135,239,1.71,0.88,2016,17,2.547169811320755,1.7058823529411764,51,13,64,1.9375
2016-17,RegularSeason,2592,371,James Jones,1610612739,CLE,48,381,44,92,0.478,31,66,0.47,13,20,0.65,3,34,37,14,6,10,10,37,132,134,1.4,0.6,2016,17,2.75,1.4,48,7,55,0.6727272727272727
2016-17,RegularSeason,1627749,372,Dejounte Murray,1610612759,SAS,38,322,50,116,0.431,9,23,0.391,21,30,0.7,6,36,42,48,8,6,38,29,130,121,1.26,0.21,2016,17,3.4210526315789473,1.263157894736842,66,9,75,0.56
2016-17,RegularSeason,1626199,373,Darrun Hilliard,1610612765,DET,39,381,47,126,0.373,12,46,0.261,21,28,0.75,2,31,33,33,11,2,28,39,127,92,1.18,0.39,2016,17,3.2564102564102564,1.1785714285714286,79,7,86,0.38372093023255816
2016-17,RegularSeason,1627834,374,Georgios Papagiannis,1610612758,SAC,22,355,56,102,0.549,0,2,0.0,12,14,0.857,24,62,86,20,3,17,24,44,124,178,0.83,0.13,2016,17,5.636363636363637,0.8333333333333334,46,2,48,1.7916666666666667
2016-17,RegularSeason,2756,374,Sasha Vujacic,1610612752,NYK,42,408,42,136,0.309,23,74,0.311,17,24,0.708,12,47,59,52,13,2,16,38,124,133,3.25,0.81,2016,17,2.9523809523809526,3.25,94,7,101,0.5841584158415841
2016-17,RegularSeason,202362,376,Lance Stephenson,1610612754,IND,18,362,54,120,0.45,6,20,0.3,8,13,0.615,4,48,52,59,5,3,26,32,122,144,2.27,0.19,2016,17,6.777777777777778,2.269230769230769,66,5,71,0.7323943661971831
2016-17,RegularSeason,1628021,377,David Nwaba,1610612747,LAL,20,397,47,81,0.58,1,5,0.2,25,39,0.641,17,46,63,14,13,7,11,36,120,158,1.27,1.18,2016,17,6.0,1.2727272727272727,34,14,48,1.3125
2016-17,RegularSeason,201962,378,Toney Douglas,1610612763,MEM,24,394,43,117,0.368,7,42,0.167,24,29,0.828,13,48,61,56,18,5,21,50,117,157,2.67,0.86,2016,17,4.875,2.6666666666666665,74,5,79,0.7721518987341772
2016-17,RegularSeason,203461,379,Anthony Bennett,1610612751,BKN,23,264,38,92,0.413,13,48,0.271,26,36,0.722,25,53,78,12,5,3,12,18,115,137,1.0,0.42,2016,17,5.0,1.0,54,10,64,1.21875
2016-17,RegularSeason,203101,380,Miles Plumlee,1610612766,CHA,45,485,44,92,0.478,0,0,0.0,25,39,0.641,38,57,95,21,18,13,30,73,113,168,0.7,0.6,2016,17,2.511111111111111,0.7,48,14,62,1.532258064516129
2016-17,RegularSeason,203462,381,Archie Goodwin,1610612751,BKN,15,214,36,66,0.545,5,15,0.333,33,42,0.786,7,21,28,24,4,5,14,8,110,118,1.71,0.29,2016,17,7.333333333333333,1.7142857142857142,30,9,39,0.717948717948718
2016-17,RegularSeason,1627832,382,Fred VanVleet,1610612761,TOR,37,294,39,111,0.351,11,29,0.379,18,22,0.818,4,38,42,35,16,3,15,36,107,112,2.33,1.07,2016,17,2.891891891891892,2.3333333333333335,72,4,76,0.5526315789473685
2016-17,RegularSeason,201177,382,Josh McRoberts,1610612748,MIA,22,381,44,118,0.373,13,31,0.419,6,9,0.667,23,51,74,50,10,4,23,31,107,145,2.17,0.43,2016,17,4.863636363636363,2.1739130434782608,74,3,77,0.961038961038961
2016-17,RegularSeason,1626780,384,Jonathan Gibson,1610612742,DAL,17,231,35,95,0.368,15,45,0.333,21,29,0.724,1,21,22,26,8,0,21,21,106,73,1.24,0.38,2016,17,6.235294117647059,1.2380952380952381,60,8,68,0.3235294117647059
2016-17,RegularSeason,1627735,384,Wade Baldwin IV,1610612763,MEM,33,405,36,115,0.313,3,22,0.136,31,37,0.838,11,35,46,61,18,7,39,40,106,114,1.56,0.46,2016,17,3.212121212121212,1.564102564102564,79,6,85,0.5411764705882353
2016-17,RegularSeason,202332,386,Cole Aldrich,1610612750,MIN,62,531,45,86,0.523,0,0,0.0,15,22,0.682,51,107,158,25,25,23,17,85,105,271,1.47,1.47,2016,17,1.6935483870967742,1.4705882352941178,41,7,48,3.2916666666666665
2016-17,RegularSeason,1627761,387,DeAndre' Bembry,1610612737,ATL,38,371,47,98,0.48,1,18,0.056,6,16,0.375,14,45,59,28,8,5,16,21,101,124,1.75,0.5,2016,17,2.6578947368421053,1.75,51,10,61,0.9672131147540983
2016-17,RegularSeason,203094,388,Andrew Nicholson,1610612751,BKN,38,342,43,111,0.387,5,27,0.185,9,14,0.643,15,46,61,10,16,6,17,55,100,103,0.59,0.94,2016,17,2.6315789473684212,0.5882352941176471,68,5,73,0.8356164383561644
2016-17,RegularSeason,203526,388,Raul Neto,1610612762,UTA,40,346,41,91,0.451,10,31,0.323,8,9,0.889,4,26,30,34,21,5,15,48,100,124,2.27,1.4,2016,17,2.5,2.2666666666666666,50,1,51,0.5882352941176471
2016-17,RegularSeason,1626254,390,Maurice Ndour,1610612752,NYK,32,331,39,86,0.453,1,7,0.143,19,26,0.731,22,42,64,8,15,8,12,30,98,127,0.67,1.25,2016,17,3.0625,0.6666666666666666,47,7,54,1.1851851851851851
2016-17,RegularSeason,1627855,390,Okaro White,1610612748,MIA,35,471,33,87,0.379,12,34,0.353,20,22,0.909,25,57,82,21,10,10,18,52,98,147,1.17,0.56,2016,17,2.8,1.1666666666666667,54,2,56,1.4642857142857142
2016-17,RegularSeason,1626192,390,Pat Connaughton,1610612757,POR,39,316,37,72,0.514,17,33,0.515,7,9,0.778,10,42,52,28,6,2,17,23,98,132,1.65,0.35,2016,17,2.5128205128205128,1.6470588235294117,35,2,37,1.4054054054054055
2016-17,RegularSeason,1627854,393,Bryn Forbes,1610612759,SAS,36,285,36,99,0.364,17,53,0.321,5,6,0.833,2,21,23,23,1,0,11,20,94,66,2.09,0.09,2016,17,2.611111111111111,2.090909090909091,63,1,64,0.359375
2016-17,RegularSeason,1627815,394,Sheldon Mac,1610612764,WAS,30,287,30,75,0.4,7,30,0.233,23,27,0.852,4,30,34,15,8,2,5,17,90,95,3.0,1.6,2016,17,3.0,3.0,45,4,49,0.6938775510204082
2016-17,RegularSeason,202713,395,Kyle Singler,1610612760,OKC,32,385,34,83,0.41,7,37,0.189,13,17,0.765,8,40,48,9,7,5,11,29,88,93,0.82,0.64,2016,17,2.75,0.8181818181818182,49,4,53,0.9056603773584906
2016-17,RegularSeason,1627767,396,Cheick Diallo,1610612740,NOP,17,199,36,76,0.474,0,0,0.0,15,21,0.714,23,50,73,4,4,7,7,17,87,122,0.57,0.57,2016,17,5.117647058823529,0.5714285714285714,40,6,46,1.5869565217391304
2016-17,RegularSeason,101187,397,Alan Anderson,1610612746,LAC,30,308,30,80,0.375,14,44,0.318,12,16,0.75,3,21,24,11,3,0,7,35,86,63,1.57,0.43,2016,17,2.8666666666666667,1.5714285714285714,50,4,54,0.4444444444444444
2016-17,RegularSeason,201600,398,Ömer Aşik,1610612740,NOP,31,482,31,65,0.477,0,0,0.0,23,39,0.59,48,115,163,15,5,10,14,51,85,214,1.07,0.36,2016,17,2.7419354838709675,1.0714285714285714,34,16,50,3.26
2016-17,RegularSeason,1627736,399,Malik Beasley,1610612743,DEN,22,165,33,73,0.452,9,28,0.321,8,10,0.8,5,12,17,11,7,0,8,10,83,68,1.38,0.88,2016,17,3.772727272727273,1.375,40,2,42,0.40476190476190477
2016-17,RegularSeason,204014,400,Damjan Rudez,1610612753,ORL,45,314,31,88,0.352,20,64,0.313,0,0,0.0,5,20,25,20,12,1,9,31,82,74,2.22,1.33,2016,17,1.8222222222222222,2.2222222222222223,57,0,57,0.43859649122807015
2016-17,RegularSeason,1718,401,Paul Pierce,1610612746,LAC,25,277,28,70,0.4,15,43,0.349,10,13,0.769,1,47,48,10,4,5,16,40,81,87,0.63,0.25,2016,17,3.24,0.625,42,3,45,1.0666666666666667
2016-17,RegularSeason,101106,402,Andrew Bogut,1610612739,CLE,27,583,38,81,0.469,0,1,0.0,3,11,0.273,56,162,218,49,13,25,43,86,79,290,1.14,0.3,2016,17,2.925925925925926,1.1395348837209303,43,8,51,4.2745098039215685
2016-17,RegularSeason,1627781,402,Malachi Richardson,1610612758,SAC,22,198,28,68,0.412,8,28,0.286,15,19,0.789,3,20,23,11,5,1,8,23,79,67,1.38,0.63,2016,17,3.590909090909091,1.375,40,4,44,0.5227272727272727
2016-17,RegularSeason,1626188,402,Quinn Cook,1610612740,NOP,14,187,33,66,0.5,11,26,0.423,2,5,0.4,1,6,7,26,4,0,13,13,79,67,2.0,0.31,2016,17,5.642857142857143,2.0,33,3,36,0.19444444444444445
2016-17,RegularSeason,1627774,405,Jake Layman,1610612757,POR,35,249,26,89,0.292,13,51,0.255,13,17,0.765,6,18,24,11,9,3,11,22,78,47,1.0,0.82,2016,17,2.2285714285714286,1.0,63,4,67,0.3582089552238806
2016-17,RegularSeason,1627782,406,Wayne Selden,1610612763,MEM,14,236,25,58,0.431,7,28,0.25,14,22,0.636,1,15,16,13,6,1,12,18,71,54,1.08,0.5,2016,17,5.071428571428571,1.0833333333333333,33,8,41,0.3902439024390244
2016-17,RegularSeason,203923,407,James Young,1610612738,BOS,29,220,25,58,0.431,12,35,0.343,6,9,0.667,6,20,26,4,10,2,4,15,68,70,1.0,2.5,2016,17,2.3448275862068964,1.0,33,3,36,0.7222222222222222
2016-17,RegularSeason,1626202,407,Joe Young,1610612754,IND,33,135,26,72,0.361,5,23,0.217,11,15,0.733,1,16,17,15,4,0,5,5,68,49,3.0,0.8,2016,17,2.0606060606060606,3.0,46,4,50,0.34
2016-17,RegularSeason,1627816,409,Alex Poythress,1610612755,PHI,6,157,25,54,0.463,6,19,0.316,8,10,0.8,11,18,29,5,3,2,3,14,64,69,1.67,1.0,2016,17,10.666666666666666,1.6666666666666667,29,2,31,0.9354838709677419
2016-17,RegularSeason,203940,410,Adreian Payne,1610612750,MIN,18,135,23,54,0.426,3,15,0.2,14,19,0.737,9,24,33,7,8,7,8,32,63,74,0.88,1.0,2016,17,3.5,0.875,31,5,36,0.9166666666666666
2016-17,RegularSeason,1626273,410,Marcelo Huertas,1610612747,LAL,23,237,25,68,0.368,4,19,0.211,9,17,0.529,2,22,24,52,10,2,19,16,63,81,2.74,0.53,2016,17,2.739130434782609,2.736842105263158,43,8,51,0.47058823529411764
2016-17,RegularSeason,201628,412,Bobby Brown,1610612745,HOU,25,123,23,60,0.383,14,35,0.4,2,2,1.0,0,6,6,14,1,0,5,5,62,41,2.8,0.2,2016,17,2.48,2.8,37,0,37,0.16216216216216217
2016-17,RegularSeason,1627362,412,Briante Weber,1610612766,CHA,20,205,25,60,0.417,1,10,0.1,11,16,0.688,8,18,26,21,12,1,8,16,62,74,2.63,1.5,2016,17,3.1,2.625,35,5,40,0.65
2016-17,RegularSeason,1627740,414,Henry Ellenson,1610612765,DET,19,146,23,64,0.359,10,35,0.286,4,8,0.5,8,33,41,7,1,1,14,6,60,51,0.5,0.07,2016,17,3.1578947368421053,0.5,41,4,45,0.9111111111111111
2016-17,RegularSeason,1627879,415,Nicolas Laprovittola,1610612759,SAS,18,174,20,47,0.426,10,27,0.37,9,9,1.0,1,9,10,28,4,1,19,19,59,56,1.47,0.21,2016,17,3.2777777777777777,1.4736842105263157,27,0,27,0.37037037037037035
2016-17,RegularSeason,1626176,415,Rakeem Christmas,1610612754,IND,29,219,19,43,0.442,0,0,0.0,21,29,0.724,26,30,56,4,3,6,8,37,59,88,0.5,0.38,2016,17,2.0344827586206895,0.5,24,8,32,1.75
2016-17,RegularSeason,1627738,417,Deyonta Davis,1610612763,MEM,36,238,24,47,0.511,0,0,0.0,10,18,0.556,20,40,60,2,3,17,8,40,58,101,0.25,0.38,2016,17,1.6111111111111112,0.25,23,8,31,1.935483870967742
2016-17,RegularSeason,1897,418,Metta World Peace,1610612747,LAL,25,160,19,68,0.279,9,38,0.237,10,16,0.625,5,15,20,11,10,2,7,18,57,38,1.57,1.43,2016,17,2.28,1.5714285714285714,49,6,55,0.36363636363636365
2016-17,RegularSeason,1626203,418,Treveon Graham,1610612766,CHA,27,189,19,40,0.475,9,15,0.6,10,15,0.667,5,17,22,6,6,1,3,18,57,63,2.0,2.0,2016,17,2.111111111111111,2.0,21,5,26,0.8461538461538461
2016-17,RegularSeason,1627773,420,AJ Hammons,1610612742,DAL,22,163,17,42,0.405,5,10,0.5,9,20,0.45,8,28,36,4,1,13,10,21,48,56,0.4,0.1,2016,17,2.1818181818181817,0.4,25,11,36,1.0
2016-17,RegularSeason,203118,421,Mike Scott,1610612737,ATL,18,195,17,59,0.288,4,27,0.148,7,8,0.875,10,27,37,17,4,3,8,12,45,55,2.13,0.5,2016,17,2.5,2.125,42,1,43,0.8604651162790697
2016-17,RegularSeason,1626148,422,Anthony Brown,1610612753,ORL,11,159,18,50,0.36,7,27,0.259,0,0,0.0,8,25,33,8,5,1,6,15,43,52,1.33,0.83,2016,17,3.909090909090909,1.3333333333333333,32,0,32,1.03125
2016-17,RegularSeason,202708,422,Norris Cole,1610612760,OKC,13,125,16,52,0.308,3,13,0.231,8,10,0.8,0,11,11,14,8,0,7,18,43,31,2.0,1.14,2016,17,3.3076923076923075,2.0,36,2,38,0.2894736842105263
2016-17,RegularSeason,1627784,424,Jarrod Uthoff,1610612742,DAL,9,115,16,38,0.421,3,9,0.333,5,7,0.714,8,14,22,9,2,4,3,8,40,50,3.0,0.67,2016,17,4.444444444444445,3.0,22,2,24,0.9166666666666666
2016-17,RegularSeason,1627850,424,Marshall Plumlee,1610612752,NYK,21,170,16,30,0.533,0,0,0.0,8,19,0.421,23,28,51,10,4,4,12,23,40,72,0.83,0.33,2016,17,1.9047619047619047,0.8333333333333334,14,11,25,2.04
2016-17,RegularSeason,201168,426,Tiago Splitter,1610612755,PHI,8,76,14,31,0.452,2,6,0.333,9,11,0.818,8,14,22,4,1,1,6,8,39,42,0.67,0.17,2016,17,4.875,0.6666666666666666,17,2,19,1.1578947368421053
2016-17,RegularSeason,203948,427,Johnny O'Bryant III,1610612766,CHA,11,81,15,30,0.5,3,6,0.5,5,6,0.833,9,10,19,6,0,1,6,10,38,42,1.0,0.0,2016,17,3.4545454545454546,1.0,15,1,16,1.1875
2016-17,RegularSeason,1626175,427,Jordan Mickey,1610612738,BOS,25,141,15,34,0.441,0,1,0.0,8,14,0.571,13,21,34,7,3,6,9,12,38,54,0.78,0.33,2016,17,1.52,0.7777777777777778,19,6,25,1.36
2016-17,RegularSeason,203096,429,Jared Sullinger,1610612761,TOR,11,118,15,47,0.319,3,18,0.167,4,8,0.5,10,17,27,3,4,1,4,17,37,32,0.75,1.0,2016,17,3.3636363636363638,0.75,32,4,36,0.75
2016-17,RegularSeason,1626191,430,Chris McCullough,1610612764,WAS,16,80,16,32,0.5,1,7,0.143,3,5,0.6,9,10,19,2,2,2,3,7,36,40,0.67,0.67,2016,17,2.25,0.6666666666666666,16,2,18,1.0555555555555556
2016-17,RegularSeason,1626174,431,Christian Wood,1610612766,CHA,13,107,12,23,0.522,0,5,0.0,11,15,0.733,14,15,29,2,3,6,7,11,35,53,0.29,0.43,2016,17,2.6923076923076925,0.2857142857142857,11,4,15,1.9333333333333333
2016-17,RegularSeason,203510,431,Pierre Jackson,1610612742,DAL,9,84,13,39,0.333,3,11,0.273,6,7,0.857,1,8,9,19,2,0,3,5,35,35,6.33,0.67,2016,17,3.888888888888889,6.333333333333333,26,1,27,0.3333333333333333
2016-17,RegularSeason,201573,433,Jerryd Bayless,1610612755,PHI,3,71,11,32,0.344,2,5,0.4,9,10,0.9,3,9,12,13,0,0,9,4,33,27,1.44,0.0,2016,17,11.0,1.4444444444444444,21,1,22,0.5454545454545454
2016-17,RegularSeason,2555,433,Nick Collison,1610612760,OKC,20,128,14,23,0.609,0,1,0.0,5,8,0.625,9,22,31,12,2,2,4,17,33,64,3.0,0.5,2016,17,1.65,3.0,9,3,12,2.5833333333333335
2016-17,RegularSeason,1627817,435,Tim Quarterman,1610612757,POR,16,80,13,29,0.448,5,13,0.385,0,3,0.0,4,10,14,11,2,3,11,6,31,31,1.0,0.18,2016,17,1.9375,1.0,16,3,19,0.7368421052631579
2016-17,RegularSeason,2617,435,Udonis Haslem,1610612748,MIA,16,130,11,23,0.478,0,3,0.0,9,15,0.6,8,28,36,6,6,1,8,22,31,54,0.75,0.75,2016,17,1.9375,0.75,12,6,18,2.0
2016-17,RegularSeason,2365,437,Chris Andersen,1610612739,CLE,12,114,9,22,0.409,0,3,0.0,10,14,0.714,9,22,31,5,5,7,5,20,28,54,1.0,1.0,2016,17,2.3333333333333335,1.0,13,4,17,1.8235294117647058
2016-17,RegularSeason,2034,437,Mike Miller,1610612743,DEN,20,151,9,23,0.391,8,20,0.4,2,2,1.0,2,36,38,22,2,0,13,9,28,63,1.69,0.15,2016,17,1.4,1.6923076923076923,14,0,14,2.7142857142857144
2016-17,RegularSeason,202130,439,Reggie Williams,1610612740,NOP,6,79,8,23,0.348,5,11,0.455,6,7,0.857,2,4,6,4,3,0,0,2,27,24,0.0,0.0,2016,17,4.5,inf,15,1,16,0.375
2016-17,RegularSeason,201202,440,Joel Anthony,1610612759,SAS,19,122,10,16,0.625,0,0,0.0,5,8,0.625,8,23,31,3,2,6,4,11,25,54,0.75,0.5,2016,17,1.3157894736842106,0.75,6,3,9,3.4444444444444446
2016-17,RegularSeason,203527,440,Ryan Kelly,1610612737,ATL,16,110,8,28,0.286,4,10,0.4,5,6,0.833,1,17,18,8,4,5,4,5,25,35,2.0,1.0,2016,17,1.5625,2.0,20,1,21,0.8571428571428571
2016-17,RegularSeason,1627849,442,Daniel Ochefu,1610612764,WAS,19,75,12,27,0.444,0,0,0.0,0,2,0.0,5,17,22,3,2,0,3,17,24,31,1.0,0.67,2016,17,1.263157894736842,1.0,15,2,17,1.2941176470588236
2016-17,RegularSeason,204067,442,Jarell Eddie,1610612756,PHX,5,62,6,19,0.316,4,16,0.25,8,9,0.889,1,6,7,0,1,0,1,1,24,17,0.0,1.0,2016,17,4.8,0.0,13,1,14,0.5
2016-17,RegularSeason,1627757,444,Stephen Zimmerman,1610612753,ORL,19,108,10,31,0.323,0,0,0.0,3,5,0.6,11,24,35,4,2,5,3,17,23,43,1.33,0.67,2016,17,1.2105263157894737,1.3333333333333333,21,2,23,1.5217391304347827
2016-17,RegularSeason,1627762,445,Joel Bolomboy,1610612762,UTA,12,53,9,16,0.563,1,4,0.25,3,6,0.5,4,13,17,2,1,2,2,1,22,32,1.0,0.5,2016,17,1.8333333333333333,1.0,7,3,10,1.7
2016-17,RegularSeason,203912,446,C.J. Wilcox,1610612753,ORL,22,108,8,31,0.258,3,15,0.2,2,2,1.0,4,8,12,12,2,1,6,8,21,19,2.0,0.33,2016,17,0.9545454545454546,2.0,23,0,23,0.5217391304347826
2016-17,RegularSeason,1627777,446,Georges Niang,1610612754,IND,23,93,9,36,0.25,1,12,0.083,2,2,1.0,2,15,17,5,3,0,5,6,21,14,1.0,0.6,2016,17,0.9130434782608695,1.0,27,0,27,0.6296296296296297
2016-17,RegularSeason,1627780,448,Gary Payton II,1610612749,MIL,6,99,8,22,0.364,1,9,0.111,3,5,0.6,0,12,12,13,3,4,10,9,20,26,1.3,0.3,2016,17,3.3333333333333335,1.3,14,2,16,0.75
2016-17,RegularSeason,1627745,449,Damian Jones,1610612744,GSW,10,85,8,16,0.5,0,0,0.0,3,10,0.3,9,14,23,0,1,4,6,15,19,26,0.0,0.17,2016,17,1.9,0.0,8,7,15,1.5333333333333334
2016-17,RegularSeason,2760,450,Anderson Varejao,1610612744,GSW,14,92,5,14,0.357,0,0,0.0,8,11,0.727,12,15,27,10,3,3,8,16,18,41,1.25,0.38,2016,17,1.2857142857142858,1.25,9,3,12,2.25
2016-17,RegularSeason,203998,451,Bruno Caboclo,1610612761,TOR,9,40,6,16,0.375,2,6,0.333,0,0,0.0,5,5,10,4,2,1,2,4,14,19,2.0,1.0,2016,17,1.5555555555555556,2.0,10,0,10,1.0
2016-17,RegularSeason,1627778,451,Chinanu Onuaku,1610612745,HOU,5,52,5,7,0.714,0,0,0.0,4,4,1.0,2,8,10,3,3,1,4,6,14,25,0.75,0.75,2016,17,2.8,0.75,2,0,2,5.0
2016-17,RegularSeason,203962,451,Josh Huestis,1610612760,OKC,2,31,6,11,0.545,2,4,0.5,0,1,0.0,4,5,9,3,0,3,0,0,14,23,0.0,0.0,2016,17,7.0,inf,5,1,6,1.5
2016-17,RegularSeason,1627875,451,Marcus Georges-Hunt,1610612753,ORL,5,48,2,7,0.286,1,2,0.5,9,10,0.9,1,8,9,3,1,0,2,5,14,19,1.5,0.5,2016,17,2.8,1.5,5,1,6,1.5
2016-17,RegularSeason,101179,451,Ronnie Price,1610612756,PHX,14,134,4,24,0.167,3,17,0.176,3,4,0.75,3,8,11,18,11,1,3,14,14,31,6.0,3.67,2016,17,1.0,6.0,20,1,21,0.5238095238095238
2016-17,RegularSeason,1627787,456,Kyle Wiltjer,1610612745,HOU,14,44,4,14,0.286,4,13,0.308,1,2,0.5,4,6,10,2,3,1,5,4,13,13,0.4,0.6,2016,17,0.9285714285714286,0.4,10,1,11,0.9090909090909091
2016-17,RegularSeason,200770,457,Jordan Farmar,1610612758,SAC,2,35,4,12,0.333,4,9,0.444,0,0,0.0,1,2,3,9,2,0,3,1,12,15,3.0,0.67,2016,17,6.0,3.0,8,0,8,0.375
2016-17,RegularSeason,201941,457,Jordan Hill,1610612750,MIN,7,47,5,13,0.385,0,0,0.0,2,2,1.0,8,6,14,0,1,0,4,9,12,15,0.0,0.25,2016,17,1.7142857142857142,0.0,8,0,8,1.75
2016-17,RegularSeason,202712,457,Justin Harper,1610612755,PHI,3,31,5,12,0.417,2,7,0.286,0,0,0.0,2,3,5,2,0,0,4,2,12,8,0.5,0.0,2016,17,4.0,0.5,7,0,7,0.7142857142857143
2016-17,RegularSeason,202087,460,Alonzo Gee,1610612743,DEN,13,89,3,14,0.214,0,3,0.0,5,9,0.556,4,11,15,6,5,1,4,14,11,19,1.5,1.25,2016,17,0.8461538461538461,1.5,11,4,15,1.0
2016-17,RegularSeason,1626253,460,Axel Toupane,1610612740,NOP,4,47,5,9,0.556,1,4,0.25,0,0,0.0,0,1,1,0,1,1,0,6,11,10,0.0,0.0,2016,17,2.75,,4,0,4,0.25
2016-17,RegularSeason,1627743,462,Demetrius Jackson,1610612738,BOS,5,17,3,4,0.75,1,1,1.0,3,6,0.5,2,2,4,3,0,0,0,0,10,13,0.0,0.0,2016,17,2.0,inf,1,3,4,1.0
2016-17,RegularSeason,1627754,462,Diamond Stone,1610612746,LAC,7,24,3,13,0.231,0,0,0.0,4,4,1.0,1,5,6,0,0,1,2,5,10,5,0.0,0.0,2016,17,1.4285714285714286,0.0,10,0,10,0.6
2016-17,RegularSeason,2563,464,Dahntay Jones,1610612739,CLE,1,12,3,8,0.375,0,2,0.0,3,4,0.75,1,1,2,1,0,0,1,1,9,5,1.0,0.0,2016,17,9.0,1.0,5,1,6,0.3333333333333333
2016-17,RegularSeason,203934,464,Lamar Patterson,1610612737,ATL,5,40,3,15,0.2,1,6,0.167,2,3,0.667,1,6,7,6,1,0,4,6,9,6,1.5,0.25,2016,17,1.8,1.5,12,1,13,0.5384615384615384
2016-17,RegularSeason,204002,466,Edy Tavares,1610612739,CLE,2,28,4,5,0.8,0,0,0.0,0,3,0.0,4,7,11,1,0,6,2,3,8,20,0.5,0.0,2016,17,4.0,0.5,1,3,4,2.75
2016-17,RegularSeason,202412,466,Manny Harris,1610612742,DAL,4,25,3,15,0.2,0,2,0.0,2,4,0.5,3,6,9,2,0,0,2,1,8,3,1.0,0.0,2016,17,2.0,1.0,12,2,14,0.6428571428571429
2016-17,RegularSeason,202349,468,Greivis Vasquez,1610612751,BKN,3,39,2,8,0.25,1,3,0.333,2,3,0.667,0,2,2,5,1,1,1,6,7,8,5.0,1.0,2016,17,2.3333333333333335,5.0,6,1,7,0.2857142857142857
2016-17,RegularSeason,203098,468,John Jenkins,1610612756,PHX,4,13,2,5,0.4,1,2,0.5,2,2,1.0,0,1,1,1,0,0,0,0,7,6,0.0,0.0,2016,17,1.75,inf,3,0,3,0.3333333333333333
2016-17,RegularSeason,101127,470,Jarrett Jack,1610612740,NOP,2,33,2,3,0.667,0,1,0.0,2,2,1.0,0,0,0,5,2,0,3,4,6,9,1.67,0.67,2016,17,3.0,1.6666666666666667,1,0,1,0.0
2016-17,RegularSeason,200779,471,Steve Novak,1610612749,MIL,8,22,2,7,0.286,1,6,0.167,0,0,0.0,0,3,3,0,0,0,0,1,5,3,0.0,0.0,2016,17,0.625,,5,0,5,0.6
2016-17,RegularSeason,202620,472,Arinze Onuaku,1610612753,ORL,8,28,2,4,0.5,0,0,0.0,0,0,0.0,2,4,6,2,0,1,2,3,4,9,1.0,0.0,2016,17,0.5,1.0,2,0,2,3.0
2016-17,RegularSeason,1627744,472,Brice Johnson,1610612746,LAC,3,9,2,7,0.286,0,0,0.0,0,0,0.0,1,2,3,1,2,1,1,0,4,5,1.0,2.0,2016,17,1.3333333333333333,1.0,5,0,5,0.6
2016-17,RegularSeason,202390,472,Gary Neal,1610612737,ATL,2,18,0,7,0.0,0,2,0.0,4,4,1.0,0,1,1,1,0,0,0,1,4,-1,0.0,0.0,2016,17,2.0,inf,7,0,7,0.14285714285714285
2016-17,RegularSeason,202336,472,Larry Sanders,1610612739,CLE,5,13,1,4,0.25,0,0,0.0,2,2,1.0,3,1,4,0,1,1,2,5,4,5,0.0,0.5,2016,17,0.8,0.0,3,0,3,1.3333333333333333
2016-17,RegularSeason,1627771,472,Michael Gbinije,1610612765,DET,9,32,1,10,0.1,0,4,0.0,2,2,1.0,2,1,3,2,0,0,0,2,4,0,0.0,0.0,2016,17,0.4444444444444444,inf,9,0,9,0.3333333333333333
2016-17,RegularSeason,202407,477,Elijah Millsap,1610612756,PHX,2,23,1,7,0.143,0,2,0.0,1,2,0.5,3,3,6,1,0,0,2,2,3,1,0.5,0.0,2016,17,1.5,0.5,6,1,7,0.8571428571428571
2016-17,RegularSeason,1627819,477,Isaiah Taylor,1610612745,HOU,4,52,1,7,0.143,0,2,0.0,1,2,0.5,1,2,3,3,1,1,0,6,3,4,0.0,0.0,2016,17,0.75,inf,6,1,7,0.42857142857142855
2016-17,RegularSeason,203950,477,Jarnell Stokes,1610612743,DEN,2,7,1,1,1.0,0,0,0.0,1,2,0.5,1,1,2,2,1,0,0,3,3,7,0.0,0.0,2016,17,1.5,inf,0,1,1,2.0
2016-17,RegularSeason,101249,480,John Lucas III,1610612750,MIN,5,11,1,4,0.25,0,1,0.0,0,0,0.0,0,0,0,1,2,0,0,0,2,2,0.0,0.0,2016,17,0.4,inf,3,0,3,0.0
2016-17,RegularSeason,1627861,480,Mike Tobey,1610612766,CHA,2,25,1,4,0.25,0,0,0.0,0,0,0.0,2,1,3,1,0,0,1,2,2,2,1.0,0.0,2016,17,1.0,1.0,3,0,3,1.0
2016-17,RegularSeason,1626151,482,Aaron Harrison,1610612766,CHA,5,17,0,4,0.0,0,2,0.0,1,2,0.5,0,3,3,3,0,0,0,2,1,2,0.0,0.0,2016,17,0.2,inf,4,1,5,0.6
2016-17,RegularSeason,1627791,483,Ben Bentil,1610612742,DAL,3,10,0,3,0.0,0,1,0.0,0,0,0.0,0,2,2,0,0,0,1,1,0,-2,0.0,0.0,2016,17,0.0,0.0,3,0,3,0.6666666666666666
2016-17,RegularSeason,1627863,483,Danuel House Jr.,1610612764,WAS,1,1,0,0,0.0,0,0,0.0,0,0,0.0,0,1,1,0,0,0,0,0,0,1,0.0,0.0,2016,17,0.0,,0,0,0,inf
2016-17,RegularSeason,1627868,483,Patricio Garino,1610612753,ORL,5,43,0,7,0.0,0,5,0.0,0,0,0.0,1,6,7,0,0,0,3,4,0,-3,0.0,0.0,2016,17,0.0,0.0,7,0,7,1.0
2016-17,RegularSeason,1626154,483,RJ Hunter,1610612741,CHI,3,9,0,1,0.0,0,1,0.0,0,0,0.0,0,1,1,0,0,0,0,0,0,0,0.0,0.0,2016,17,0.0,,1,0,1,1.0
2016-17,Playoffs,2544,1,LeBron James,1610612739,CLE,18,744,217,384,0.565,44,107,0.411,113,162,0.698,19,145,164,141,35,23,72,43,591,666,1.96,0.49,2016,17,32.833333333333336,1.9583333333333333,167,49,216,0.7592592592592593
2016-17,Playoffs,201939,2,Stephen Curry,1610612744,GSW,17,601,151,312,0.484,72,172,0.419,103,114,0.904,22,84,106,114,34,4,58,37,477,505,1.97,0.59,2016,17,28.058823529411764,1.9655172413793103,161,11,172,0.6162790697674418
2016-17,Playoffs,202681,3,Kyrie Irving,1610612739,CLE,18,653,173,370,0.468,44,118,0.373,76,84,0.905,13,38,51,95,23,8,48,38,466,390,1.98,0.48,2016,17,25.88888888888889,1.9791666666666667,197,8,205,0.24878048780487805
2016-17,Playoffs,201142,4,Kevin Durant,1610612744,GSW,15,533,149,268,0.556,38,86,0.442,92,103,0.893,16,103,119,64,12,20,38,39,428,475,1.68,0.32,2016,17,28.533333333333335,1.6842105263157894,119,11,130,0.9153846153846154
2016-17,Playoffs,202322,5,John Wall,1610612764,WAS,13,507,127,281,0.452,21,61,0.344,78,93,0.839,7,41,48,134,22,15,55,26,353,348,2.44,0.4,2016,17,27.153846153846153,2.4363636363636365,154,15,169,0.28402366863905326
2016-17,Playoffs,202738,6,Isaiah Thomas,1610612738,BOS,15,521,111,261,0.425,36,108,0.333,91,111,0.82,5,42,47,100,13,2,50,35,349,291,2.0,0.26,2016,17,23.266666666666666,2.0,150,20,170,0.27647058823529413
2016-17,Playoffs,202695,7,Kawhi Leonard,1610612759,SAS,12,429,106,202,0.525,25,55,0.455,95,102,0.931,19,74,93,55,20,6,26,21,332,377,2.12,0.77,2016,17,27.666666666666668,2.1153846153846154,96,7,103,0.9029126213592233
2016-17,Playoffs,203078,8,Bradley Beal,1610612764,WAS,13,505,122,259,0.471,29,101,0.287,50,61,0.82,15,29,44,35,21,8,27,38,323,256,1.3,0.78,2016,17,24.846153846153847,1.2962962962962963,137,11,148,0.2972972972972973
2016-17,Playoffs,201935,9,James Harden,1610612745,HOU,11,407,90,218,0.413,32,115,0.278,101,115,0.878,7,53,60,93,21,5,59,43,313,291,1.58,0.36,2016,17,28.454545454545453,1.576271186440678,128,14,142,0.4225352112676056
2016-17,Playoffs,201567,10,Kevin Love,1610612739,CLE,18,578,95,218,0.436,50,111,0.45,63,75,0.84,36,155,191,30,21,16,31,46,303,395,0.97,0.68,2016,17,16.833333333333332,0.967741935483871,123,12,135,1.4148148148148147
2016-17,Playoffs,202340,11,Avery Bradley,1610612738,BOS,18,645,120,272,0.441,40,114,0.351,21,27,0.778,18,53,71,41,23,3,31,40,301,250,1.32,0.74,2016,17,16.72222222222222,1.3225806451612903,152,6,158,0.44936708860759494
2016-17,Playoffs,201143,12,Al Horford,1610612738,BOS,18,610,111,190,0.584,27,52,0.519,22,29,0.759,31,87,118,97,15,14,33,33,271,396,2.94,0.46,2016,17,15.055555555555555,2.9393939393939394,79,7,86,1.372093023255814
2016-17,Playoffs,202330,13,Gordon Hayward,1610612762,UTA,11,411,83,188,0.441,28,68,0.412,71,76,0.934,7,60,67,37,10,3,24,23,265,248,1.54,0.42,2016,17,24.09090909090909,1.5416666666666667,105,5,110,0.6090909090909091
2016-17,Playoffs,200746,14,LaMarcus Aldridge,1610612759,SAS,16,537,110,240,0.458,2,14,0.143,42,55,0.764,43,76,119,24,10,16,28,41,264,262,0.86,0.36,2016,17,16.5,0.8571428571428571,130,13,143,0.8321678321678322
2016-17,Playoffs,202691,15,Klay Thompson,1610612744,GSW,17,596,94,237,0.397,41,106,0.387,26,33,0.788,11,55,66,35,14,5,24,44,255,201,1.46,0.58,2016,17,15.0,1.4583333333333333,143,7,150,0.44
2016-17,Playoffs,203109,16,Jae Crowder,1610612738,BOS,18,596,87,200,0.435,31,88,0.352,40,48,0.833,20,95,115,48,19,6,12,52,245,300,4.0,1.58,2016,17,13.61111111111111,4.0,113,8,121,0.9504132231404959
2016-17,Playoffs,201942,17,DeMar DeRozan,1610612761,TOR,10,373,76,175,0.434,1,15,0.067,71,80,0.888,4,45,49,34,14,0,25,26,224,188,1.36,0.56,2016,17,22.4,1.36,99,9,108,0.4537037037037037
2016-17,Playoffs,203110,18,Draymond Green,1610612744,GSW,17,593,72,161,0.447,32,78,0.41,46,67,0.687,20,135,155,110,31,28,36,60,222,400,3.06,0.86,2016,17,13.058823529411764,3.0555555555555554,89,21,110,1.4090909090909092
2016-17,Playoffs,201566,19,Russell Westbrook,1610612760,OKC,5,194,59,152,0.388,13,49,0.265,56,70,0.8,9,49,58,54,12,2,30,16,187,176,1.8,0.4,2016,17,37.4,1.8,93,14,107,0.5420560747663551
2016-17,Playoffs,101108,20,Chris Paul,1610612746,LAC,7,260,67,135,0.496,14,38,0.368,29,33,0.879,4,31,35,69,12,1,19,24,177,203,3.63,0.63,2016,17,25.285714285714285,3.6315789473684212,68,4,72,0.4861111111111111
2016-17,Playoffs,203482,21,Kelly Olynyk,1610612738,BOS,18,346,64,125,0.512,15,47,0.319,22,30,0.733,14,43,57,34,13,14,22,47,165,192,1.54,0.59,2016,17,9.166666666666666,1.5454545454545454,61,8,69,0.8260869565217391
2016-17,Playoffs,201988,21,Patty Mills,1610612759,SAS,16,416,57,140,0.407,32,89,0.36,19,22,0.864,5,29,34,43,13,1,21,33,165,149,2.05,0.62,2016,17,10.3125,2.0476190476190474,83,3,86,0.3953488372093023
2016-17,Playoffs,203613,23,Jonathon Simmons,1610612759,SAS,15,306,62,136,0.456,13,37,0.351,21,31,0.677,9,19,28,29,9,2,11,30,158,131,2.64,0.82,2016,17,10.533333333333333,2.6363636363636362,74,10,84,0.3333333333333333
2016-17,Playoffs,203490,23,Otto Porter Jr.,1610612764,WAS,13,428,58,109,0.532,11,39,0.282,31,35,0.886,15,75,90,23,21,7,10,26,158,234,2.3,2.1,2016,17,12.153846153846153,2.3,51,4,55,1.6363636363636365
2016-17,Playoffs,202693,25,Markieff Morris,1610612764,WAS,13,373,59,145,0.407,14,38,0.368,25,31,0.806,18,65,83,22,12,17,21,46,157,178,1.05,0.57,2016,17,12.076923076923077,1.0476190476190477,86,6,92,0.9021739130434783
2016-17,Playoffs,203935,26,Marcus Smart,1610612738,BOS,18,538,47,134,0.351,29,73,0.397,32,50,0.64,23,62,85,85,27,16,38,51,155,225,2.24,0.71,2016,17,8.61111111111111,2.236842105263158,87,18,105,0.8095238095238095
2016-17,Playoffs,203507,27,Giannis Antetokounmpo,1610612749,MIL,6,243,60,112,0.536,4,10,0.4,25,46,0.543,10,47,57,24,13,10,20,21,149,160,1.2,0.65,2016,17,24.833333333333332,1.2,52,21,73,0.7808219178082192
2016-17,Playoffs,203471,28,Dennis Schroder,1610612737,ATL,6,211,50,110,0.455,17,40,0.425,31,37,0.838,4,10,14,46,6,0,10,19,148,138,4.6,0.6,2016,17,24.666666666666668,4.6,60,6,66,0.21212121212121213
2016-17,Playoffs,201144,28,Mike Conley,1610612763,MEM,6,224,50,103,0.485,17,38,0.447,31,37,0.838,1,19,20,42,10,3,12,11,148,152,3.5,0.83,2016,17,24.666666666666668,3.5,53,6,59,0.3389830508474576
2016-17,Playoffs,202684,28,Tristan Thompson,1610612739,CLE,18,562,54,92,0.587,0,0,0.0,40,60,0.667,69,81,150,26,9,13,21,36,148,267,1.24,0.43,2016,17,8.222222222222221,1.2380952380952381,38,20,58,2.586206896551724
2016-17,Playoffs,200794,31,Paul Millsap,1610612737,ATL,6,219,50,99,0.505,3,17,0.176,43,53,0.811,9,47,56,26,10,4,23,19,146,160,1.13,0.43,2016,17,24.333333333333332,1.1304347826086956,49,10,59,0.9491525423728814
2016-17,Playoffs,2747,32,JR Smith,1610612739,CLE,18,487,50,99,0.505,40,80,0.5,5,11,0.455,5,37,42,13,13,6,12,41,145,152,1.08,1.08,2016,17,8.055555555555555,1.0833333333333333,49,6,55,0.7636363636363637
2016-17,Playoffs,201586,33,Serge Ibaka,1610612761,TOR,10,307,60,130,0.462,12,38,0.316,11,13,0.846,9,56,65,14,4,17,11,37,143,160,1.27,0.36,2016,17,14.3,1.2727272727272727,70,2,72,0.9027777777777778
2016-17,Playoffs,201569,34,Eric Gordon,1610612745,HOU,11,358,51,121,0.421,27,70,0.386,13,18,0.722,5,38,43,22,8,6,14,20,142,132,1.57,0.57,2016,17,12.909090909090908,1.5714285714285714,70,5,75,0.5733333333333334
2016-17,Playoffs,2207,34,Joe Johnson,1610612762,UTA,11,326,58,133,0.436,15,45,0.333,11,15,0.733,8,35,43,27,6,1,13,21,142,127,2.08,0.46,2016,17,12.909090909090908,2.076923076923077,75,4,79,0.5443037974683544
2016-17,Playoffs,101150,36,Lou Williams,1610612745,HOU,11,272,50,118,0.424,12,39,0.308,26,29,0.897,7,23,30,14,7,1,14,17,138,105,1.0,0.5,2016,17,12.545454545454545,1.0,68,3,71,0.4225352112676056
2016-17,Playoffs,202710,37,Jimmy Butler,1610612741,CHI,6,239,46,108,0.426,6,23,0.261,38,47,0.809,9,35,44,26,10,5,15,10,136,135,1.73,0.67,2016,17,22.666666666666668,1.7333333333333334,62,9,71,0.6197183098591549
2016-17,Playoffs,2225,38,Tony Parker,1610612759,SAS,8,211,51,97,0.526,11,19,0.579,14,14,1.0,2,18,20,25,4,0,12,10,127,118,2.08,0.33,2016,17,15.875,2.0833333333333335,46,0,46,0.43478260869565216
2016-17,Playoffs,200768,39,Kyle Lowry,1610612761,TOR,8,300,43,93,0.462,13,38,0.342,27,33,0.818,3,22,25,47,12,4,17,26,126,141,2.77,0.71,2016,17,15.75,2.764705882352941,50,6,56,0.44642857142857145
2016-17,Playoffs,201588,40,George Hill,1610612762,UTA,8,281,46,98,0.469,12,31,0.387,21,29,0.724,8,25,33,29,2,1,13,25,125,117,2.23,0.15,2016,17,15.625,2.230769230769231,52,8,60,0.55
2016-17,Playoffs,201980,41,Danny Green,1610612759,SAS,16,436,45,111,0.405,26,76,0.342,8,14,0.571,13,44,57,23,10,15,17,30,124,140,1.35,0.59,2016,17,7.75,1.3529411764705883,66,6,72,0.7916666666666666
2016-17,Playoffs,2200,42,Pau Gasol,1610612759,SAS,16,365,50,114,0.439,6,18,0.333,17,24,0.708,39,75,114,31,7,15,18,35,123,201,1.72,0.39,2016,17,7.6875,1.7222222222222223,64,7,71,1.6056338028169015
2016-17,Playoffs,201976,43,Patrick Beverley,1610612745,HOU,11,325,45,109,0.413,21,52,0.404,11,14,0.786,21,40,61,33,16,2,18,38,122,149,1.83,0.89,2016,17,11.090909090909092,1.8333333333333333,64,3,67,0.9104477611940298
2016-17,Playoffs,2772,44,Trevor Ariza,1610612745,HOU,11,413,41,97,0.423,23,61,0.377,13,14,0.929,8,48,56,23,14,2,9,25,118,147,2.56,1.56,2016,17,10.727272727272727,2.5555555555555554,56,1,57,0.9824561403508771
2016-17,Playoffs,203991,45,Clint Capela,1610612745,HOU,11,286,46,82,0.561,0,1,0.0,24,39,0.615,26,70,96,12,8,28,8,28,116,201,1.5,1.0,2016,17,10.545454545454545,1.5,36,15,51,1.8823529411764706
2016-17,Playoffs,201188,45,Marc Gasol,1610612763,MEM,6,240,39,83,0.47,7,12,0.583,31,33,0.939,7,32,39,25,2,4,15,22,116,125,1.67,0.13,2016,17,19.333333333333332,1.6666666666666667,44,2,46,0.8478260869565217
2016-17,Playoffs,2738,47,Andre Iguodala,1610612744,GSW,16,419,46,101,0.455,8,42,0.19,15,26,0.577,9,56,65,51,14,7,16,29,115,170,3.19,0.88,2016,17,7.1875,3.1875,55,11,66,0.9848484848484849
2016-17,Playoffs,202711,47,Bojan Bogdanovic,1610612764,WAS,13,264,36,87,0.414,16,45,0.356,27,32,0.844,10,46,56,9,6,1,8,17,115,123,1.13,0.75,2016,17,8.846153846153847,1.125,51,5,56,1.0
2016-17,Playoffs,202685,49,Jonas Valanciunas,1610612761,TOR,10,226,44,81,0.543,0,1,0.0,24,33,0.727,9,58,67,2,2,6,13,22,112,130,0.15,0.15,2016,17,11.2,0.15384615384615385,37,9,46,1.4565217391304348
2016-17,Playoffs,202331,49,Paul George,1610612754,IND,4,172,34,88,0.386,18,42,0.429,26,30,0.867,5,30,35,29,7,2,13,13,112,114,2.23,0.54,2016,17,28.0,2.230769230769231,54,4,58,0.603448275862069
2016-17,Playoffs,203081,51,Damian Lillard,1610612757,POR,4,151,39,90,0.433,9,32,0.281,24,25,0.96,4,14,18,13,5,2,13,11,111,84,1.0,0.39,2016,17,27.75,1.0,51,1,52,0.34615384615384615
2016-17,Playoffs,203546,52,Ian Clark,1610612744,GSW,16,219,40,79,0.506,13,36,0.361,16,17,0.941,4,22,26,11,6,0,11,17,109,101,1.0,0.55,2016,17,6.8125,1.0,39,1,40,0.65
2016-17,Playoffs,201599,53,DeAndre Jordan,1610612746,LAC,7,264,43,61,0.705,0,1,0.0,22,56,0.393,25,76,101,5,3,6,17,29,108,154,0.29,0.18,2016,17,15.428571428571429,0.29411764705882354,18,34,52,1.9423076923076923
2016-17,Playoffs,1938,54,Manu Ginobili,1610612759,SAS,16,284,40,97,0.412,9,40,0.225,17,23,0.739,10,29,39,39,16,2,12,28,106,127,3.25,1.33,2016,17,6.625,3.25,57,6,63,0.6190476190476191
2016-17,Playoffs,2594,55,Kyle Korver,1610612739,CLE,18,326,34,80,0.425,27,69,0.391,10,10,1.0,2,28,30,13,7,5,7,22,105,107,1.86,1.0,2016,17,5.833333333333333,1.8571428571428572,46,0,46,0.6521739130434783
2016-17,Playoffs,101162,55,Marcin Gortat,1610612764,WAS,13,409,47,93,0.505,0,0,0.0,11,18,0.611,52,91,143,24,5,20,17,40,105,227,1.41,0.29,2016,17,8.076923076923077,1.411764705882353,46,7,53,2.69811320754717
2016-17,Playoffs,1626181,55,Norman Powell,1610612761,TOR,9,227,35,82,0.427,15,34,0.441,20,24,0.833,5,23,28,14,10,3,15,25,105,94,0.93,0.67,2016,17,11.666666666666666,0.9333333333333333,47,4,51,0.5490196078431373
2016-17,Playoffs,203497,58,Rudy Gobert,1610612762,UTA,9,246,40,63,0.635,0,0,0.0,24,50,0.48,22,67,89,11,9,12,9,30,104,167,1.22,1.0,2016,17,11.555555555555555,1.2222222222222223,23,26,49,1.816326530612245
2016-17,Playoffs,201583,59,Ryan Anderson,1610612745,HOU,11,336,36,92,0.391,17,60,0.283,14,16,0.875,15,42,57,7,4,2,9,24,103,106,0.78,0.44,2016,17,9.363636363636363,0.7777777777777778,56,2,58,0.9827586206896551
2016-17,Playoffs,203918,60,Rodney Hood,1610612762,UTA,11,277,37,105,0.352,13,50,0.26,11,18,0.611,1,29,30,12,5,0,10,30,98,60,1.2,0.5,2016,17,8.909090909090908,1.2,68,7,75,0.4
2016-17,Playoffs,101123,61,Gerald Green,1610612738,BOS,13,192,34,72,0.472,21,45,0.467,8,9,0.889,2,18,20,9,3,1,7,21,97,84,1.29,0.43,2016,17,7.461538461538462,1.2857142857142858,38,1,39,0.5128205128205128
2016-17,Playoffs,1626179,62,Terry Rozier,1610612738,BOS,17,277,33,82,0.402,14,38,0.368,16,20,0.8,12,32,44,32,11,4,10,20,96,124,3.2,1.1,2016,17,5.647058823529412,3.2,49,4,53,0.8301886792452831
2016-17,Playoffs,201580,63,JaVale McGee,1610612744,GSW,16,149,41,56,0.732,0,0,0.0,13,18,0.722,22,26,48,4,2,15,8,31,95,136,0.5,0.25,2016,17,5.9375,0.5,15,5,20,2.4
2016-17,Playoffs,203468,64,CJ McCollum,1610612757,POR,4,140,32,80,0.4,11,22,0.5,15,16,0.938,8,16,24,4,4,2,15,10,90,60,0.27,0.27,2016,17,22.5,0.26666666666666666,48,1,49,0.4897959183673469
2016-17,Playoffs,2548,64,Dwyane Wade,1610612741,CHI,6,190,32,86,0.372,6,17,0.353,20,21,0.952,6,24,30,24,5,8,10,8,90,92,2.4,0.5,2016,17,15.0,2.4,54,1,55,0.5454545454545454
2016-17,Playoffs,2403,64,Nene,1610612745,HOU,9,161,36,51,0.706,0,1,0.0,18,31,0.581,11,31,42,5,6,4,9,24,90,110,0.56,0.67,2016,17,10.0,0.5555555555555556,15,13,28,1.5
2016-17,Playoffs,101112,67,Channing Frye,1610612739,CLE,12,154,31,60,0.517,20,39,0.513,6,7,0.857,0,22,22,13,3,4,2,11,88,98,6.5,1.5,2016,17,7.333333333333333,6.5,29,1,30,0.7333333333333333
2016-17,Playoffs,2037,67,Jamal Crawford,1610612746,LAC,7,196,35,83,0.422,6,25,0.24,12,12,1.0,2,7,9,13,4,1,9,12,88,58,1.44,0.44,2016,17,12.571428571428571,1.4444444444444444,48,0,48,0.1875
2016-17,Playoffs,203114,69,Khris Middleton,1610612749,MIL,6,231,31,78,0.397,7,19,0.368,18,22,0.818,0,28,28,32,12,0,11,17,87,97,2.91,1.09,2016,17,14.5,2.909090909090909,47,4,51,0.5490196078431373
2016-17,Playoffs,1627759,70,Jaylen Brown,1610612738,BOS,17,215,34,71,0.479,5,23,0.217,12,18,0.667,12,24,36,13,6,2,13,26,85,86,1.0,0.46,2016,17,5.0,1.0,37,6,43,0.8372093023255814
2016-17,Playoffs,202324,71,Derrick Favors,1610612762,UTA,11,225,36,62,0.581,0,0,0.0,11,23,0.478,15,45,60,10,8,6,4,25,83,125,2.5,2.0,2016,17,7.545454545454546,2.5,26,12,38,1.5789473684210527
2016-17,Playoffs,203937,71,Kyle Anderson,1610612759,SAS,15,195,36,64,0.563,3,10,0.3,8,11,0.727,12,34,46,25,10,2,7,8,83,128,3.57,1.43,2016,17,5.533333333333333,3.5714285714285716,28,3,31,1.4838709677419355
2016-17,Playoffs,202709,73,Cory Joseph,1610612761,TOR,10,212,31,71,0.437,9,22,0.409,8,8,1.0,4,17,21,31,4,2,14,17,79,83,2.21,0.29,2016,17,7.9,2.2142857142857144,40,0,40,0.525
2016-17,Playoffs,202328,73,Greg Monroe,1610612749,MIL,6,141,27,51,0.529,0,0,0.0,25,30,0.833,17,27,44,10,8,3,11,16,79,104,0.91,0.73,2016,17,13.166666666666666,0.9090909090909091,24,5,29,1.5172413793103448
2016-17,Playoffs,2216,73,Zach Randolph,1610612763,MEM,6,191,35,83,0.422,1,7,0.143,8,11,0.727,9,40,49,4,5,2,7,14,79,81,0.57,0.71,2016,17,13.166666666666666,0.5714285714285714,48,3,51,0.9607843137254902
2016-17,Playoffs,101114,76,Deron Williams,1610612739,CLE,18,262,28,64,0.438,12,31,0.387,10,11,0.909,3,20,23,38,10,1,17,29,78,96,2.23,0.59,2016,17,4.333333333333333,2.235294117647059,36,1,37,0.6216216216216216
2016-17,Playoffs,203501,77,Tim Hardaway Jr.,1610612737,ATL,6,200,27,82,0.329,11,42,0.262,12,19,0.632,3,13,16,7,3,0,10,13,77,31,0.7,0.3,2016,17,12.833333333333334,0.7,55,7,62,0.25806451612903225
2016-17,Playoffs,2585,77,Zaza Pachulia,1610612744,GSW,15,212,32,60,0.533,0,1,0.0,13,17,0.765,18,39,57,12,8,4,14,32,77,112,0.86,0.57,2016,17,5.133333333333334,0.8571428571428571,28,4,32,1.78125
2016-17,Playoffs,2561,79,David West,1610612744,GSW,17,221,34,59,0.576,1,2,0.5,7,9,0.778,7,39,46,36,7,13,10,26,76,141,3.6,0.7,2016,17,4.470588235294118,3.6,25,2,27,1.7037037037037037
2016-17,Playoffs,201577,79,Robin Lopez,1610612741,CHI,6,162,34,52,0.654,0,0,0.0,8,8,1.0,28,15,43,5,3,6,8,13,76,107,0.63,0.38,2016,17,12.666666666666666,0.625,18,0,18,2.388888888888889
2016-17,Playoffs,202697,81,Iman Shumpert,1610612739,CLE,17,275,25,60,0.417,10,26,0.385,14,17,0.824,6,41,47,16,10,3,6,32,74,106,2.67,1.67,2016,17,4.352941176470588,2.6666666666666665,35,3,38,1.236842105263158
2016-17,Playoffs,2733,82,Shaun Livingston,1610612744,GSW,14,220,34,59,0.576,0,0,0.0,5,7,0.714,10,19,29,20,5,2,10,24,73,92,2.0,0.5,2016,17,5.214285714285714,2.0,25,2,27,1.0740740740740742
2016-17,Playoffs,204060,83,Joe Ingles,1610612762,UTA,11,333,25,62,0.403,15,41,0.366,6,9,0.667,2,39,41,36,22,5,16,28,71,119,2.25,1.38,2016,17,6.454545454545454,2.25,37,3,40,1.025
2016-17,Playoffs,1626162,84,Kelly Oubre Jr.,1610612764,WAS,12,184,26,61,0.426,11,30,0.367,7,10,0.7,9,19,28,4,10,5,7,38,70,72,0.57,1.43,2016,17,5.833333333333333,0.5714285714285714,35,3,38,0.7368421052631579
2016-17,Playoffs,201952,85,Jeff Teague,1610612754,IND,4,142,22,45,0.489,9,17,0.529,15,18,0.833,0,13,13,25,4,3,8,12,68,79,3.13,0.5,2016,17,17.0,3.125,23,3,26,0.5
2016-17,Playoffs,1627752,86,Taurean Prince,1610612737,ATL,6,187,29,52,0.558,4,14,0.286,5,5,1.0,7,25,32,8,2,1,7,9,67,80,1.14,0.29,2016,17,11.166666666666666,1.1428571428571428,23,0,23,1.391304347826087
2016-17,Playoffs,200755,87,JJ Redick,1610612746,LAC,7,206,19,50,0.38,9,26,0.346,17,20,0.85,0,12,12,6,2,0,13,17,64,37,0.46,0.15,2016,17,9.142857142857142,0.46153846153846156,31,3,34,0.35294117647058826
2016-17,Playoffs,202362,87,Lance Stephenson,1610612754,IND,4,107,27,53,0.509,7,18,0.389,3,4,0.75,1,20,21,11,2,0,4,11,64,67,2.75,0.5,2016,17,16.0,2.75,26,1,27,0.7777777777777778
2016-17,Playoffs,2564,89,Boris Diaw,1610612762,UTA,11,203,24,48,0.5,6,14,0.429,9,10,0.9,3,18,21,22,7,4,14,12,63,78,1.57,0.5,2016,17,5.7272727272727275,1.5714285714285714,24,1,25,0.84
2016-17,Playoffs,1627749,89,Dejounte Murray,1610612759,SAS,11,168,23,61,0.377,0,3,0.0,17,25,0.68,4,23,27,27,16,1,16,14,63,72,1.69,1.0,2016,17,5.7272727272727275,1.6875,38,8,46,0.5869565217391305
2016-17,Playoffs,201933,91,Blake Griffin,1610612746,LAC,3,99,25,51,0.49,4,6,0.667,7,7,1.0,3,15,18,7,2,1,6,2,61,57,1.17,0.33,2016,17,20.333333333333332,1.1666666666666667,26,0,26,0.6923076923076923
2016-17,Playoffs,101135,91,David Lee,1610612759,SAS,15,245,25,48,0.521,0,1,0.0,11,17,0.647,20,37,57,11,4,5,6,20,61,103,1.83,0.67,2016,17,4.066666666666666,1.8333333333333333,23,6,29,1.9655172413793103
2016-17,Playoffs,1627775,91,Patrick McCaw,1610612744,GSW,15,181,21,48,0.438,8,23,0.348,11,13,0.846,10,23,33,16,9,3,3,14,61,90,5.33,3.0,2016,17,4.066666666666666,5.333333333333333,27,2,29,1.1379310344827587
2016-17,Playoffs,203503,94,Tony Snell,1610612749,MIL,6,185,22,44,0.5,16,31,0.516,0,0,0.0,2,12,14,9,1,1,2,17,60,61,4.5,0.5,2016,17,10.0,4.5,22,0,22,0.6363636363636364
2016-17,Playoffs,203145,95,Kent Bazemore,1610612737,ATL,6,150,21,53,0.396,7,24,0.292,10,14,0.714,4,19,23,20,4,5,16,15,59,59,1.25,0.25,2016,17,9.833333333333334,1.25,32,4,36,0.6388888888888888
2016-17,Playoffs,203460,96,Andre Roberson,1610612760,OKC,5,185,24,46,0.522,7,17,0.412,3,21,0.143,18,13,31,9,12,17,7,15,58,80,1.29,1.71,2016,17,11.6,1.2857142857142858,22,18,40,0.775
2016-17,Playoffs,2210,97,Richard Jefferson,1610612739,CLE,14,179,16,38,0.421,5,19,0.263,18,28,0.643,10,15,25,7,2,3,8,30,55,52,0.88,0.25,2016,17,3.9285714285714284,0.875,22,10,32,0.78125
2016-17,Playoffs,1713,97,Vince Carter,1610612763,MEM,6,195,20,42,0.476,8,20,0.4,7,7,1.0,4,16,20,9,2,0,10,15,55,54,0.9,0.2,2016,17,9.166666666666666,0.9,22,0,22,0.9090909090909091
2016-17,Playoffs,1627763,99,Malcolm Brogdon,1610612749,MIL,6,183,22,55,0.4,10,21,0.476,0,0,0.0,3,23,26,21,3,2,12,12,54,61,1.75,0.25,2016,17,9.0,1.75,33,0,33,0.7878787878787878
2016-17,Playoffs,202714,99,Shelvin Mack,1610612762,UTA,9,155,17,49,0.347,7,15,0.467,13,15,0.867,3,22,25,18,4,0,9,14,54,58,2.0,0.44,2016,17,6.0,2.0,32,2,34,0.7352941176470589
2016-17,Playoffs,203506,99,Victor Oladipo,1610612760,OKC,5,181,21,61,0.344,6,25,0.24,6,6,1.0,2,26,28,10,7,3,6,17,54,56,1.67,1.17,2016,17,10.8,1.6666666666666667,40,0,40,0.7
2016-17,Playoffs,201601,102,Luc Mbah a Moute,1610612746,LAC,7,224,17,43,0.395,5,16,0.313,14,20,0.7,10,24,34,7,8,4,3,16,53,71,2.33,2.67,2016,17,7.571428571428571,2.3333333333333335,26,6,32,1.0625
2016-17,Playoffs,202703,103,Nikola Mirotic,1610612741,CHI,6,162,17,50,0.34,10,35,0.286,8,10,0.8,4,26,30,9,4,3,4,16,52,59,2.25,1.0,2016,17,8.666666666666666,2.25,33,2,35,0.8571428571428571
2016-17,Playoffs,201160,104,Jason Smith,1610612764,WAS,13,157,19,39,0.487,3,10,0.3,10,14,0.714,10,19,29,4,2,7,10,30,51,59,0.4,0.2,2016,17,3.923076923076923,0.4,20,4,24,1.2083333333333333
2016-17,Playoffs,203516,105,James Ennis III,1610612763,MEM,6,159,16,38,0.421,6,19,0.316,12,14,0.857,8,17,25,7,5,2,7,20,50,58,1.0,0.71,2016,17,8.333333333333334,1.0,22,2,24,1.0416666666666667
2016-17,Playoffs,200782,105,P.J. Tucker,1610612761,TOR,10,251,18,49,0.367,9,28,0.321,5,8,0.625,15,42,57,11,6,3,8,27,50,85,1.38,0.75,2016,17,5.0,1.375,31,3,34,1.6764705882352942
2016-17,Playoffs,201959,107,Taj Gibson,1610612760,OKC,5,118,21,35,0.6,0,0,0.0,7,8,0.875,3,15,18,3,1,0,8,13,49,48,0.38,0.13,2016,17,9.8,0.375,14,1,15,1.2
2016-17,Playoffs,202329,108,Al-Farouq Aminu,1610612757,POR,4,113,17,37,0.459,7,17,0.412,7,11,0.636,5,21,26,4,3,4,9,9,48,52,0.44,0.33,2016,17,12.0,0.4444444444444444,20,4,24,1.0833333333333333
2016-17,Playoffs,2730,108,Dwight Howard,1610612737,ATL,6,157,18,36,0.5,0,0,0.0,12,19,0.632,18,46,64,8,6,5,11,21,48,95,0.73,0.55,2016,17,8.0,0.7272727272727273,18,7,25,2.56
2016-17,Playoffs,201152,108,Thaddeus Young,1610612754,IND,4,140,21,39,0.538,1,4,0.25,5,10,0.5,22,14,36,10,8,1,6,11,48,74,1.67,1.33,2016,17,12.0,1.6666666666666667,18,5,23,1.565217391304348
2016-17,Playoffs,203924,111,Jerami Grant,1610612760,OKC,5,111,19,31,0.613,2,6,0.333,6,7,0.857,7,12,19,4,1,2,3,7,46,56,1.33,0.33,2016,17,9.2,1.3333333333333333,12,1,13,1.4615384615384615
2016-17,Playoffs,201578,111,Marreese Speights,1610612746,LAC,7,98,16,37,0.432,7,20,0.35,7,10,0.7,4,16,20,3,2,3,3,13,46,47,1.0,0.67,2016,17,6.571428571428571,1.0,21,3,24,0.8333333333333334
2016-17,Playoffs,203521,111,Matthew Dellavedova,1610612749,MIL,6,159,16,41,0.39,6,16,0.375,8,10,0.8,1,11,12,12,1,0,7,5,46,37,1.71,0.14,2016,17,7.666666666666667,1.7142857142857142,25,2,27,0.4444444444444444
2016-17,Playoffs,203473,114,Dewayne Dedmon,1610612759,SAS,12,97,14,23,0.609,0,0,0.0,17,32,0.531,21,26,47,3,2,3,8,16,45,68,0.38,0.25,2016,17,3.75,0.375,9,15,24,1.9583333333333333
2016-17,Playoffs,203210,115,JaMychal Green,1610612763,MEM,6,118,17,36,0.472,7,16,0.438,3,3,1.0,3,17,20,2,0,0,4,21,44,43,0.5,0.0,2016,17,7.333333333333333,0.5,19,0,19,1.0526315789473684
2016-17,Playoffs,1627835,115,Paul Zipser,1610612741,CHI,6,136,15,33,0.455,6,16,0.375,8,8,1.0,3,18,21,3,1,1,7,12,44,45,0.43,0.14,2016,17,7.333333333333333,0.42857142857142855,18,0,18,1.1666666666666667
2016-17,Playoffs,201973,117,Jonas Jerebko,1610612738,BOS,12,128,15,31,0.484,5,15,0.333,8,8,1.0,7,22,29,12,5,3,6,13,43,70,2.0,0.83,2016,17,3.5833333333333335,2.0,16,0,16,1.8125
2016-17,Playoffs,1626167,117,Myles Turner,1610612754,IND,4,133,19,44,0.432,0,6,0.0,5,8,0.625,6,21,27,3,7,5,6,15,43,51,0.5,1.17,2016,17,10.75,0.5,25,3,28,0.9642857142857143
2016-17,Playoffs,201960,119,DeMarre Carroll,1610612761,TOR,10,155,15,37,0.405,7,22,0.318,5,9,0.556,4,23,27,5,8,5,5,13,42,56,1.0,1.6,2016,17,4.2,1.0,22,4,26,1.0384615384615385
2016-17,Playoffs,202323,120,Evan Turner,1610612757,POR,4,124,12,33,0.364,5,15,0.333,12,16,0.75,3,20,23,15,7,2,7,7,41,56,2.14,1.0,2016,17,10.25,2.142857142857143,21,4,25,0.92
2016-17,Playoffs,1626171,121,Bobby Portis,1610612741,CHI,6,121,17,33,0.515,6,13,0.462,0,0,0.0,5,31,36,7,3,3,6,10,40,67,1.17,0.5,2016,17,6.666666666666667,1.1666666666666667,16,0,16,2.25
2016-17,Playoffs,203500,121,Steven Adams,1610612760,OKC,5,157,18,28,0.643,0,0,0.0,4,11,0.364,17,17,34,7,6,9,4,14,40,75,1.75,1.5,2016,17,8.0,1.75,10,7,17,2.0
2016-17,Playoffs,1626150,123,Andrew Harrison,1610612763,MEM,6,119,13,29,0.448,5,13,0.385,8,9,0.889,4,7,11,13,3,1,3,14,39,47,4.33,1.0,2016,17,6.5,4.333333333333333,16,1,17,0.6470588235294118
2016-17,Playoffs,101109,123,Raymond Felton,1610612746,LAC,7,127,15,32,0.469,4,9,0.444,5,5,1.0,2,8,10,10,6,0,3,10,39,45,3.33,2.0,2016,17,5.571428571428571,3.3333333333333335,17,0,17,0.5882352941176471
2016-17,Playoffs,201943,125,Brandon Jennings,1610612764,WAS,13,178,14,36,0.389,2,13,0.154,7,8,0.875,5,14,19,24,2,0,8,13,37,51,3.0,0.25,2016,17,2.8461538461538463,3.0,22,1,23,0.8260869565217391
2016-17,Playoffs,101161,126,Amir Johnson,1610612738,BOS,14,142,15,30,0.5,1,3,0.333,5,8,0.625,17,13,30,3,4,6,6,24,36,55,0.5,0.67,2016,17,2.5714285714285716,0.5,15,3,18,1.6666666666666667
2016-17,Playoffs,202722,126,Dāvis Bertāns,1610612759,SAS,13,112,12,27,0.444,8,20,0.4,4,6,0.667,5,15,20,3,3,4,6,7,36,43,0.5,0.5,2016,17,2.769230769230769,0.5,15,2,17,1.1764705882352942
2016-17,Playoffs,203477,128,Isaiah Canaan,1610612741,CHI,3,95,13,26,0.5,5,14,0.357,4,6,0.667,0,4,4,4,3,0,5,6,35,26,0.8,0.6,2016,17,11.666666666666666,0.8,13,2,15,0.26666666666666666
2016-17,Playoffs,1627748,128,Thon Maker,1610612749,MIL,6,116,12,31,0.387,2,10,0.2,9,11,0.818,8,11,19,12,5,11,8,18,35,53,1.5,0.63,2016,17,5.833333333333333,1.5,19,2,21,0.9047619047619048
2016-17,Playoffs,202335,130,Patrick Patterson,1610612761,TOR,10,185,10,36,0.278,8,26,0.308,6,6,1.0,1,19,20,20,7,2,6,4,34,51,3.33,1.17,2016,17,3.4,3.3333333333333335,26,0,26,0.7692307692307693
2016-17,Playoffs,203957,131,Dante Exum,1610612762,UTA,7,84,11,27,0.407,4,12,0.333,6,6,1.0,2,4,6,9,5,0,3,10,32,33,3.0,1.67,2016,17,4.571428571428571,3.0,16,0,16,0.375
2016-17,Playoffs,203092,131,Tyler Zeller,1610612738,BOS,11,78,13,25,0.52,0,0,0.0,6,8,0.75,8,11,19,8,0,2,4,7,32,43,2.0,0.0,2016,17,2.909090909090909,2.0,12,2,14,1.3571428571428572
2016-17,Playoffs,101139,133,CJ Miles,1610612754,IND,4,82,11,24,0.458,5,16,0.313,2,2,1.0,4,4,8,1,2,1,2,12,29,26,0.5,1.0,2016,17,7.25,0.5,13,0,13,0.6153846153846154
2016-17,Playoffs,202338,133,Kevin Seraphin,1610612754,IND,4,59,12,26,0.462,0,0,0.0,5,7,0.714,8,6,14,4,0,2,4,10,29,29,1.0,0.0,2016,17,7.25,1.0,14,2,16,0.875
2016-17,Playoffs,203090,133,Maurice Harkless,1610612757,POR,4,99,10,34,0.294,2,12,0.167,7,8,0.875,7,6,13,3,5,5,1,14,29,29,3.0,5.0,2016,17,7.25,3.0,24,1,25,0.52
2016-17,Playoffs,203894,136,Shabazz Napier,1610612757,POR,4,47,8,19,0.421,5,11,0.455,6,8,0.75,1,3,4,3,2,0,0,6,27,23,0.0,0.0,2016,17,6.75,inf,11,2,13,0.3076923076923077
2016-17,Playoffs,101181,137,Jose Calderon,1610612737,ATL,6,75,11,23,0.478,4,12,0.333,0,0,0.0,2,6,8,13,2,1,4,9,26,34,3.25,0.5,2016,17,4.333333333333333,3.25,12,0,12,0.6666666666666666
2016-17,Playoffs,201628,138,Bobby Brown,1610612745,HOU,5,22,10,20,0.5,5,11,0.455,0,0,0.0,0,2,2,1,0,0,0,1,25,18,0.0,0.0,2016,17,5.0,inf,10,0,10,0.2
2016-17,Playoffs,1626153,138,Delon Wright,1610612761,TOR,9,92,9,17,0.529,2,6,0.333,5,7,0.714,4,9,13,13,4,1,5,4,25,41,2.6,0.8,2016,17,2.7777777777777777,2.6,8,2,10,1.3
2016-17,Playoffs,203926,138,Doug McDermott,1610612760,OKC,5,66,9,18,0.5,7,13,0.538,0,0,0.0,0,5,5,1,1,1,1,2,25,23,1.0,1.0,2016,17,5.0,1.0,9,0,9,0.5555555555555556
2016-17,Playoffs,203518,141,Alex Abrines,1610612760,OKC,5,80,8,23,0.348,5,17,0.294,3,4,0.75,2,7,9,4,0,0,0,8,24,21,0.0,0.0,2016,17,4.8,inf,15,1,16,0.5625
2016-17,Playoffs,203085,141,Austin Rivers,1610612746,LAC,3,90,9,26,0.346,4,13,0.308,2,2,1.0,1,7,8,2,1,1,5,6,24,14,0.4,0.2,2016,17,8.0,0.4,17,0,17,0.47058823529411764
2016-17,Playoffs,202683,141,Enes Freedom,1610612760,OKC,5,45,10,26,0.385,0,0,0.0,4,4,1.0,3,6,9,1,0,4,2,8,24,20,0.5,0.0,2016,17,4.8,0.5,16,0,16,0.5625
2016-17,Playoffs,101141,141,Ersan Ilyasova,1610612737,ATL,6,90,8,23,0.348,1,5,0.2,7,9,0.778,14,17,31,2,1,0,5,7,24,36,0.4,0.2,2016,17,4.0,0.4,15,2,17,1.8235294117647058
2016-17,Playoffs,203949,141,James Michael McAdoo,1610612744,GSW,13,56,9,17,0.529,2,5,0.4,4,6,0.667,5,8,13,0,2,2,1,5,24,30,0.0,2.0,2016,17,1.8461538461538463,0.0,8,2,10,1.3
2016-17,Playoffs,200765,146,Rajon Rondo,1610612741,CHI,2,67,11,26,0.423,0,6,0.0,1,2,0.5,7,10,17,20,7,1,4,6,23,48,5.0,1.75,2016,17,11.5,5.0,15,1,16,1.0625
2016-17,Playoffs,203526,146,Raul Neto,1610612762,UTA,9,60,8,13,0.615,3,6,0.5,4,4,1.0,0,7,7,4,1,1,3,8,23,28,1.33,0.33,2016,17,2.5555555555555554,1.3333333333333333,5,0,5,1.4
2016-17,Playoffs,1627782,146,Wayne Selden,1610612763,MEM,6,106,9,26,0.346,2,11,0.182,3,4,0.75,3,6,9,7,1,1,2,8,23,21,3.5,0.5,2016,17,3.8333333333333335,3.5,17,1,18,0.5
2016-17,Playoffs,203459,149,Allen Crabbe,1610612757,POR,4,92,9,24,0.375,3,13,0.231,1,3,0.333,0,12,12,2,1,0,1,9,22,19,2.0,1.0,2016,17,5.5,2.0,15,2,17,0.7058823529411765
2016-17,Playoffs,101145,149,Monta Ellis,1610612754,IND,4,76,8,20,0.4,2,8,0.25,4,5,0.8,1,7,8,5,2,1,4,5,22,21,1.25,0.5,2016,17,5.5,1.25,12,1,13,0.6153846153846154
2016-17,Playoffs,202682,151,Derrick Williams,1610612739,CLE,8,38,8,15,0.533,3,5,0.6,2,2,1.0,1,2,3,4,0,1,3,0,21,19,1.33,0.0,2016,17,2.625,1.3333333333333333,7,0,7,0.42857142857142855
2016-17,Playoffs,1718,151,Paul Pierce,1610612746,LAC,7,101,8,18,0.444,4,10,0.4,1,1,1.0,2,12,14,7,2,0,4,11,21,30,1.75,0.5,2016,17,3.0,1.75,10,0,10,1.4
2016-17,Playoffs,1627854,153,Bryn Forbes,1610612759,SAS,6,73,6,21,0.286,2,9,0.222,6,6,1.0,0,6,6,3,0,1,2,5,20,13,1.5,0.0,2016,17,3.3333333333333335,1.5,15,0,15,0.4
2016-17,Playoffs,1626245,154,Cristiano Felicio,1610612741,CHI,6,82,9,15,0.6,0,0,0.0,1,2,0.5,7,19,26,2,3,2,7,16,19,38,0.29,0.43,2016,17,3.1666666666666665,0.2857142857142857,6,1,7,3.7142857142857144
2016-17,Playoffs,203943,155,Noah Vonleh,1610612757,POR,4,100,8,18,0.444,0,0,0.0,2,5,0.4,9,20,29,8,1,3,6,11,18,40,1.33,0.17,2016,17,4.5,1.3333333333333333,10,3,13,2.230769230769231
2016-17,Playoffs,201563,156,Michael Beasley,1610612749,MIL,4,48,7,20,0.35,3,5,0.6,0,4,0.0,2,7,9,1,1,1,2,8,17,10,0.5,0.5,2016,17,4.25,0.5,13,4,17,0.5294117647058824
2016-17,Playoffs,203488,156,Mike Muscala,1610612737,ATL,6,81,5,18,0.278,0,4,0.0,7,8,0.875,6,10,16,2,1,3,1,12,17,24,2.0,1.0,2016,17,2.8333333333333335,2.0,13,1,14,1.1428571428571428
2016-17,Playoffs,2563,158,Dahntay Jones,1610612739,CLE,10,33,5,10,0.5,1,2,0.5,5,5,1.0,1,6,7,1,0,1,1,7,16,19,1.0,0.0,2016,17,1.6,1.0,5,0,5,1.4
2016-17,Playoffs,1626170,158,Jerian Grant,1610612741,CHI,5,52,6,23,0.261,1,9,0.111,3,3,1.0,0,4,4,5,2,0,7,3,16,3,0.71,0.29,2016,17,3.2,0.7142857142857143,17,0,17,0.23529411764705882
2016-17,Playoffs,203922,160,Glenn Robinson III,1610612754,IND,3,31,6,6,1.0,2,2,1.0,1,2,0.5,0,3,3,1,0,0,0,2,15,18,0.0,0.0,2016,17,5.0,inf,0,1,1,3.0
2016-17,Playoffs,203923,160,James Young,1610612738,BOS,10,39,5,15,0.333,5,14,0.357,0,0,0.0,1,6,7,3,0,0,1,2,15,14,3.0,0.0,2016,17,1.5,3.0,10,0,10,0.7
2016-17,Playoffs,1891,160,Jason Terry,1610612749,MIL,6,68,6,18,0.333,2,10,0.2,1,1,1.0,2,6,8,5,3,1,2,7,15,18,2.5,1.5,2016,17,2.5,2.5,12,0,12,0.6666666666666666
2016-17,Playoffs,1627832,163,Fred VanVleet,1610612761,TOR,7,29,6,9,0.667,2,5,0.4,0,0,0.0,0,1,1,4,1,0,1,3,14,16,4.0,1.0,2016,17,2.0,4.0,3,0,3,0.3333333333333333
2016-17,Playoffs,101133,163,Ian Mahinmi,1610612764,WAS,5,63,5,9,0.556,0,0,0.0,4,11,0.364,3,8,11,6,1,6,3,17,14,24,2.0,0.33,2016,17,2.8,2.0,4,7,11,1.0
2016-17,Playoffs,203530,163,Joffrey Lauvergne,1610612741,CHI,3,26,4,11,0.364,0,2,0.0,6,6,1.0,5,4,9,5,0,0,2,1,14,19,2.5,0.0,2016,17,4.666666666666667,2.5,7,0,7,1.2857142857142858
2016-17,Playoffs,203487,163,Michael Carter-Williams,1610612741,CHI,5,53,6,15,0.4,0,1,0.0,2,4,0.5,1,3,4,6,2,1,6,6,14,10,1.0,0.33,2016,17,2.8,1.0,9,2,11,0.36363636363636365
2016-17,Playoffs,1627815,163,Sheldon Mac,1610612764,WAS,7,17,5,9,0.556,2,5,0.4,2,2,1.0,0,2,2,0,0,0,1,1,14,11,0.0,0.0,2016,17,2.0,0.0,4,0,4,0.5
2016-17,Playoffs,201627,168,Anthony Morrow,1610612741,CHI,3,29,5,9,0.556,0,0,0.0,2,2,1.0,0,3,3,2,0,0,0,2,12,13,0.0,0.0,2016,17,4.0,inf,4,0,4,0.75
2016-17,Playoffs,2399,168,Mike Dunleavy,1610612737,ATL,6,53,3,7,0.429,2,5,0.4,4,4,1.0,1,4,5,2,1,0,6,3,12,10,0.33,0.17,2016,17,2.0,0.3333333333333333,4,0,4,1.25
2016-17,Playoffs,1627751,170,Jakob Poeltl,1610612761,TOR,6,26,5,11,0.455,0,0,0.0,0,2,0.0,6,6,12,0,1,1,0,3,10,16,0.0,0.0,2016,17,1.6666666666666667,,6,2,8,1.5
2016-17,Playoffs,2440,171,Matt Barnes,1610612744,GSW,12,61,4,15,0.267,1,8,0.125,0,0,0.0,0,9,9,7,2,0,3,9,9,13,2.33,0.67,2016,17,0.75,2.3333333333333335,11,0,11,0.8181818181818182
2016-17,Playoffs,1626155,171,Sam Dekker,1610612745,HOU,4,31,3,12,0.25,3,6,0.5,0,0,0.0,5,5,10,1,1,1,0,2,9,13,0.0,0.0,2016,17,2.25,inf,9,0,9,1.1111111111111112
2016-17,Playoffs,203584,171,Troy Daniels,1610612763,MEM,6,68,3,9,0.333,3,9,0.333,0,0,0.0,1,4,5,2,2,0,2,1,9,10,1.0,1.0,2016,17,1.5,1.0,6,0,6,0.8333333333333334
2016-17,Playoffs,1627098,174,Malcolm Delaney,1610612737,ATL,1,3,3,3,1.0,1,1,1.0,1,2,0.5,0,1,1,0,0,0,0,0,8,8,0.0,0.0,2016,17,8.0,,0,1,1,1.0
2016-17,Playoffs,203107,174,Tomas Satoransky,1610612764,WAS,10,36,3,6,0.5,0,0,0.0,2,5,0.4,1,4,5,6,1,0,2,4,8,12,3.0,0.5,2016,17,0.8,3.0,3,3,6,0.8333333333333334
2016-17,Playoffs,1627745,176,Damian Jones,1610612744,GSW,4,21,3,7,0.429,0,0,0.0,1,2,0.5,4,2,6,0,2,1,0,3,7,11,0.0,0.0,2016,17,1.75,,4,1,5,1.2
2016-17,Playoffs,1627738,176,Deyonta Davis,1610612763,MEM,3,11,3,5,0.6,0,0,0.0,1,2,0.5,2,3,5,0,0,0,0,2,7,9,0.0,0.0,2016,17,2.3333333333333335,,2,1,3,1.6666666666666667
2016-17,Playoffs,1626192,176,Pat Connaughton,1610612757,POR,3,24,2,9,0.222,0,6,0.0,3,3,1.0,1,6,7,4,0,0,0,0,7,11,0.0,0.0,2016,17,2.3333333333333335,inf,7,0,7,1.0
2016-17,Playoffs,1626168,176,Trey Lyles,1610612762,UTA,2,10,3,7,0.429,1,3,0.333,0,0,0.0,0,2,2,1,1,0,1,1,7,6,1.0,1.0,2016,17,3.5,1.0,4,0,4,0.5
2016-17,Playoffs,1627774,180,Jake Layman,1610612757,POR,2,16,2,4,0.5,1,1,1.0,1,2,0.5,0,1,1,1,1,0,0,2,6,6,0.0,0.0,2016,17,3.0,inf,2,1,3,0.3333333333333333
2016-17,Playoffs,201202,180,Joel Anthony,1610612759,SAS,3,15,3,4,0.75,0,0,0.0,0,1,0.0,2,2,4,0,0,2,1,2,6,9,0.0,0.0,2016,17,2.0,0.0,1,1,2,2.0
2016-17,Playoffs,1626173,180,Rashad Vaughn,1610612749,MIL,3,10,2,4,0.5,2,2,1.0,0,0,0.0,0,0,0,0,0,0,0,0,6,4,0.0,0.0,2016,17,2.0,,2,0,2,0.0
2016-17,Playoffs,201166,183,Aaron Brooks,1610612754,IND,1,7,2,3,0.667,1,2,0.5,0,0,0.0,0,1,1,1,0,0,1,0,5,5,1.0,0.0,2016,17,5.0,1.0,1,0,1,1.0
2016-17,Playoffs,1627756,183,Denzel Valentine,1610612741,CHI,4,22,2,6,0.333,1,4,0.25,0,0,0.0,0,8,8,2,0,1,2,1,5,10,1.0,0.0,2016,17,1.25,1.0,4,0,4,2.0
2016-17,Playoffs,203481,183,Jeff Withey,1610612762,UTA,3,21,2,4,0.5,0,0,0.0,1,2,0.5,3,1,4,1,1,1,0,5,5,9,0.0,0.0,2016,17,1.6666666666666667,inf,2,1,3,1.3333333333333333
2016-17,Playoffs,1626149,183,Montrezl Harrell,1610612745,HOU,5,21,1,3,0.333,0,0,0.0,3,6,0.5,1,5,6,2,0,0,2,7,5,6,1.0,0.0,2016,17,1.0,1.0,2,3,5,1.2
2016-17,Playoffs,202708,183,Norris Cole,1610612760,OKC,4,25,2,8,0.25,1,4,0.25,0,0,0.0,0,1,1,1,0,1,2,4,5,0,0.5,0.0,2016,17,1.25,0.5,6,0,6,0.16666666666666666
2016-17,Playoffs,203902,183,Semaj Christon,1610612760,OKC,2,21,2,5,0.4,1,3,0.333,0,0,0.0,0,3,3,5,1,0,0,1,5,11,0.0,0.0,2016,17,2.5,inf,3,0,3,1.0
2016-17,Playoffs,201150,183,Spencer Hawes,1610612749,MIL,3,17,2,5,0.4,1,2,0.5,0,0,0.0,2,2,4,1,0,1,1,3,5,7,1.0,0.0,2016,17,1.6666666666666667,1.0,3,0,3,1.3333333333333333
2016-17,Playoffs,201148,190,Brandan Wright,1610612763,MEM,2,12,2,5,0.4,0,0,0.0,0,0,0.0,1,1,2,0,0,2,1,0,4,4,0.0,0.0,2016,17,2.0,0.0,3,0,3,0.6666666666666666
2016-17,Playoffs,1627734,190,Domantas Sabonis,1610612760,OKC,2,6,0,3,0.0,0,1,0.0,4,4,1.0,0,2,2,0,1,1,0,4,4,5,0.0,0.0,2016,17,2.0,,3,0,3,0.6666666666666666
2016-17,Playoffs,1627762,190,Joel Bolomboy,1610612762,UTA,2,9,2,3,0.667,0,0,0.0,0,0,0.0,0,2,2,0,0,1,0,0,4,6,0.0,0.0,2016,17,2.0,,1,0,1,2.0
2016-17,Playoffs,1626175,190,Jordan Mickey,1610612738,BOS,2,18,2,5,0.4,0,0,0.0,0,0,0.0,0,5,5,0,0,1,1,3,4,6,0.0,0.0,2016,17,2.0,0.0,3,0,3,1.6666666666666667
2016-17,Playoffs,1626166,194,Cameron Payne,1610612741,CHI,1,4,1,2,0.5,1,1,1.0,0,0,0.0,0,1,1,0,0,0,1,0,3,2,0.0,0.0,2016,17,3.0,0.0,1,0,1,1.0
2016-17,Playoffs,203089,194,John Henson,1610612749,MIL,2,12,1,4,0.25,0,0,0.0,1,1,1.0,2,2,4,0,1,0,1,1,3,4,0.0,1.0,2016,17,1.5,0.0,3,0,3,1.3333333333333333
2016-17,Playoffs,1627787,194,Kyle Wiltjer,1610612745,HOU,1,5,1,1,1.0,1,1,1.0,0,0,0.0,0,0,0,0,0,0,0,0,3,3,0.0,0.0,2016,17,3.0,,0,0,0,
2016-17,Playoffs,203512,194,Lucas Nogueira,1610612761,TOR,3,7,1,2,0.5,0,0,0.0,1,2,0.5,2,3,5,0,0,0,0,1,3,6,0.0,0.0,2016,17,1.0,,1,1,2,2.5
2016-17,Playoffs,203141,194,Mirza Teletovic,1610612749,MIL,3,27,1,6,0.167,1,4,0.25,0,0,0.0,0,3,3,0,1,0,1,3,3,1,0.0,1.0,2016,17,1.0,0.0,5,0,5,0.6
2016-17,Playoffs,1627817,194,Tim Quarterman,1610612757,POR,2,7,1,2,0.5,1,2,0.5,0,0,0.0,0,0,0,1,0,0,0,1,3,3,0.0,0.0,2016,17,1.5,inf,1,0,1,0.0
2016-17,Playoffs,101138,200,Brandon Bass,1610612746,LAC,1,4,1,3,0.333,0,0,0.0,0,0,0.0,1,0,1,0,1,0,0,0,2,2,0.0,0.0,2016,17,2.0,,2,0,2,0.5
2016-17,Playoffs,2592,200,James Jones,1610612739,CLE,8,30,1,5,0.2,0,3,0.0,0,0,0.0,1,3,4,0,0,0,2,3,2,0,0.0,0.0,2016,17,0.25,0.0,4,0,4,1.0
2016-17,Playoffs,1626185,200,Jarell Martin,1610612763,MEM,3,10,1,3,0.333,0,0,0.0,0,0,0.0,2,2,4,0,1,0,0,2,2,5,0.0,0.0,2016,17,0.6666666666666666,,2,0,2,2.0
2016-17,Playoffs,203994,200,Jusuf Nurkic,1610612757,POR,1,17,1,3,0.333,0,1,0.0,0,0,0.0,0,11,11,4,0,1,3,1,2,13,1.33,0.0,2016,17,2.0,1.3333333333333333,2,0,2,5.5
2016-17,Playoffs,203086,200,Meyers Leonard,1610612757,POR,3,31,1,5,0.2,0,4,0.0,0,0,0.0,2,6,8,1,0,0,4,6,2,3,0.25,0.0,2016,17,0.6666666666666666,0.25,4,0,4,2.0
2016-17,Playoffs,1627735,200,Wade Baldwin IV,1610612763,MEM,3,12,0,1,0.0,0,0,0.0,2,2,1.0,1,3,4,2,0,0,0,3,2,7,0.0,0.0,2016,17,0.6666666666666666,inf,1,0,1,4.0
2016-17,Playoffs,200757,206,Thabo Sefolosha,1610612737,ATL,4,9,0,1,0.0,0,0,0.0,1,4,0.25,0,0,0,0,0,0,0,1,1,-3,0.0,0.0,2016,17,0.25,,1,3,4,0.0
2016-17,Playoffs,1627786,206,Troy Williams,1610612745,HOU,5,19,0,9,0.0,0,5,0.0,1,2,0.5,2,5,7,1,0,0,2,0,1,-3,0.5,0.0,2016,17,0.2,0.5,9,1,10,0.7
2016-17,Playoffs,202325,206,Wesley Johnson,1610612746,LAC,3,11,0,0,0.0,0,0,0.0,1,2,0.5,0,2,2,0,1,0,0,2,1,3,0.0,0.0,2016,17,0.3333333333333333,,0,1,1,2.0
2016-17,Playoffs,1627849,209,Daniel Ochefu,1610612764,WAS,4,5,0,1,0.0,0,0,0.0,0,0,0.0,0,1,1,0,0,0,1,1,0,-1,0.0,0.0,2016,17,0.0,0.0,1,0,1,1.0
2016-17,Playoffs,1627819,209,Isaiah Taylor,1610612745,HOU,3,10,0,2,0.0,0,1,0.0,0,0,0.0,1,1,2,1,0,0,0,1,0,1,0.0,0.0,2016,17,0.0,inf,2,0,2,1.0
2016-17,Playoffs,2743,209,Kris Humphries,1610612737,ATL,1,3,0,0,0.0,0,0,0.0,0,0,0.0,0,0,0,0,0,1,0,0,0,1,0.0,0.0,2016,17,0.0,,0,0,0,
2016-17,Playoffs,202713,209,Kyle Singler,1610612760,OKC,1,10,0,1,0.0,0,0,0.0,0,0,0.0,0,1,1,0,0,0,0,2,0,0,0.0,0.0,2016,17,0.0,,1,0,1,1.0
2016-17,Playoffs,202730,209,Lavoy Allen,1610612754,IND,3,11,0,0,0.0,0,0,0.0,0,0,0.0,0,2,2,0,0,0,1,0,0,1,0.0,0.0,2016,17,0.0,0.0,0,0,0,inf
2016-17,Playoffs,1627783,209,Pascal Siakam,1610612761,TOR,2,10,0,2,0.0,0,0,0.0,0,0,0.0,2,1,3,1,1,0,0,1,0,3,0.0,0.0,2016,17,0.0,inf,2,0,2,1.5
2016-17,Playoffs,203504,209,Trey Burke,1610612764,WAS,3,20,0,4,0.0,0,2,0.0,0,0,0.0,0,0,0,5,0,0,0,2,0,1,0.0,0.0,2016,17,0.0,inf,4,0,4,0.0
2017-18,RegularSeason,2544,1,LeBron James,1610612739,CLE,82,3026,857,1580,0.542,149,406,0.367,388,531,0.731,97,612,709,747,116,71,347,136,2251,2681,2.15,0.33,2017,18,27.451219512195124,2.152737752161383,723,143,866,0.8187066974595842
2017-18,RegularSeason,201935,2,James Harden,1610612745,HOU,72,2551,651,1449,0.449,265,722,0.367,624,727,0.858,41,348,389,630,126,50,315,169,2191,2170,2.0,0.4,2017,18,30.430555555555557,2.0,798,103,901,0.43174250832408434
2017-18,RegularSeason,203076,3,Anthony Davis,1610612740,NOP,75,2727,780,1462,0.534,55,162,0.34,495,598,0.828,187,644,831,174,115,193,162,159,2110,2476,1.07,0.71,2017,18,28.133333333333333,1.0740740740740742,682,103,785,1.0585987261146497
2017-18,RegularSeason,201566,4,Russell Westbrook,1610612760,OKC,80,2914,757,1687,0.449,97,326,0.298,417,566,0.737,152,652,804,820,147,20,381,200,2028,2359,2.15,0.39,2017,18,25.35,2.152230971128609,930,149,1079,0.7451343836886005
2017-18,RegularSeason,203507,5,Giannis Antetokounmpo,1610612749,MIL,75,2756,742,1402,0.529,43,140,0.307,487,641,0.76,156,597,753,361,109,106,223,231,2014,2306,1.62,0.49,2017,18,26.85333333333333,1.6188340807174888,660,154,814,0.9250614250614251
2017-18,RegularSeason,203081,6,Damian Lillard,1610612757,POR,73,2670,621,1415,0.439,227,629,0.361,493,538,0.916,62,263,325,481,77,27,206,117,1962,1827,2.33,0.37,2017,18,26.876712328767123,2.3349514563106797,794,45,839,0.3873659117997616
2017-18,RegularSeason,203078,7,Bradley Beal,1610612764,WAS,82,2977,683,1484,0.46,199,530,0.375,292,369,0.791,61,302,363,373,96,36,214,160,1857,1633,1.74,0.45,2017,18,22.646341463414632,1.7429906542056075,801,77,878,0.4134396355353075
2017-18,RegularSeason,201942,8,DeMar DeRozan,1610612761,TOR,80,2712,645,1413,0.456,89,287,0.31,461,559,0.825,59,256,315,417,85,22,175,151,1840,1638,2.38,0.49,2017,18,23.0,2.382857142857143,768,98,866,0.36374133949191684
2017-18,RegularSeason,201142,9,Kevin Durant,1610612744,GSW,68,2325,630,1222,0.516,173,413,0.419,359,404,0.889,31,433,464,366,50,119,207,133,1792,1947,1.77,0.24,2017,18,26.352941176470587,1.7681159420289856,592,45,637,0.728414442700157
2017-18,RegularSeason,101150,10,Lou Williams,1610612746,LAC,79,2589,582,1337,0.435,186,518,0.359,432,491,0.88,40,158,198,417,85,19,234,106,1782,1453,1.78,0.36,2017,18,22.556962025316455,1.7820512820512822,755,59,814,0.24324324324324326
2017-18,RegularSeason,202689,11,Kemba Walker,1610612766,CHA,80,2736,588,1363,0.431,231,601,0.384,363,420,0.864,32,216,248,444,91,24,179,98,1770,1566,2.48,0.51,2017,18,22.125,2.4804469273743015,775,57,832,0.2980769230769231
2017-18,RegularSeason,1626157,12,Karl-Anthony Towns,1610612750,MIN,82,2918,639,1172,0.545,120,285,0.421,345,402,0.858,238,774,1012,199,64,115,159,285,1743,2384,1.25,0.4,2017,18,21.25609756097561,1.251572327044025,533,57,590,1.7152542372881356
2017-18,RegularSeason,200746,13,LaMarcus Aldridge,1610612759,SAS,75,2509,687,1347,0.51,27,92,0.293,334,399,0.837,246,389,635,152,43,90,111,161,1735,1819,1.37,0.39,2017,18,23.133333333333333,1.3693693693693694,660,65,725,0.8758620689655172
2017-18,RegularSeason,203506,13,Victor Oladipo,1610612754,IND,75,2552,640,1342,0.477,161,434,0.371,294,368,0.799,47,343,390,323,177,57,219,175,1735,1687,1.48,0.81,2017,18,23.133333333333333,1.4748858447488584,702,74,776,0.5025773195876289
2017-18,RegularSeason,202331,15,Paul George,1610612760,OKC,79,2891,576,1340,0.43,244,609,0.401,338,411,0.822,72,375,447,263,161,39,212,233,1734,1595,1.24,0.76,2017,18,21.949367088607595,1.240566037735849,764,73,837,0.5340501792114696
2017-18,RegularSeason,203468,16,CJ McCollum,1610612757,POR,81,2924,667,1505,0.443,189,476,0.397,209,250,0.836,53,268,321,272,77,35,151,168,1732,1407,1.8,0.51,2017,18,21.382716049382715,1.8013245033112584,838,41,879,0.3651877133105802
2017-18,RegularSeason,203114,17,Khris Middleton,1610612749,MIL,82,2982,593,1272,0.466,146,407,0.359,320,362,0.884,45,384,429,328,119,21,191,270,1652,1637,1.72,0.62,2017,18,20.146341463414632,1.7172774869109948,679,42,721,0.59500693481276
2017-18,RegularSeason,1628378,18,Donovan Mitchell,1610612762,UTA,79,2638,595,1362,0.437,187,550,0.34,239,297,0.805,52,244,296,291,118,27,215,213,1616,1308,1.35,0.55,2017,18,20.455696202531644,1.3534883720930233,767,58,825,0.35878787878787877
2017-18,RegularSeason,201950,19,Jrue Holiday,1610612740,NOP,81,2927,615,1244,0.494,120,356,0.337,187,238,0.786,62,303,365,486,123,64,213,201,1537,1682,2.28,0.58,2017,18,18.97530864197531,2.2816901408450705,629,51,680,0.5367647058823529
2017-18,RegularSeason,202699,20,Tobias Harris,1610612746,LAC,80,2668,562,1221,0.46,183,445,0.411,179,216,0.829,58,379,437,192,71,35,105,164,1486,1420,1.83,0.68,2017,18,18.575,1.8285714285714285,659,37,696,0.6278735632183908
2017-18,RegularSeason,202681,21,Kyrie Irving,1610612738,BOS,60,1931,534,1087,0.491,166,407,0.408,232,261,0.889,33,194,227,306,65,17,139,122,1466,1360,2.2,0.47,2017,18,24.433333333333334,2.2014388489208634,553,29,582,0.3900343642611684
2017-18,RegularSeason,202691,22,Klay Thompson,1610612744,GSW,73,2504,575,1177,0.489,229,520,0.44,82,98,0.837,31,246,277,185,55,34,128,117,1461,1266,1.45,0.43,2017,18,20.013698630136986,1.4453125,602,16,618,0.4482200647249191
2017-18,RegularSeason,203952,23,Andrew Wiggins,1610612750,MIN,82,2979,569,1300,0.438,112,338,0.331,202,314,0.643,82,276,358,160,91,51,138,163,1452,1131,1.16,0.66,2017,18,17.70731707317073,1.1594202898550725,731,112,843,0.4246737841043891
2017-18,RegularSeason,203084,23,Harrison Barnes,1610612742,DAL,77,2634,537,1208,0.445,119,333,0.357,259,313,0.827,77,391,468,152,49,14,118,94,1452,1292,1.29,0.41,2017,18,18.857142857142858,1.2881355932203389,671,54,725,0.6455172413793103
2017-18,RegularSeason,203954,25,Joel Embiid,1610612755,PHI,63,1912,510,1056,0.483,66,214,0.308,359,467,0.769,143,547,690,199,40,111,234,209,1445,1597,0.85,0.17,2017,18,22.936507936507937,0.8504273504273504,546,108,654,1.055045871559633
2017-18,RegularSeason,203999,26,Nikola Jokic,1610612743,DEN,75,2443,504,1010,0.499,111,280,0.396,266,313,0.85,195,608,803,458,90,61,210,212,1385,2034,2.18,0.43,2017,18,18.466666666666665,2.1809523809523808,506,47,553,1.4520795660036165
2017-18,RegularSeason,1627750,27,Jamal Murray,1610612743,DEN,81,2565,479,1062,0.451,165,436,0.378,229,253,0.905,82,215,297,274,79,28,172,173,1352,1251,1.59,0.46,2017,18,16.691358024691358,1.5930232558139534,583,24,607,0.48929159802306427
2017-18,RegularSeason,2730,28,Dwight Howard,1610612766,CHA,81,2463,506,911,0.555,1,7,0.143,334,582,0.574,255,757,1012,105,48,131,208,249,1347,1782,0.51,0.23,2017,18,16.62962962962963,0.5048076923076923,405,248,653,1.549770290964778
2017-18,RegularSeason,1626164,29,Devin Booker,1610612756,PHX,54,1865,455,1054,0.432,147,384,0.383,289,329,0.878,26,218,244,253,47,14,194,168,1346,1071,1.3,0.24,2017,18,24.925925925925927,1.3041237113402062,599,40,639,0.38184663536776214
2017-18,RegularSeason,201939,29,Stephen Curry,1610612744,GSW,51,1631,428,864,0.495,212,501,0.423,278,302,0.921,36,225,261,310,80,8,153,114,1346,1392,2.03,0.52,2017,18,26.392156862745097,2.026143790849673,436,24,460,0.5673913043478261
2017-18,RegularSeason,203944,31,Julius Randle,1610612747,LAL,82,2190,504,904,0.558,10,45,0.222,305,425,0.718,181,473,654,210,43,45,213,274,1323,1542,0.99,0.2,2017,18,16.134146341463413,0.9859154929577465,400,120,520,1.2576923076923077
2017-18,RegularSeason,202339,32,Eric Bledsoe,1610612749,MIL,74,2322,468,989,0.473,125,360,0.347,252,317,0.795,51,233,284,370,149,42,216,185,1313,1356,1.71,0.69,2017,18,17.743243243243242,1.712962962962963,521,65,586,0.48464163822525597
2017-18,RegularSeason,202710,33,Jimmy Butler,1610612750,MIN,59,2164,437,921,0.474,70,200,0.35,363,425,0.854,79,235,314,288,116,24,108,78,1307,1395,2.67,1.07,2017,18,22.152542372881356,2.6666666666666665,484,62,546,0.575091575091575
2017-18,RegularSeason,203471,34,Dennis Schroder,1610612737,ATL,67,2078,500,1146,0.436,76,262,0.29,225,265,0.849,44,164,208,417,72,6,183,147,1301,1135,2.28,0.39,2017,18,19.417910447761194,2.278688524590164,646,40,686,0.3032069970845481
2017-18,RegularSeason,201609,35,Goran Dragic,1610612748,MIA,75,2378,484,1075,0.45,111,300,0.37,217,271,0.801,54,252,306,359,63,12,166,180,1296,1225,2.16,0.38,2017,18,17.28,2.1626506024096384,591,54,645,0.4744186046511628
2017-18,RegularSeason,1627732,36,Ben Simmons,1610612755,PHI,81,2732,544,998,0.545,0,11,0.0,191,341,0.56,145,514,659,661,140,70,278,211,1279,1927,2.38,0.5,2017,18,15.790123456790123,2.3776978417266186,454,150,604,1.0910596026490067
2017-18,RegularSeason,203933,37,T.J. Warren,1610612756,PHX,65,2142,529,1063,0.498,20,90,0.222,193,255,0.757,125,208,333,85,65,41,85,149,1271,1114,1.0,0.77,2017,18,19.553846153846155,1.0,534,62,596,0.5587248322147651
2017-18,RegularSeason,203115,38,Will Barton,1610612743,DEN,81,2683,465,1028,0.452,156,422,0.37,182,226,0.805,70,339,409,331,82,52,149,168,1268,1386,2.22,0.55,2017,18,15.654320987654321,2.221476510067114,563,44,607,0.6738056013179572
2017-18,RegularSeason,200768,39,Kyle Lowry,1610612761,TOR,78,2510,403,944,0.427,238,596,0.399,223,261,0.854,66,368,434,537,85,19,183,192,1267,1580,2.93,0.46,2017,18,16.243589743589745,2.9344262295081966,541,38,579,0.7495682210708118
2017-18,RegularSeason,2546,40,Carmelo Anthony,1610612760,OKC,78,2501,472,1168,0.404,169,474,0.357,148,193,0.767,67,386,453,103,47,49,99,197,1261,1073,1.04,0.47,2017,18,16.166666666666668,1.0404040404040404,696,45,741,0.611336032388664
2017-18,RegularSeason,201188,41,Marc Gasol,1610612763,MEM,73,2408,434,1033,0.42,109,320,0.341,281,337,0.834,78,514,592,305,54,101,194,185,1258,1461,1.57,0.28,2017,18,17.232876712328768,1.5721649484536082,599,56,655,0.9038167938931297
2017-18,RegularSeason,201569,42,Eric Gordon,1610612745,HOU,69,2154,415,970,0.428,218,608,0.359,195,241,0.809,25,145,170,154,44,27,130,116,1243,907,1.19,0.34,2017,18,18.014492753623188,1.1846153846153846,555,46,601,0.28286189683860236
2017-18,RegularSeason,201933,43,Blake Griffin,1610612765,DET,58,1970,436,996,0.438,111,322,0.345,259,330,0.785,73,355,428,334,40,18,165,139,1242,1266,2.02,0.24,2017,18,21.413793103448278,2.0242424242424244,560,71,631,0.6782884310618067
2017-18,RegularSeason,1628398,43,Kyle Kuzma,1610612747,LAL,77,2401,468,1039,0.45,159,434,0.366,147,208,0.707,88,395,483,141,49,34,140,160,1242,1177,1.01,0.35,2017,18,16.12987012987013,1.0071428571428571,571,61,632,0.7642405063291139
2017-18,RegularSeason,202326,45,DeMarcus Cousins,1610612740,NOP,48,1737,406,864,0.47,104,294,0.354,294,394,0.746,105,512,617,257,79,76,242,183,1210,1439,1.06,0.33,2017,18,25.208333333333332,1.06198347107438,458,100,558,1.1057347670250897
2017-18,RegularSeason,200755,46,JJ Redick,1610612755,PHI,70,2116,404,879,0.46,193,460,0.42,197,218,0.904,9,169,178,210,35,6,103,123,1198,1028,2.04,0.34,2017,18,17.114285714285714,2.0388349514563107,475,21,496,0.3588709677419355
2017-18,RegularSeason,203083,47,Andre Drummond,1610612765,DET,78,2625,466,881,0.529,0,11,0.0,239,395,0.605,399,848,1247,237,114,127,200,250,1171,2125,1.19,0.57,2017,18,15.012820512820513,1.185,415,156,571,2.183887915936953
2017-18,RegularSeason,203914,48,Gary Harris,1610612743,DEN,67,2305,440,908,0.485,156,394,0.396,134,162,0.827,37,139,176,194,122,15,119,119,1170,1062,1.63,1.02,2017,18,17.46268656716418,1.6302521008403361,468,28,496,0.3548387096774194
2017-18,RegularSeason,1627752,49,Taurean Prince,1610612737,ATL,82,2464,415,975,0.426,176,457,0.385,152,180,0.844,50,339,389,214,85,42,191,168,1158,1109,1.12,0.45,2017,18,14.121951219512194,1.1204188481675392,560,28,588,0.6615646258503401
2017-18,RegularSeason,202711,50,Bojan Bogdanovic,1610612754,IND,80,2465,404,852,0.474,155,386,0.402,178,205,0.868,30,240,270,119,55,8,106,129,1141,1012,1.12,0.52,2017,18,14.2625,1.1226415094339623,448,27,475,0.5684210526315789
2017-18,RegularSeason,203967,50,Dario Saric,1610612755,PHI,78,2310,403,890,0.453,157,399,0.393,178,207,0.86,154,366,520,202,51,20,148,160,1141,1270,1.36,0.34,2017,18,14.628205128205128,1.364864864864865,487,29,516,1.0077519379844961
2017-18,RegularSeason,203490,52,Otto Porter Jr.,1610612764,WAS,77,2432,445,885,0.503,138,313,0.441,106,128,0.828,103,389,492,157,116,41,75,151,1134,1403,2.09,1.55,2017,18,14.727272727272727,2.0933333333333333,440,22,462,1.0649350649350648
2017-18,RegularSeason,203994,53,Jusuf Nurkic,1610612757,POR,79,2088,480,951,0.505,0,7,0.0,172,273,0.63,189,519,708,143,64,111,183,247,1132,1403,0.78,0.35,2017,18,14.329113924050633,0.7814207650273224,471,101,572,1.2377622377622377
2017-18,RegularSeason,203903,54,Jordan Clarkson,1610612739,CLE,81,1887,430,954,0.451,112,318,0.352,152,190,0.8,57,160,217,221,58,6,127,107,1124,937,1.74,0.46,2017,18,13.876543209876543,1.7401574803149606,524,38,562,0.3861209964412811
2017-18,RegularSeason,1628369,55,Jayson Tatum,1610612738,BOS,80,2443,397,835,0.475,105,242,0.434,213,258,0.826,50,352,402,128,83,58,114,170,1112,1186,1.12,0.73,2017,18,13.9,1.1228070175438596,438,45,483,0.8322981366459627
2017-18,RegularSeason,204001,56,Kristaps Porzingis,1610612752,NYK,48,1553,390,889,0.439,90,228,0.395,218,275,0.793,62,254,316,57,36,115,93,141,1088,963,0.61,0.39,2017,18,22.666666666666668,0.6129032258064516,499,57,556,0.5683453237410072
2017-18,RegularSeason,101108,57,Chris Paul,1610612745,HOU,58,1847,367,798,0.46,144,379,0.38,203,221,0.919,37,276,313,457,96,14,128,141,1081,1384,3.57,0.75,2017,18,18.637931034482758,3.5703125,431,18,449,0.6971046770601337
2017-18,RegularSeason,1627741,58,Buddy Hield,1610612758,SAC,80,2024,416,933,0.446,176,408,0.431,71,81,0.877,55,252,307,155,85,22,124,148,1079,997,1.25,0.69,2017,18,13.4875,1.25,517,10,527,0.5825426944971537
2017-18,RegularSeason,203500,59,Steven Adams,1610612760,OKC,76,2487,448,712,0.629,0,2,0.0,160,286,0.559,384,301,685,88,92,78,128,215,1056,1481,0.69,0.72,2017,18,13.894736842105264,0.6875,264,126,390,1.7564102564102564
2017-18,RegularSeason,1628372,60,Dennis Smith Jr.,1610612742,DAL,69,2049,404,1024,0.395,106,339,0.313,134,193,0.694,50,210,260,358,71,18,194,152,1048,882,1.84,0.37,2017,18,15.18840579710145,1.8453608247422681,620,59,679,0.38291605301914583
2017-18,RegularSeason,1626196,61,Josh Richardson,1610612748,MIA,81,2690,399,885,0.451,127,336,0.378,120,142,0.845,69,216,285,231,121,75,140,199,1045,1109,1.65,0.86,2017,18,12.901234567901234,1.65,486,22,508,0.5610236220472441
2017-18,RegularSeason,201567,62,Kevin Love,1610612739,CLE,59,1651,334,729,0.458,137,330,0.415,234,266,0.88,101,445,546,103,43,24,90,120,1039,1238,1.14,0.48,2017,18,17.610169491525422,1.1444444444444444,395,32,427,1.278688524590164
2017-18,RegularSeason,203087,63,Jeremy Lamb,1610612766,CHA,80,1967,380,832,0.457,94,254,0.37,179,208,0.861,49,275,324,186,61,32,93,138,1033,1062,2.0,0.66,2017,18,12.9125,2.0,452,29,481,0.6735966735966736
2017-18,RegularSeason,1628374,63,Lauri Markkanen,1610612741,CHI,68,2020,374,862,0.434,145,401,0.362,140,166,0.843,79,429,508,79,39,40,83,103,1033,1102,0.95,0.47,2017,18,15.191176470588236,0.9518072289156626,488,26,514,0.9883268482490273
2017-18,RegularSeason,203991,65,Clint Capela,1610612745,HOU,74,2034,441,676,0.652,0,1,0.0,144,257,0.56,241,561,802,68,58,137,103,185,1026,1640,0.66,0.56,2017,18,13.864864864864865,0.6601941747572816,235,113,348,2.3045977011494254
2017-18,RegularSeason,203932,66,Aaron Gordon,1610612753,ORL,58,1909,375,865,0.434,115,342,0.336,157,225,0.698,87,370,457,136,59,45,107,111,1022,1054,1.27,0.55,2017,18,17.620689655172413,1.2710280373831775,490,68,558,0.8189964157706093
2017-18,RegularSeason,202734,66,E'Twaun Moore,1610612740,NOP,82,2586,423,832,0.508,128,301,0.425,48,68,0.706,57,181,238,187,79,12,102,182,1022,1007,1.83,0.78,2017,18,12.463414634146341,1.8333333333333333,409,20,429,0.5547785547785548
2017-18,RegularSeason,1627759,68,Jaylen Brown,1610612738,BOS,70,2152,373,803,0.465,121,306,0.395,150,233,0.644,66,280,346,114,70,26,124,181,1017,936,0.92,0.56,2017,18,14.528571428571428,0.9193548387096774,430,83,513,0.6744639376218323
2017-18,RegularSeason,203095,69,Evan Fournier,1610612753,ORL,57,1837,368,802,0.459,127,335,0.379,150,173,0.867,23,157,180,165,47,16,95,138,1013,869,1.74,0.49,2017,18,17.771929824561404,1.736842105263158,434,23,457,0.3938730853391685
2017-18,RegularSeason,1628367,70,Josh Jackson,1610612756,PHX,77,1959,389,932,0.417,57,217,0.263,177,279,0.634,95,256,351,119,80,35,146,218,1012,806,0.81,0.55,2017,18,13.142857142857142,0.815068493150685,543,102,645,0.5441860465116279
2017-18,RegularSeason,201936,71,Tyreke Evans,1610612763,MEM,52,1607,366,809,0.452,114,286,0.399,164,209,0.785,44,221,265,269,57,17,117,96,1010,1013,2.3,0.49,2017,18,19.423076923076923,2.299145299145299,443,45,488,0.5430327868852459
2017-18,RegularSeason,203496,72,Robert Covington,1610612755,PHI,80,2531,345,836,0.413,203,550,0.369,116,136,0.853,55,378,433,156,137,72,126,238,1009,1170,1.24,1.09,2017,18,12.6125,1.2380952380952381,491,20,511,0.8473581213307241
2017-18,RegularSeason,201937,73,Ricky Rubio,1610612762,UTA,77,2254,346,827,0.418,96,273,0.352,220,254,0.866,44,307,351,410,121,11,207,206,1008,1179,1.98,0.58,2017,18,13.090909090909092,1.9806763285024154,481,34,515,0.6815533980582524
2017-18,RegularSeason,203915,74,Spencer Dinwiddie,1610612751,BKN,80,2306,324,838,0.387,141,433,0.326,218,268,0.813,40,219,259,524,68,23,128,186,1007,1189,4.09,0.53,2017,18,12.5875,4.09375,514,50,564,0.4592198581560284
2017-18,RegularSeason,202683,75,Enes Freedom,1610612752,NYK,71,1830,422,713,0.592,0,2,0.0,156,184,0.848,273,507,780,105,36,37,122,187,1000,1517,0.86,0.29,2017,18,14.084507042253522,0.860655737704918,291,28,319,2.445141065830721
2017-18,RegularSeason,201959,76,Taj Gibson,1610612750,MIN,82,2726,425,737,0.577,7,35,0.2,142,185,0.768,194,390,584,99,62,59,89,218,999,1359,1.11,0.7,2017,18,12.182926829268293,1.1123595505617978,312,43,355,1.6450704225352113
2017-18,RegularSeason,203501,77,Tim Hardaway Jr.,1610612752,NYK,57,1885,360,856,0.421,130,410,0.317,146,179,0.816,32,192,224,155,62,10,92,123,996,826,1.69,0.67,2017,18,17.473684210526315,1.684782608695652,496,33,529,0.42344045368620037
2017-18,RegularSeason,201952,78,Jeff Teague,1610612750,MIN,70,2311,354,794,0.446,84,228,0.368,202,239,0.845,24,185,209,492,102,23,177,171,994,1166,2.78,0.58,2017,18,14.2,2.7796610169491527,440,37,477,0.4381551362683438
2017-18,RegularSeason,203484,79,Kentavious Caldwell-Pope,1610612747,LAL,74,2458,340,798,0.426,159,415,0.383,153,194,0.789,60,327,387,162,106,16,97,145,992,1067,1.67,1.09,2017,18,13.405405405405405,1.6701030927835052,458,41,499,0.7755511022044088
2017-18,RegularSeason,203459,80,Allen Crabbe,1610612751,BKN,75,2197,337,827,0.407,201,532,0.378,115,135,0.852,28,296,324,117,47,35,78,168,990,925,1.5,0.6,2017,18,13.2,1.5,490,20,510,0.6352941176470588
2017-18,RegularSeason,201960,81,DeMarre Carroll,1610612751,BKN,73,2180,325,785,0.414,145,391,0.371,188,246,0.764,105,374,479,147,59,30,103,165,983,1077,1.43,0.57,2017,18,13.465753424657533,1.4271844660194175,460,58,518,0.9247104247104247
2017-18,RegularSeason,202685,82,Jonas Valanciunas,1610612761,TOR,77,1727,390,687,0.568,30,74,0.405,170,211,0.806,183,477,660,81,29,69,115,192,980,1366,0.7,0.25,2017,18,12.727272727272727,0.7043478260869566,297,41,338,1.952662721893491
2017-18,RegularSeason,201563,83,Michael Beasley,1610612752,NYK,74,1653,409,807,0.507,34,86,0.395,124,159,0.78,97,317,414,123,36,43,143,145,976,1016,0.86,0.25,2017,18,13.18918918918919,0.8601398601398601,398,35,433,0.9561200923787528
2017-18,RegularSeason,201158,84,Marco Belinelli,1610612755,PHI,80,1947,337,764,0.441,149,395,0.377,148,163,0.908,20,131,151,148,66,12,94,91,971,812,1.57,0.7,2017,18,12.1375,1.574468085106383,427,15,442,0.3416289592760181
2017-18,RegularSeason,1626171,85,Bobby Portis,1610612741,CHI,73,1643,382,811,0.471,80,223,0.359,120,156,0.769,159,339,498,123,50,23,103,130,964,1090,1.19,0.48,2017,18,13.205479452054794,1.1941747572815533,429,36,465,1.070967741935484
2017-18,RegularSeason,203613,86,Jonathon Simmons,1610612753,ORL,69,2029,354,761,0.465,69,204,0.338,185,241,0.768,61,178,239,171,58,16,146,175,962,837,1.17,0.4,2017,18,13.942028985507246,1.1712328767123288,407,56,463,0.5161987041036717
2017-18,RegularSeason,201572,87,Brook Lopez,1610612747,LAL,74,1735,369,793,0.465,112,325,0.345,111,158,0.703,74,220,294,126,30,98,98,195,961,940,1.29,0.31,2017,18,12.986486486486486,1.2857142857142858,424,47,471,0.6242038216560509
2017-18,RegularSeason,201586,88,Serge Ibaka,1610612761,TOR,76,2093,379,784,0.483,107,297,0.36,94,118,0.797,78,400,478,62,29,99,90,209,959,1108,0.69,0.32,2017,18,12.618421052631579,0.6888888888888889,405,24,429,1.1142191142191142
2017-18,RegularSeason,201152,89,Thaddeus Young,1610612754,IND,81,2607,421,864,0.487,58,181,0.32,55,92,0.598,184,328,512,152,135,36,105,175,955,1205,1.45,1.29,2017,18,11.790123456790123,1.4476190476190476,443,37,480,1.0666666666666667
2017-18,RegularSeason,1626162,90,Kelly Oubre Jr.,1610612764,WAS,81,2231,318,790,0.403,126,369,0.341,191,233,0.82,59,304,363,98,80,35,90,234,953,925,1.09,0.89,2017,18,11.765432098765432,1.0888888888888888,472,42,514,0.7062256809338522
2017-18,RegularSeason,1627742,91,Brandon Ingram,1610612747,LAL,59,1975,358,761,0.47,41,105,0.39,192,282,0.681,57,257,314,230,45,43,149,163,949,939,1.54,0.3,2017,18,16.084745762711865,1.5436241610738255,403,90,493,0.6369168356997972
2017-18,RegularSeason,1626178,92,Rondae Hollis-Jefferson,1610612751,BKN,68,1921,342,724,0.472,13,54,0.241,249,316,0.788,101,358,459,167,65,48,121,145,946,1115,1.38,0.54,2017,18,13.911764705882353,1.3801652892561984,382,67,449,1.022271714922049
2017-18,RegularSeason,202324,93,Derrick Favors,1610612762,UTA,77,2153,395,702,0.563,14,63,0.222,140,215,0.651,198,354,552,102,54,82,88,164,944,1264,1.16,0.61,2017,18,12.25974025974026,1.1590909090909092,307,75,382,1.4450261780104712
2017-18,RegularSeason,204060,94,Joe Ingles,1610612762,UTA,82,2579,335,718,0.467,204,464,0.44,66,83,0.795,24,320,344,392,90,20,159,178,940,1227,2.46,0.57,2017,18,11.463414634146341,2.4654088050314464,383,17,400,0.86
2017-18,RegularSeason,202696,95,Nikola Vucevic,1610612753,ORL,57,1683,399,840,0.475,64,204,0.314,77,94,0.819,101,422,523,191,56,62,109,144,939,1204,1.75,0.51,2017,18,16.473684210526315,1.7522935779816513,441,17,458,1.1419213973799127
2017-18,RegularSeason,1626161,96,Willie Cauley-Stein,1610612758,SAC,73,2044,388,773,0.502,3,12,0.25,153,247,0.619,131,379,510,172,77,67,109,185,932,1170,1.58,0.71,2017,18,12.767123287671232,1.5779816513761469,385,94,479,1.0647181628392484
2017-18,RegularSeason,201143,97,Al Horford,1610612738,BOS,72,2277,368,753,0.489,97,226,0.429,94,120,0.783,103,428,531,339,43,78,132,138,927,1375,2.57,0.33,2017,18,12.875,2.5681818181818183,385,26,411,1.2919708029197081
2017-18,RegularSeason,201599,97,DeAndre Jordan,1610612746,LAC,77,2423,373,578,0.645,0,0,0.0,181,312,0.58,329,842,1171,117,39,70,137,203,927,1851,0.85,0.28,2017,18,12.03896103896104,0.8540145985401459,205,131,336,3.4851190476190474
2017-18,RegularSeason,1717,97,Dirk Nowitzki,1610612742,DAL,77,1900,346,758,0.456,138,337,0.409,97,108,0.898,22,416,438,120,43,45,51,146,927,1099,2.35,0.84,2017,18,12.03896103896104,2.3529411764705883,412,11,423,1.0354609929078014
2017-18,RegularSeason,203085,100,Austin Rivers,1610612746,LAC,61,2057,341,805,0.424,136,360,0.378,102,159,0.642,27,118,145,242,74,16,109,152,920,767,2.22,0.68,2017,18,15.081967213114755,2.220183486238532,464,57,521,0.2783109404990403
2017-18,RegularSeason,203992,101,Bogdan Bogdanovic,1610612758,SAC,78,2175,344,772,0.446,129,329,0.392,100,119,0.84,31,192,223,258,72,16,125,172,917,914,2.06,0.58,2017,18,11.756410256410257,2.064,428,19,447,0.4988814317673378
2017-18,RegularSeason,201584,102,Courtney Lee,1610612752,NYK,76,2310,343,755,0.454,113,278,0.406,114,124,0.919,30,194,224,180,80,17,84,109,913,908,2.14,0.95,2017,18,12.013157894736842,2.142857142857143,412,10,422,0.5308056872037915
2017-18,RegularSeason,1626179,103,Terry Rozier,1610612738,BOS,80,2068,316,800,0.395,153,402,0.381,115,149,0.772,63,313,376,232,80,19,80,123,900,1009,2.9,1.0,2017,18,11.25,2.9,484,34,518,0.7258687258687259
2017-18,RegularSeason,1628415,104,Dillon Brooks,1610612763,MEM,82,2350,340,772,0.44,94,264,0.356,124,166,0.747,49,208,257,135,73,17,124,233,898,782,1.09,0.59,2017,18,10.951219512195122,1.0887096774193548,432,42,474,0.5421940928270043
2017-18,RegularSeason,202397,105,Ish Smith,1610612765,DET,82,2043,389,801,0.486,35,101,0.347,81,116,0.698,27,197,224,360,64,20,108,140,894,1007,3.33,0.59,2017,18,10.902439024390244,3.3333333333333335,412,35,447,0.5011185682326622
2017-18,RegularSeason,203918,106,Rodney Hood,1610612739,CLE,60,1616,322,751,0.429,127,333,0.381,111,129,0.86,22,143,165,95,45,12,70,105,882,682,1.36,0.64,2017,18,14.7,1.3571428571428572,429,18,447,0.3691275167785235
2017-18,RegularSeason,203200,107,Justin Holiday,1610612741,CHI,72,2265,290,782,0.371,161,449,0.359,135,164,0.823,31,260,291,153,80,31,93,134,876,817,1.65,0.86,2017,18,12.166666666666666,1.6451612903225807,492,29,521,0.5585412667946257
2017-18,RegularSeason,1626163,108,Frank Kaminsky,1610612766,CHA,79,1835,307,716,0.429,104,274,0.38,155,194,0.799,46,242,288,129,36,19,66,95,873,831,1.96,0.55,2017,18,11.050632911392405,1.9545454545454546,409,39,448,0.6428571428571429
2017-18,RegularSeason,203482,109,Kelly Olynyk,1610612748,MIA,76,1779,316,636,0.497,106,280,0.379,134,174,0.77,89,342,431,207,62,35,147,222,872,1100,1.41,0.42,2017,18,11.473684210526315,1.4081632653061225,320,40,360,1.1972222222222222
2017-18,RegularSeason,201961,110,Wayne Ellington,1610612748,MIA,77,2041,285,700,0.407,227,579,0.392,67,78,0.859,23,195,218,79,53,8,52,94,864,744,1.52,1.02,2017,18,11.220779220779221,1.5192307692307692,415,11,426,0.5117370892018779
2017-18,RegularSeason,1627734,111,Domantas Sabonis,1610612754,IND,74,1810,340,661,0.514,13,37,0.351,168,224,0.75,165,407,572,151,40,32,137,220,861,1142,1.1,0.29,2017,18,11.635135135135135,1.102189781021898,321,56,377,1.5172413793103448
2017-18,RegularSeason,202703,112,Nikola Mirotic,1610612740,NOP,55,1494,306,684,0.447,135,358,0.377,112,137,0.818,59,346,405,80,44,39,62,108,859,962,1.29,0.71,2017,18,15.618181818181819,1.2903225806451613,378,25,403,1.0049627791563276
2017-18,RegularSeason,1627747,113,Caris LeVert,1610612751,BKN,71,1864,320,735,0.435,85,245,0.347,133,187,0.711,53,207,260,299,82,22,153,159,858,899,1.95,0.54,2017,18,12.084507042253522,1.9542483660130718,415,54,469,0.5543710021321961
2017-18,RegularSeason,2216,114,Zach Randolph,1610612758,SAC,59,1508,361,763,0.473,51,147,0.347,84,107,0.785,97,300,397,127,42,10,116,119,857,892,1.09,0.36,2017,18,14.525423728813559,1.0948275862068966,402,23,425,0.9341176470588235
2017-18,RegularSeason,201954,115,Darren Collison,1610612754,IND,69,2018,316,638,0.495,96,205,0.468,127,144,0.882,37,141,178,368,92,15,86,122,855,1083,4.28,1.07,2017,18,12.391304347826088,4.27906976744186,322,17,339,0.5250737463126843
2017-18,RegularSeason,201145,116,Jeff Green,1610612739,CLE,78,1828,295,618,0.477,53,170,0.312,203,234,0.868,60,186,246,99,41,34,75,149,846,837,1.32,0.55,2017,18,10.846153846153847,1.32,323,31,354,0.6949152542372882
2017-18,RegularSeason,203925,116,Joe Harris,1610612751,BKN,78,1975,305,621,0.491,150,358,0.419,86,104,0.827,51,209,260,128,35,20,91,153,846,864,1.41,0.39,2017,18,10.846153846153847,1.4065934065934067,316,18,334,0.7784431137724551
2017-18,RegularSeason,1628368,118,De'Aaron Fox,1610612758,SAC,73,2026,328,797,0.412,47,153,0.307,141,195,0.723,33,171,204,320,70,20,173,163,844,762,1.85,0.41,2017,18,11.561643835616438,1.8497109826589595,469,54,523,0.390057361376673
2017-18,RegularSeason,204020,119,Tyler Johnson,1610612748,MIA,72,2052,309,711,0.435,119,324,0.367,106,129,0.822,34,214,248,165,60,34,81,148,843,844,2.04,0.74,2017,18,11.708333333333334,2.037037037037037,402,23,425,0.5835294117647059
2017-18,RegularSeason,202693,120,Markieff Morris,1610612764,WAS,73,1968,330,687,0.48,76,207,0.367,105,128,0.82,75,334,409,142,56,38,127,216,841,979,1.12,0.44,2017,18,11.520547945205479,1.1181102362204725,357,23,380,1.0763157894736841
2017-18,RegularSeason,1627812,121,Yogi Ferrell,1610612742,DAL,82,2282,311,730,0.426,134,359,0.373,82,103,0.796,26,223,249,201,64,9,78,153,838,843,2.58,0.82,2017,18,10.21951219512195,2.576923076923077,419,21,440,0.5659090909090909
2017-18,RegularSeason,203145,122,Kent Bazemore,1610612737,ATL,65,1789,284,676,0.42,108,274,0.394,160,201,0.796,25,223,248,228,100,45,157,147,836,867,1.45,0.64,2017,18,12.861538461538462,1.4522292993630572,392,41,433,0.5727482678983834
2017-18,RegularSeason,1626149,122,Montrezl Harrell,1610612746,LAC,76,1293,348,548,0.635,1,7,0.143,139,222,0.626,103,203,306,74,36,52,68,143,836,953,1.09,0.53,2017,18,11.0,1.088235294117647,200,83,283,1.0812720848056536
2017-18,RegularSeason,1626167,124,Myles Turner,1610612754,IND,65,1836,306,639,0.479,56,157,0.357,160,206,0.777,93,324,417,87,38,118,96,186,828,1013,0.91,0.4,2017,18,12.738461538461538,0.90625,333,46,379,1.1002638522427441
2017-18,RegularSeason,2037,125,Jamal Crawford,1610612750,MIN,80,1653,308,742,0.415,104,314,0.331,102,113,0.903,21,78,99,185,40,9,95,85,822,615,1.95,0.42,2017,18,10.275,1.9473684210526316,434,11,445,0.22247191011235956
2017-18,RegularSeason,201988,126,Patty Mills,1610612759,SAS,82,2107,280,682,0.411,154,414,0.372,105,118,0.89,26,128,154,229,55,11,106,128,819,747,2.16,0.52,2017,18,9.987804878048781,2.160377358490566,402,13,415,0.3710843373493976
2017-18,RegularSeason,202083,127,Wesley Matthews,1610612742,DAL,63,2131,283,697,0.406,153,402,0.381,83,101,0.822,28,170,198,172,76,16,83,140,802,749,2.07,0.92,2017,18,12.73015873015873,2.072289156626506,414,18,432,0.4583333333333333
2017-18,RegularSeason,200826,128,J.J. Barea,1610612742,DAL,69,1603,303,690,0.439,115,313,0.367,80,102,0.784,15,186,201,434,35,3,143,83,801,922,3.04,0.24,2017,18,11.608695652173912,3.034965034965035,387,22,409,0.49144254278728605
2017-18,RegularSeason,203901,129,Elfrid Payton,1610612756,PHX,63,1809,329,667,0.493,30,92,0.326,109,168,0.649,64,210,274,393,83,22,168,147,797,1004,2.34,0.49,2017,18,12.65079365079365,2.3392857142857144,338,59,397,0.690176322418136
2017-18,RegularSeason,202322,129,John Wall,1610612764,WAS,41,1410,280,667,0.42,62,167,0.371,175,241,0.726,22,128,150,393,57,45,158,80,797,831,2.49,0.36,2017,18,19.4390243902439,2.4873417721518987,387,66,453,0.33112582781456956
2017-18,RegularSeason,201949,131,James Johnson,1610612748,MIA,73,1943,309,614,0.503,57,185,0.308,113,162,0.698,61,297,358,280,70,51,141,192,788,1052,1.99,0.5,2017,18,10.794520547945206,1.9858156028368794,305,49,354,1.0112994350282485
2017-18,RegularSeason,1627756,132,Denzel Valentine,1610612741,CHI,77,2095,301,721,0.417,143,370,0.386,38,51,0.745,48,345,393,244,65,11,99,185,783,964,2.46,0.66,2017,18,10.168831168831169,2.4646464646464645,420,13,433,0.9076212471131639
2017-18,RegularSeason,2772,133,Trevor Ariza,1610612745,HOU,67,2269,268,651,0.412,170,462,0.368,76,89,0.854,33,261,294,105,98,13,52,132,782,844,2.02,1.89,2017,18,11.671641791044776,2.019230769230769,383,13,396,0.7424242424242424
2017-18,RegularSeason,1628381,134,John Collins,1610612737,ATL,74,1785,314,545,0.576,16,47,0.34,133,186,0.715,176,365,541,98,47,80,105,215,777,1154,0.93,0.45,2017,18,10.5,0.9333333333333333,231,53,284,1.9049295774647887
2017-18,RegularSeason,2200,135,Pau Gasol,1610612759,SAS,77,1812,287,627,0.458,43,120,0.358,158,209,0.756,129,490,619,238,24,79,108,121,775,1236,2.2,0.22,2017,18,10.064935064935066,2.2037037037037037,340,51,391,1.5831202046035806
2017-18,RegularSeason,203110,136,Draymond Green,1610612744,GSW,70,2287,281,619,0.454,77,256,0.301,134,173,0.775,75,460,535,508,95,91,202,185,773,1423,2.52,0.47,2017,18,11.042857142857143,2.514851485148515,338,39,377,1.4190981432360743
2017-18,RegularSeason,203109,136,Jae Crowder,1610612762,UTA,80,2090,271,671,0.404,110,341,0.323,121,148,0.818,59,216,275,99,64,21,74,187,773,731,1.34,0.86,2017,18,9.6625,1.337837837837838,400,27,427,0.6440281030444965
2017-18,RegularSeason,201571,138,D.J. Augustin,1610612753,ORL,75,1760,244,540,0.452,114,272,0.419,164,189,0.868,30,130,160,287,54,0,123,94,766,823,2.33,0.44,2017,18,10.213333333333333,2.3333333333333335,296,25,321,0.4984423676012461
2017-18,RegularSeason,2548,139,Dwyane Wade,1610612748,MIA,67,1536,299,682,0.438,32,111,0.288,135,189,0.714,50,202,252,228,61,47,140,124,765,776,1.63,0.44,2017,18,11.417910447761194,1.6285714285714286,383,54,437,0.5766590389016019
2017-18,RegularSeason,202362,140,Lance Stephenson,1610612754,IND,82,1850,303,709,0.427,67,232,0.289,84,127,0.661,62,362,424,235,46,17,131,177,757,899,1.79,0.35,2017,18,9.231707317073171,1.7938931297709924,406,43,449,0.9443207126948775
2017-18,RegularSeason,201577,141,Robin Lopez,1610612741,CHI,64,1690,342,645,0.53,4,14,0.286,68,90,0.756,134,156,290,124,14,53,107,109,756,805,1.16,0.13,2017,18,11.8125,1.158878504672897,303,22,325,0.8923076923076924
2017-18,RegularSeason,203497,141,Rudy Gobert,1610612762,UTA,56,1816,276,444,0.622,0,0,0.0,204,299,0.682,165,436,601,80,44,129,107,153,756,1240,0.75,0.41,2017,18,13.5,0.7476635514018691,168,95,263,2.285171102661597
2017-18,RegularSeason,202355,143,Hassan Whiteside,1610612748,MIA,54,1364,312,578,0.54,2,2,1.0,128,182,0.703,174,444,618,54,37,94,92,131,754,1145,0.59,0.4,2017,18,13.962962962962964,0.5869565217391305,266,54,320,1.93125
2017-18,RegularSeason,101141,144,Ersan Ilyasova,1610612755,PHI,69,1730,277,613,0.452,91,253,0.36,105,135,0.778,118,287,405,90,61,26,72,157,750,894,1.25,0.85,2017,18,10.869565217391305,1.25,336,30,366,1.1065573770491803
2017-18,RegularSeason,101107,145,Marvin Williams,1610612766,CHA,78,2006,258,563,0.458,126,305,0.413,102,123,0.829,74,296,370,96,56,38,66,116,744,912,1.46,0.85,2017,18,9.538461538461538,1.4545454545454546,305,21,326,1.1349693251533743
2017-18,RegularSeason,1626156,146,D'Angelo Russell,1610612751,BKN,48,1234,278,672,0.414,90,278,0.324,97,131,0.74,30,159,189,249,36,17,147,93,743,659,1.69,0.24,2017,18,15.479166666666666,1.6938775510204083,394,34,428,0.441588785046729
2017-18,RegularSeason,201587,147,Nicolas Batum,1610612766,CHA,64,1981,270,650,0.415,92,274,0.336,108,130,0.831,57,249,306,349,65,23,131,72,740,950,2.66,0.5,2017,18,11.5625,2.66412213740458,380,22,402,0.7611940298507462
2017-18,RegularSeason,201163,148,Wilson Chandler,1610612743,DEN,74,2346,281,631,0.445,88,246,0.358,88,114,0.772,102,296,398,159,43,39,92,156,738,909,1.73,0.47,2017,18,9.972972972972974,1.7282608695652173,350,26,376,1.0585106382978724
2017-18,RegularSeason,202694,149,Marcus Morris Sr.,1610612738,BOS,54,1442,262,611,0.429,86,234,0.368,124,154,0.805,43,246,289,72,35,12,65,100,734,698,1.11,0.54,2017,18,13.592592592592593,1.1076923076923078,349,30,379,0.762532981530343
2017-18,RegularSeason,1626168,150,Trey Lyles,1610612743,DEN,73,1391,270,550,0.491,83,218,0.381,101,143,0.706,55,292,347,91,30,34,61,111,724,843,1.49,0.49,2017,18,9.917808219178083,1.4918032786885247,280,42,322,1.0776397515527951
2017-18,RegularSeason,1626209,151,Mario Hezonja,1610612753,ORL,75,1657,273,617,0.442,90,267,0.337,86,105,0.819,41,240,281,106,81,31,86,134,722,772,1.23,0.94,2017,18,9.626666666666667,1.2325581395348837,344,19,363,0.7741046831955923
2017-18,RegularSeason,201229,152,Anthony Tolliver,1610612765,DET,79,1757,219,472,0.464,159,365,0.436,106,133,0.797,50,191,241,90,32,21,58,144,703,749,1.55,0.55,2017,18,8.89873417721519,1.5517241379310345,253,27,280,0.8607142857142858
2017-18,RegularSeason,203584,152,Troy Daniels,1610612756,PHX,79,1622,232,575,0.403,183,458,0.4,56,64,0.875,12,115,127,48,26,5,56,137,703,502,0.86,0.46,2017,18,8.89873417721519,0.8571428571428571,343,8,351,0.36182336182336183
2017-18,RegularSeason,101139,154,CJ Miles,1610612761,TOR,70,1337,227,599,0.379,164,454,0.361,81,97,0.835,18,134,152,55,37,21,39,134,699,537,1.41,0.95,2017,18,9.985714285714286,1.4102564102564104,372,16,388,0.3917525773195876
2017-18,RegularSeason,1627739,154,Kris Dunn,1610612741,CHI,52,1525,286,666,0.429,43,134,0.321,84,114,0.737,24,197,221,310,104,27,150,174,699,801,2.07,0.69,2017,18,13.442307692307692,2.066666666666667,380,30,410,0.5390243902439025
2017-18,RegularSeason,203493,156,Reggie Bullock Jr.,1610612765,DET,62,1732,267,546,0.489,125,281,0.445,39,49,0.796,27,127,154,95,47,13,47,70,698,671,2.02,1.0,2017,18,11.258064516129032,2.021276595744681,279,10,289,0.532871972318339
2017-18,RegularSeason,101162,157,Marcin Gortat,1610612764,WAS,82,2074,290,560,0.518,0,0,0.0,110,163,0.675,181,442,623,151,40,61,99,175,690,1143,1.52,0.4,2017,18,8.414634146341463,1.5252525252525253,270,53,323,1.9287925696594428
2017-18,RegularSeason,203924,158,Jerami Grant,1610612760,OKC,81,1647,244,456,0.535,32,110,0.291,162,240,0.675,86,233,319,57,31,77,54,155,682,822,1.06,0.57,2017,18,8.419753086419753,1.0555555555555556,212,78,290,1.1
2017-18,RegularSeason,203077,159,Michael Kidd-Gilchrist,1610612766,CHA,74,1850,282,560,0.504,0,2,0.0,117,171,0.684,84,218,302,71,51,32,53,143,681,752,1.34,0.96,2017,18,9.202702702702704,1.3396226415094339,278,54,332,0.9096385542168675
2017-18,RegularSeason,2594,160,Kyle Korver,1610612739,CLE,73,1574,222,484,0.459,164,376,0.436,64,72,0.889,9,156,165,88,31,27,55,130,672,658,1.6,0.56,2017,18,9.205479452054794,1.6,262,8,270,0.6111111111111112
2017-18,RegularSeason,203939,161,Dwight Powell,1610612742,DAL,79,1672,255,430,0.593,28,84,0.333,133,185,0.719,135,309,444,91,67,32,59,186,671,1019,1.54,1.14,2017,18,8.49367088607595,1.5423728813559323,175,52,227,1.9559471365638768
2017-18,RegularSeason,203118,162,Mike Scott,1610612764,WAS,76,1406,276,524,0.527,66,163,0.405,50,76,0.658,50,197,247,80,23,10,79,148,668,675,1.01,0.29,2017,18,8.789473684210526,1.0126582278481013,248,26,274,0.9014598540145985
2017-18,RegularSeason,201588,163,George Hill,1610612739,CLE,67,1812,236,513,0.46,85,205,0.415,110,140,0.786,42,139,181,186,61,27,88,128,667,727,2.11,0.69,2017,18,9.955223880597014,2.1136363636363638,277,30,307,0.5895765472312704
2017-18,RegularSeason,203089,164,John Henson,1610612749,MIL,76,1969,287,502,0.572,1,7,0.143,90,158,0.57,150,363,513,114,45,109,84,202,665,1079,1.36,0.54,2017,18,8.75,1.3571428571428572,215,68,283,1.812720848056537
2017-18,RegularSeason,2747,165,JR Smith,1610612739,CLE,80,2244,240,595,0.403,143,381,0.375,39,56,0.696,29,206,235,141,68,11,81,161,662,664,1.74,0.84,2017,18,8.275,1.7407407407407407,355,17,372,0.6317204301075269
2017-18,RegularSeason,202340,166,Avery Bradley,1610612746,LAC,46,1433,259,625,0.414,75,203,0.369,63,82,0.768,22,94,116,94,51,8,101,92,656,439,0.93,0.51,2017,18,14.26086956521739,0.9306930693069307,366,19,385,0.3012987012987013
2017-18,RegularSeason,1627832,166,Fred VanVleet,1610612761,TOR,76,1520,232,545,0.426,108,261,0.414,84,101,0.832,25,159,184,243,68,19,74,130,656,766,3.28,0.92,2017,18,8.631578947368421,3.2837837837837838,313,17,330,0.5575757575757576
2017-18,RegularSeason,202704,166,Reggie Jackson,1610612765,DET,45,1201,246,577,0.426,52,169,0.308,112,134,0.836,29,96,125,238,27,4,99,87,656,598,2.4,0.27,2017,18,14.577777777777778,2.404040404040404,331,22,353,0.35410764872521244
2017-18,RegularSeason,200752,169,Rudy Gay,1610612759,SAS,57,1231,253,537,0.471,37,118,0.314,112,145,0.772,76,215,291,73,46,38,78,98,655,708,0.94,0.59,2017,18,11.491228070175438,0.9358974358974359,284,33,317,0.917981072555205
2017-18,RegularSeason,1627749,170,Dejounte Murray,1610612759,SAS,81,1743,270,609,0.443,9,34,0.265,105,148,0.709,110,349,459,231,97,31,134,151,654,956,1.72,0.72,2017,18,8.074074074074074,1.7238805970149254,339,43,382,1.2015706806282722
2017-18,RegularSeason,202709,171,Cory Joseph,1610612754,IND,82,2210,256,604,0.424,67,190,0.353,70,94,0.745,39,224,263,260,80,18,87,141,649,811,2.99,0.92,2017,18,7.914634146341464,2.9885057471264367,348,24,372,0.706989247311828
2017-18,RegularSeason,202323,171,Evan Turner,1610612757,POR,79,2034,258,577,0.447,42,132,0.318,91,107,0.85,30,214,244,173,47,29,99,163,649,708,1.75,0.47,2017,18,8.215189873417721,1.7474747474747474,319,16,335,0.7283582089552239
2017-18,RegularSeason,202329,173,Al-Farouq Aminu,1610612757,POR,69,2072,230,582,0.395,125,339,0.369,59,80,0.738,97,428,525,84,79,40,79,136,644,920,1.06,1.0,2017,18,9.333333333333334,1.0632911392405062,352,21,373,1.4075067024128687
2017-18,RegularSeason,203894,173,Shabazz Napier,1610612757,POR,74,1536,223,531,0.42,82,218,0.376,116,138,0.841,26,144,170,150,81,14,90,84,644,639,1.67,0.9,2017,18,8.702702702702704,1.6666666666666667,308,22,330,0.5151515151515151
2017-18,RegularSeason,203121,175,Darius Miller,1610612740,NOP,82,1944,216,487,0.444,147,358,0.411,58,67,0.866,18,146,164,111,28,17,58,160,637,619,1.91,0.48,2017,18,7.7682926829268295,1.9137931034482758,271,9,280,0.5857142857142857
2017-18,RegularSeason,203926,176,Doug McDermott,1610612742,DAL,81,1768,237,508,0.467,92,216,0.426,64,81,0.79,40,160,200,79,19,16,56,122,630,600,1.41,0.34,2017,18,7.777777777777778,1.4107142857142858,271,17,288,0.6944444444444444
2017-18,RegularSeason,1627763,177,Malcolm Brogdon,1610612749,MIL,48,1436,244,503,0.485,62,161,0.385,75,85,0.882,23,133,156,152,41,13,66,128,625,652,2.3,0.62,2017,18,13.020833333333334,2.303030303030303,259,10,269,0.5799256505576208
2017-18,RegularSeason,1626170,178,Jerian Grant,1610612741,CHI,74,1686,209,503,0.416,61,187,0.326,140,188,0.745,31,140,171,342,63,8,89,132,619,772,3.84,0.71,2017,18,8.364864864864865,3.842696629213483,294,48,342,0.5
2017-18,RegularSeason,203473,179,Dewayne Dedmon,1610612737,ATL,62,1542,250,477,0.524,50,141,0.355,67,86,0.779,100,389,489,90,40,51,85,162,617,956,1.06,0.47,2017,18,9.951612903225806,1.0588235294117647,227,19,246,1.9878048780487805
2017-18,RegularSeason,201583,179,Ryan Anderson,1610612745,HOU,66,1725,207,480,0.431,131,339,0.386,72,93,0.774,94,237,331,60,24,21,42,126,617,717,1.43,0.57,2017,18,9.348484848484848,1.4285714285714286,273,21,294,1.1258503401360545
2017-18,RegularSeason,201980,181,Danny Green,1610612759,SAS,70,1791,217,561,0.387,116,320,0.363,50,65,0.769,41,208,249,110,63,80,74,122,600,669,1.49,0.85,2017,18,8.571428571428571,1.4864864864864864,344,15,359,0.6935933147632312
2017-18,RegularSeason,1626169,182,Stanley Johnson,1610612765,DET,69,1894,210,560,0.375,67,234,0.286,112,145,0.772,33,219,252,112,95,14,77,169,599,612,1.46,1.23,2017,18,8.681159420289855,1.4545454545454546,350,33,383,0.6579634464751958
2017-18,RegularSeason,2734,183,Devin Harris,1610612743,DEN,71,1340,187,454,0.412,79,227,0.348,142,170,0.835,12,115,127,152,47,12,76,158,595,562,2.0,0.62,2017,18,8.380281690140846,2.0,267,28,295,0.43050847457627117
2017-18,RegularSeason,1627783,184,Pascal Siakam,1610612761,TOR,81,1679,253,498,0.508,29,132,0.22,54,87,0.621,79,285,364,159,62,42,67,166,589,871,2.37,0.93,2017,18,7.271604938271605,2.373134328358209,245,33,278,1.3093525179856116
2017-18,RegularSeason,203458,185,Alex Len,1610612756,PHX,69,1395,214,378,0.566,1,3,0.333,158,231,0.684,175,343,518,82,27,61,78,158,587,960,1.05,0.35,2017,18,8.507246376811594,1.0512820512820513,164,73,237,2.1856540084388185
2017-18,RegularSeason,1628386,185,Jarrett Allen,1610612751,BKN,72,1441,234,397,0.589,5,15,0.333,114,147,0.776,144,244,388,49,28,88,82,147,587,862,0.6,0.34,2017,18,8.152777777777779,0.5975609756097561,163,33,196,1.9795918367346939
2017-18,RegularSeason,203937,187,Kyle Anderson,1610612759,SAS,74,1978,231,438,0.527,19,57,0.333,104,146,0.712,84,312,396,202,115,60,94,114,585,1015,2.15,1.22,2017,18,7.905405405405405,2.148936170212766,207,42,249,1.5903614457831325
2017-18,RegularSeason,201156,188,Nick Young,1610612744,GSW,80,1393,201,488,0.412,123,326,0.377,56,65,0.862,20,105,125,36,38,7,39,100,581,452,0.92,0.97,2017,18,7.2625,0.9230769230769231,287,9,296,0.4222972972972973
2017-18,RegularSeason,1938,189,Manu Ginobili,1610612759,SAS,65,1299,201,463,0.434,64,192,0.333,110,131,0.84,19,123,142,163,43,16,105,126,576,552,1.55,0.41,2017,18,8.861538461538462,1.5523809523809524,262,21,283,0.5017667844522968
2017-18,RegularSeason,1626204,190,Larry Nance Jr.,1610612739,CLE,66,1421,240,413,0.581,2,12,0.167,91,137,0.664,161,291,452,82,88,38,51,172,573,963,1.61,1.73,2017,18,8.681818181818182,1.607843137254902,173,46,219,2.0639269406392695
2017-18,RegularSeason,203210,191,JaMychal Green,1610612763,MEM,55,1542,223,488,0.457,43,127,0.339,80,111,0.721,147,317,464,79,32,25,76,153,569,797,1.04,0.42,2017,18,10.345454545454546,1.0394736842105263,265,31,296,1.5675675675675675
2017-18,RegularSeason,1627751,192,Jakob Poeltl,1610612761,TOR,82,1524,253,384,0.659,1,2,0.5,60,101,0.594,165,228,393,57,39,100,85,212,567,899,0.67,0.46,2017,18,6.914634146341464,0.6705882352941176,131,41,172,2.2848837209302326
2017-18,RegularSeason,1626185,193,Jarell Martin,1610612763,MEM,73,1661,221,496,0.446,34,98,0.347,89,116,0.767,97,221,318,73,39,49,86,211,565,656,0.85,0.45,2017,18,7.739726027397261,0.8488372093023255,275,27,302,1.0529801324503312
2017-18,RegularSeason,101109,193,Raymond Felton,1610612760,OKC,82,1365,224,552,0.406,81,230,0.352,36,44,0.818,25,131,156,203,49,16,76,91,565,577,2.67,0.65,2017,18,6.890243902439025,2.6710526315789473,328,8,336,0.4642857142857143
2017-18,RegularSeason,1628379,195,Luke Kennard,1610612765,DET,73,1463,206,465,0.443,81,195,0.415,65,76,0.855,21,155,176,124,44,13,69,86,558,576,1.8,0.64,2017,18,7.6438356164383565,1.7971014492753623,259,11,270,0.6518518518518519
2017-18,RegularSeason,1627737,196,Marquese Chriss,1610612756,PHX,72,1527,202,477,0.423,56,190,0.295,96,158,0.608,76,319,395,83,51,70,107,205,556,711,0.78,0.48,2017,18,7.722222222222222,0.7757009345794392,275,62,337,1.172106824925816
2017-18,RegularSeason,1627854,197,Bryn Forbes,1610612759,SAS,80,1517,209,497,0.421,89,228,0.39,48,72,0.667,12,98,110,80,28,2,37,108,555,426,2.16,0.76,2017,18,6.9375,2.1621621621621623,288,24,312,0.3525641025641026
2017-18,RegularSeason,1628021,197,David Nwaba,1610612741,CHI,70,1646,202,423,0.478,18,52,0.346,133,203,0.655,89,237,326,104,59,29,77,158,555,705,1.35,0.77,2017,18,7.928571428571429,1.3506493506493507,221,70,291,1.120274914089347
2017-18,RegularSeason,1626153,197,Delon Wright,1610612761,TOR,69,1433,201,432,0.465,56,153,0.366,97,117,0.829,45,153,198,200,72,33,78,81,555,729,2.56,0.92,2017,18,8.043478260869565,2.5641025641025643,231,20,251,0.7888446215139442
2017-18,RegularSeason,200794,197,Paul Millsap,1610612743,DEN,38,1143,202,435,0.464,39,113,0.345,112,161,0.696,65,180,245,105,39,44,73,99,555,633,1.44,0.53,2017,18,14.605263157894736,1.4383561643835616,233,49,282,0.8687943262411347
2017-18,RegularSeason,1627755,201,Tyler Ulis,1610612756,PHX,71,1658,214,551,0.388,42,146,0.288,84,101,0.832,24,104,128,311,70,7,127,120,554,589,2.45,0.55,2017,18,7.802816901408451,2.4488188976377954,337,17,354,0.3615819209039548
2017-18,RegularSeason,1626144,202,Emmanuel Mudiay,1610612752,NYK,64,1244,204,526,0.388,47,148,0.318,98,129,0.76,26,126,152,206,41,11,113,80,553,497,1.82,0.36,2017,18,8.640625,1.823008849557522,322,31,353,0.43059490084985835
2017-18,RegularSeason,203546,203,Ian Clark,1610612740,NOP,74,1454,222,495,0.448,62,195,0.318,45,59,0.763,10,117,127,110,33,10,57,120,551,487,1.93,0.58,2017,18,7.445945945945946,1.9298245614035088,273,14,287,0.4425087108013937
2017-18,RegularSeason,203124,204,Kyle O'Quinn,1610612752,NYK,77,1387,224,384,0.583,4,17,0.235,98,127,0.772,121,349,470,158,36,98,100,192,550,1023,1.58,0.36,2017,18,7.142857142857143,1.58,160,29,189,2.486772486772487
2017-18,RegularSeason,203935,204,Marcus Smart,1610612738,BOS,54,1614,189,515,0.367,75,249,0.301,97,133,0.729,43,145,188,259,71,23,129,133,550,600,2.01,0.55,2017,18,10.185185185185185,2.007751937984496,326,36,362,0.5193370165745856
2017-18,RegularSeason,202066,206,Garrett Temple,1610612758,SAC,65,1615,199,476,0.418,89,227,0.392,60,78,0.769,22,130,152,124,57,27,79,135,547,533,1.57,0.72,2017,18,8.415384615384616,1.5696202531645569,277,18,295,0.5152542372881356
2017-18,RegularSeason,200765,207,Rajon Rondo,1610612740,NOP,65,1705,231,494,0.468,50,150,0.333,25,46,0.543,31,232,263,533,70,10,151,119,537,978,3.53,0.46,2017,18,8.261538461538462,3.5298013245033113,263,21,284,0.926056338028169
2017-18,RegularSeason,1626150,208,Andrew Harrison,1610612763,MEM,56,1326,181,429,0.422,47,142,0.331,124,159,0.78,23,108,131,177,38,26,81,138,533,541,2.19,0.47,2017,18,9.517857142857142,2.185185185185185,248,35,283,0.4628975265017668
2017-18,RegularSeason,1627733,209,Dragan Bender,1610612756,PHX,82,2069,187,484,0.386,118,322,0.366,39,51,0.765,40,321,361,130,22,53,112,166,531,676,1.16,0.2,2017,18,6.475609756097561,1.1607142857142858,297,12,309,1.168284789644013
2017-18,RegularSeason,1626159,210,Justise Winslow,1610612748,MIA,68,1680,207,488,0.424,49,129,0.38,66,104,0.635,64,306,370,148,54,33,77,140,529,738,1.92,0.7,2017,18,7.779411764705882,1.922077922077922,281,38,319,1.1598746081504703
2017-18,RegularSeason,1628366,211,Lonzo Ball,1610612747,LAL,52,1780,203,564,0.36,90,295,0.305,32,71,0.451,69,291,360,376,88,43,136,117,528,859,2.77,0.65,2017,18,10.153846153846153,2.764705882352941,361,39,400,0.9
2017-18,RegularSeason,202328,212,Greg Monroe,1610612738,BOS,51,1041,218,386,0.565,0,0,0.0,88,119,0.739,109,241,350,114,44,23,94,95,524,762,1.21,0.47,2017,18,10.27450980392157,1.2127659574468086,168,31,199,1.7587939698492463
2017-18,RegularSeason,203486,212,Mason Plumlee,1610612743,DEN,74,1439,221,368,0.601,0,1,0.0,82,179,0.458,132,268,400,142,49,81,102,184,524,850,1.39,0.48,2017,18,7.081081081081081,1.392156862745098,147,97,244,1.639344262295082
2017-18,RegularSeason,203107,212,Tomas Satoransky,1610612764,WAS,73,1643,201,384,0.523,47,101,0.465,75,96,0.781,72,161,233,286,52,15,83,131,524,823,3.45,0.63,2017,18,7.178082191780822,3.4457831325301207,183,21,204,1.142156862745098
2017-18,RegularSeason,1627746,215,Skal Labissiere,1610612758,SAC,60,1240,205,458,0.448,18,51,0.353,95,118,0.805,98,189,287,72,25,49,73,132,523,607,0.99,0.34,2017,18,8.716666666666667,0.9863013698630136,253,23,276,1.039855072463768
2017-18,RegularSeason,203503,216,Tony Snell,1610612749,MIL,75,2053,185,425,0.435,108,268,0.403,38,48,0.792,9,132,141,98,47,28,36,115,516,544,2.72,1.31,2017,18,6.88,2.7222222222222223,240,10,250,0.564
2017-18,RegularSeason,203516,217,James Ennis III,1610612765,DET,72,1604,182,384,0.474,51,153,0.333,97,116,0.836,73,151,224,71,47,18,56,134,512,595,1.27,0.84,2017,18,7.111111111111111,1.2678571428571428,202,19,221,1.0135746606334841
2017-18,RegularSeason,201596,218,Mario Chalmers,1610612763,MEM,66,1421,168,443,0.379,53,191,0.277,118,138,0.855,13,144,157,197,79,14,117,179,507,542,1.68,0.68,2017,18,7.681818181818182,1.6837606837606838,275,20,295,0.5322033898305085
2017-18,RegularSeason,200782,219,P.J. Tucker,1610612745,HOU,82,2281,172,441,0.39,115,310,0.371,43,60,0.717,93,364,457,77,78,26,74,205,502,780,1.04,1.05,2017,18,6.121951219512195,1.0405405405405406,269,17,286,1.597902097902098
2017-18,RegularSeason,101123,220,Gerald Green,1610612745,HOU,41,929,168,413,0.407,110,298,0.369,51,60,0.85,15,118,133,25,24,15,31,87,497,409,0.81,0.77,2017,18,12.121951219512194,0.8064516129032258,245,9,254,0.5236220472440944
2017-18,RegularSeason,1628404,221,Josh Hart,1610612747,LAL,63,1461,176,375,0.469,78,197,0.396,66,94,0.702,42,221,263,80,47,16,47,107,496,628,1.7,1.0,2017,18,7.873015873015873,1.702127659574468,199,28,227,1.158590308370044
2017-18,RegularSeason,2561,222,David West,1610612744,GSW,73,999,216,378,0.571,3,8,0.375,60,79,0.759,64,174,238,138,47,75,80,120,495,732,1.73,0.59,2017,18,6.780821917808219,1.725,162,19,181,1.3149171270718232
2017-18,RegularSeason,202692,223,Alec Burks,1610612762,UTA,64,1059,170,414,0.411,47,142,0.331,107,124,0.863,19,173,192,67,37,8,60,75,494,477,1.12,0.62,2017,18,7.71875,1.1166666666666667,244,17,261,0.735632183908046
2017-18,RegularSeason,201975,224,Jodie Meeks,1610612764,WAS,77,1119,157,393,0.399,72,210,0.343,101,117,0.863,15,111,126,70,29,4,37,55,487,427,1.89,0.78,2017,18,6.324675324675325,1.8918918918918919,236,16,252,0.5
2017-18,RegularSeason,202738,225,Isaiah Thomas,1610612747,LAL,32,862,157,421,0.373,55,188,0.293,117,131,0.893,17,50,67,153,15,3,95,58,486,351,1.61,0.16,2017,18,15.1875,1.6105263157894736,264,14,278,0.24100719424460432
2017-18,RegularSeason,203382,226,Aron Baynes,1610612738,BOS,81,1485,210,446,0.471,3,21,0.143,59,78,0.756,130,304,434,93,22,51,80,200,482,747,1.16,0.28,2017,18,5.950617283950617,1.1625,236,19,255,1.7019607843137254
2017-18,RegularSeason,204456,227,T.J. McConnell,1610612755,PHI,76,1707,210,421,0.499,27,62,0.435,31,39,0.795,37,189,226,303,92,13,112,122,478,781,2.71,0.82,2017,18,6.2894736842105265,2.705357142857143,211,8,219,1.0319634703196348
2017-18,RegularSeason,1628389,228,Bam Adebayo,1610612748,MIA,69,1368,174,340,0.512,0,7,0.0,129,179,0.721,118,263,381,101,32,41,66,138,477,750,1.53,0.48,2017,18,6.913043478260869,1.5303030303030303,166,50,216,1.7638888888888888
2017-18,RegularSeason,201585,228,Kosta Koufos,1610612758,SAC,71,1391,222,389,0.571,0,0,0.0,33,74,0.446,149,323,472,87,47,32,49,146,477,858,1.78,0.96,2017,18,6.71830985915493,1.7755102040816326,167,41,208,2.269230769230769
2017-18,RegularSeason,202714,230,Shelvin Mack,1610612753,ORL,69,1365,178,414,0.43,48,139,0.345,69,97,0.711,23,143,166,272,54,8,89,91,473,620,3.06,0.61,2017,18,6.855072463768116,3.056179775280899,236,28,264,0.6287878787878788
2017-18,RegularSeason,203476,231,Gorgui Dieng,1610612750,MIN,79,1333,186,388,0.479,19,61,0.311,79,102,0.775,106,254,360,71,45,39,59,147,470,701,1.2,0.76,2017,18,5.949367088607595,1.2033898305084745,202,23,225,1.6
2017-18,RegularSeason,202687,232,Bismack Biyombo,1610612753,ORL,82,1495,183,352,0.52,0,1,0.0,102,157,0.65,144,324,468,66,21,95,84,158,468,810,0.79,0.25,2017,18,5.7073170731707314,0.7857142857142857,169,55,224,2.0892857142857144
2017-18,RegularSeason,101127,233,Jarrett Jack,1610612752,NYK,62,1548,189,443,0.427,25,86,0.291,63,75,0.84,22,169,191,348,35,4,115,98,466,663,3.03,0.3,2017,18,7.516129032258065,3.026086956521739,254,12,266,0.7180451127819549
2017-18,RegularSeason,1628373,234,Frank Ntilikina,1610612752,NYK,78,1706,182,500,0.364,50,157,0.318,49,68,0.721,37,140,177,250,65,18,131,181,463,505,1.91,0.5,2017,18,5.935897435897436,1.9083969465648856,318,19,337,0.5252225519287834
2017-18,RegularSeason,203504,235,Trey Burke,1610612752,NYK,36,785,193,384,0.503,38,105,0.362,37,57,0.649,13,58,71,170,24,4,43,43,461,476,3.95,0.56,2017,18,12.805555555555555,3.953488372093023,191,20,211,0.33649289099526064
2017-18,RegularSeason,201601,236,Luc Mbah a Moute,1610612745,HOU,61,1564,166,345,0.481,63,173,0.364,65,95,0.684,22,164,186,55,72,25,68,100,460,521,0.81,1.06,2017,18,7.540983606557377,0.8088235294117647,179,30,209,0.8899521531100478
2017-18,RegularSeason,202722,237,Dāvis Bertāns,1610612759,SAS,77,1086,161,366,0.44,94,252,0.373,40,49,0.816,18,135,153,74,26,28,36,93,456,487,2.06,0.72,2017,18,5.922077922077922,2.0555555555555554,205,9,214,0.7149532710280374
2017-18,RegularSeason,202357,238,Nemanja Bjelica,1610612750,MIN,67,1371,171,371,0.461,76,183,0.415,36,45,0.8,53,221,274,86,50,16,52,141,454,619,1.65,0.96,2017,18,6.776119402985074,1.6538461538461537,200,9,209,1.3110047846889952
2017-18,RegularSeason,1628382,239,Justin Jackson,1610612758,SAC,68,1506,185,419,0.442,57,185,0.308,26,36,0.722,27,160,187,74,28,13,40,81,453,471,1.85,0.7,2017,18,6.661764705882353,1.85,234,10,244,0.7663934426229508
2017-18,RegularSeason,1627819,240,Isaiah Taylor,1610612737,ATL,67,1167,163,390,0.418,20,80,0.25,99,141,0.702,22,72,94,206,34,10,84,116,445,436,2.45,0.41,2017,18,6.641791044776119,2.4523809523809526,227,42,269,0.34944237918215615
2017-18,RegularSeason,1626192,241,Pat Connaughton,1610612757,POR,82,1488,165,390,0.423,74,210,0.352,37,44,0.841,36,125,161,91,23,22,43,120,441,463,2.12,0.54,2017,18,5.378048780487805,2.116279069767442,225,7,232,0.6939655172413793
2017-18,RegularSeason,203092,241,Tyler Zeller,1610612749,MIL,66,1108,187,334,0.56,10,28,0.357,57,79,0.722,110,195,305,47,15,35,47,126,441,627,1.0,0.32,2017,18,6.681818181818182,1.0,147,22,169,1.8047337278106508
2017-18,RegularSeason,1628384,243,OG Anunoby,1610612761,TOR,74,1481,163,346,0.471,73,197,0.371,39,62,0.629,44,140,184,55,52,14,45,130,438,492,1.22,1.16,2017,18,5.918918918918919,1.2222222222222223,183,23,206,0.8932038834951457
2017-18,RegularSeason,203079,244,Dion Waiters,1610612748,MIA,30,918,163,410,0.398,52,170,0.306,51,69,0.739,8,69,77,113,23,9,70,61,429,316,1.61,0.33,2017,18,14.3,1.6142857142857143,247,18,265,0.29056603773584905
2017-18,RegularSeason,201973,244,Jonas Jerebko,1610612762,UTA,74,1134,159,341,0.466,65,157,0.414,46,57,0.807,53,193,246,42,24,12,27,127,429,533,1.56,0.89,2017,18,5.797297297297297,1.5555555555555556,182,11,193,1.2746113989637307
2017-18,RegularSeason,1628462,244,Milos Teodosic,1610612746,LAC,45,1134,151,360,0.419,88,232,0.379,39,46,0.848,16,110,126,209,23,5,97,103,429,479,2.15,0.24,2017,18,9.533333333333333,2.154639175257732,209,7,216,0.5833333333333334
2017-18,RegularSeason,202344,247,Trevor Booker,1610612754,IND,68,1158,177,343,0.516,8,33,0.242,66,93,0.71,117,201,318,82,28,21,59,119,428,625,1.39,0.47,2017,18,6.294117647058823,1.3898305084745763,166,27,193,1.6476683937823835
2017-18,RegularSeason,203463,248,Ben McLemore,1610612763,MEM,56,1091,157,373,0.421,55,159,0.346,53,64,0.828,34,105,139,51,38,15,61,139,422,377,0.84,0.62,2017,18,7.535714285714286,0.8360655737704918,216,11,227,0.6123348017621145
2017-18,RegularSeason,1628370,249,Malik Monk,1610612766,CHA,63,854,153,425,0.36,83,243,0.342,32,38,0.842,8,58,66,91,20,9,49,60,421,280,1.86,0.41,2017,18,6.682539682539683,1.8571428571428572,272,6,278,0.23741007194244604
2017-18,RegularSeason,2225,249,Tony Parker,1610612759,SAS,55,1071,178,388,0.459,10,37,0.27,55,78,0.705,7,88,95,195,28,1,68,52,421,439,2.87,0.41,2017,18,7.654545454545454,2.8676470588235294,210,23,233,0.40772532188841204
2017-18,RegularSeason,201967,251,Dante Cunningham,1610612751,BKN,73,1562,164,364,0.451,58,168,0.345,31,52,0.596,78,220,298,48,39,30,33,111,417,578,1.46,1.18,2017,18,5.712328767123288,1.4545454545454546,200,21,221,1.3484162895927603
2017-18,RegularSeason,1626145,252,Tyus Jones,1610612750,MIN,82,1467,150,328,0.457,45,129,0.349,71,81,0.877,16,116,132,232,95,6,59,110,416,634,3.93,1.61,2017,18,5.073170731707317,3.9322033898305087,178,10,188,0.7021276595744681
2017-18,RegularSeason,202334,253,Ed Davis,1610612757,POR,78,1471,170,292,0.582,0,1,0.0,74,111,0.667,183,392,575,40,32,52,66,188,414,888,0.61,0.48,2017,18,5.3076923076923075,0.6060606060606061,122,37,159,3.6163522012578615
2017-18,RegularSeason,1628412,254,Frank Mason III,1610612758,SAC,52,984,144,380,0.379,31,86,0.36,94,115,0.817,30,100,130,147,34,10,65,72,413,412,2.26,0.52,2017,18,7.9423076923076925,2.2615384615384615,236,21,257,0.5058365758754864
2017-18,RegularSeason,203112,255,Quincy Acy,1610612751,BKN,70,1359,130,365,0.356,102,292,0.349,49,60,0.817,40,217,257,57,33,29,60,149,411,481,0.95,0.55,2017,18,5.871428571428571,0.95,235,11,246,1.0447154471544715
2017-18,RegularSeason,203488,256,Mike Muscala,1610612737,ATL,53,1060,143,312,0.458,62,167,0.371,57,62,0.919,56,174,230,51,31,27,42,80,405,528,1.21,0.74,2017,18,7.6415094339622645,1.2142857142857142,169,5,174,1.3218390804597702
2017-18,RegularSeason,1628416,256,Tyler Dorsey,1610612737,ATL,56,974,144,382,0.377,72,199,0.362,45,63,0.714,17,113,130,79,17,5,37,63,405,343,2.13,0.46,2017,18,7.232142857142857,2.135135135135135,238,18,256,0.5078125
2017-18,RegularSeason,202325,258,Wesley Johnson,1610612746,LAC,74,1486,150,368,0.408,60,177,0.339,43,58,0.741,29,187,216,61,76,62,55,146,403,530,1.11,1.38,2017,18,5.445945945945946,1.1090909090909091,218,15,233,0.927038626609442
2017-18,RegularSeason,201578,259,Marreese Speights,1610612753,ORL,52,675,138,349,0.395,86,233,0.369,40,55,0.727,21,112,133,40,8,22,40,106,402,339,1.0,0.2,2017,18,7.730769230769231,1.0,211,15,226,0.588495575221239
2017-18,RegularSeason,203897,260,Zach LaVine,1610612741,CHI,24,656,136,355,0.383,42,123,0.341,87,107,0.813,9,85,94,72,24,4,43,55,401,313,1.67,0.56,2017,18,16.708333333333332,1.6744186046511629,219,20,239,0.39330543933054396
2017-18,RegularSeason,2733,261,Shaun Livingston,1610612744,GSW,71,1129,172,343,0.501,0,5,0.0,50,61,0.82,32,99,131,140,35,21,58,117,394,481,2.41,0.6,2017,18,5.549295774647887,2.413793103448276,171,11,182,0.7197802197802198
2017-18,RegularSeason,203953,262,Jabari Parker,1610612749,MIL,31,743,160,332,0.482,31,81,0.383,40,54,0.741,42,109,151,59,25,10,45,50,391,405,1.31,0.56,2017,18,12.612903225806452,1.3111111111111111,172,14,186,0.8118279569892473
2017-18,RegularSeason,1628467,263,Maxi Kleber,1610612742,DAL,72,1206,151,309,0.489,40,128,0.313,44,59,0.746,71,163,234,51,26,47,30,114,386,541,1.7,0.87,2017,18,5.361111111111111,1.7,158,15,173,1.3526011560693643
2017-18,RegularSeason,203090,264,Maurice Harkless,1610612757,POR,59,1264,147,297,0.495,49,118,0.415,42,59,0.712,46,116,162,53,48,43,40,103,385,484,1.32,1.2,2017,18,6.52542372881356,1.325,150,17,167,0.9700598802395209
2017-18,RegularSeason,1626181,264,Norman Powell,1610612761,TOR,70,1062,150,374,0.401,53,186,0.285,32,39,0.821,14,105,119,89,37,16,66,111,385,349,1.35,0.56,2017,18,5.5,1.3484848484848484,224,7,231,0.5151515151515151
2017-18,RegularSeason,2738,266,Andre Iguodala,1610612744,GSW,64,1622,148,320,0.463,33,117,0.282,55,87,0.632,50,196,246,210,54,38,67,99,384,661,3.13,0.81,2017,18,6.0,3.1343283582089554,172,32,204,1.2058823529411764
2017-18,RegularSeason,201147,267,Corey Brewer,1610612760,OKC,72,1209,142,316,0.449,31,110,0.282,65,90,0.722,43,111,154,65,79,14,49,139,380,444,1.33,1.61,2017,18,5.277777777777778,1.3265306122448979,174,25,199,0.7738693467336684
2017-18,RegularSeason,2585,268,Zaza Pachulia,1610612744,GSW,69,972,149,264,0.564,0,1,0.0,75,93,0.806,89,232,321,109,38,17,72,122,373,653,1.51,0.53,2017,18,5.405797101449275,1.5138888888888888,115,18,133,2.4135338345864663
2017-18,RegularSeason,2207,269,Joe Johnson,1610612745,HOU,55,1205,146,360,0.406,40,145,0.276,40,45,0.889,14,158,172,83,18,7,49,67,372,384,1.69,0.37,2017,18,6.763636363636364,1.6938775510204083,214,5,219,0.7853881278538812
2017-18,RegularSeason,101133,270,Ian Mahinmi,1610612764,WAS,77,1145,138,248,0.556,0,2,0.0,90,128,0.703,135,177,312,53,38,42,100,230,366,563,0.53,0.38,2017,18,4.753246753246753,0.53,110,38,148,2.108108108108108
2017-18,RegularSeason,1627738,271,Deyonta Davis,1610612763,MEM,62,943,161,265,0.608,0,0,0.0,38,57,0.667,75,175,250,40,15,39,32,125,360,549,1.25,0.47,2017,18,5.806451612903226,1.25,104,19,123,2.032520325203252
2017-18,RegularSeason,204038,271,Langston Galloway,1610612765,DET,58,863,126,340,0.371,75,218,0.344,33,41,0.805,13,79,92,58,35,5,18,39,360,310,3.22,1.94,2017,18,6.206896551724138,3.2222222222222223,214,8,222,0.4144144144144144
2017-18,RegularSeason,1627748,273,Thon Maker,1610612749,MIL,74,1238,130,316,0.411,31,104,0.298,65,93,0.699,75,150,225,46,38,53,44,162,356,460,1.04,0.86,2017,18,4.8108108108108105,1.0454545454545454,186,28,214,1.0514018691588785
2017-18,RegularSeason,203518,274,Alex Abrines,1610612760,OKC,75,1134,115,291,0.395,84,221,0.38,39,46,0.848,26,88,114,28,38,8,25,124,353,333,1.12,1.52,2017,18,4.706666666666667,1.12,176,7,183,0.6229508196721312
2017-18,RegularSeason,1626220,275,Royce O'Neale,1610612762,UTA,69,1150,120,284,0.423,42,118,0.356,61,76,0.803,25,211,236,95,36,16,55,105,343,492,1.73,0.66,2017,18,4.971014492753623,1.7272727272727273,164,15,179,1.318435754189944
2017-18,RegularSeason,101161,276,Amir Johnson,1610612755,PHI,74,1170,140,260,0.538,10,32,0.313,52,85,0.612,123,207,330,118,45,44,55,192,342,671,2.15,0.82,2017,18,4.621621621621622,2.1454545454545455,120,33,153,2.156862745098039
2017-18,RegularSeason,2403,277,Nene,1610612745,HOU,52,758,136,239,0.569,0,2,0.0,68,107,0.636,54,122,176,45,28,14,38,123,340,423,1.18,0.74,2017,18,6.538461538461538,1.1842105263157894,103,39,142,1.2394366197183098
2017-18,RegularSeason,1627098,278,Malcolm Delaney,1610612737,ATL,54,1014,109,285,0.382,46,124,0.371,74,92,0.804,9,91,100,163,35,6,66,82,338,382,2.47,0.53,2017,18,6.2592592592592595,2.4696969696969697,176,18,194,0.5154639175257731
2017-18,RegularSeason,1628455,279,Mike James,1610612740,NOP,36,686,123,321,0.383,26,98,0.265,64,84,0.762,13,77,90,126,28,7,49,48,336,320,2.57,0.57,2017,18,9.333333333333334,2.5714285714285716,198,20,218,0.41284403669724773
2017-18,RegularSeason,1628464,280,Daniel Theis,1610612738,BOS,63,936,126,233,0.541,18,58,0.31,61,81,0.753,90,184,274,56,30,48,56,157,331,556,1.0,0.54,2017,18,5.253968253968254,1.0,107,20,127,2.15748031496063
2017-18,RegularSeason,203930,281,Sean Kilpatrick,1610612741,CHI,52,640,110,294,0.374,46,144,0.319,64,72,0.889,5,82,87,46,13,5,38,33,330,251,1.21,0.34,2017,18,6.346153846153846,1.2105263157894737,184,8,192,0.453125
2017-18,RegularSeason,1627782,282,Wayne Selden,1610612763,MEM,35,691,116,269,0.431,49,122,0.402,44,59,0.746,16,40,56,66,18,5,54,59,325,248,1.22,0.33,2017,18,9.285714285714286,1.2222222222222223,153,15,168,0.3333333333333333
2017-18,RegularSeason,201568,283,Danilo Gallinari,1610612746,LAC,21,671,102,256,0.398,36,111,0.324,81,87,0.931,9,92,101,41,13,10,26,30,321,300,1.58,0.5,2017,18,15.285714285714286,1.5769230769230769,154,6,160,0.63125
2017-18,RegularSeason,202335,284,Patrick Patterson,1610612760,OKC,82,1270,106,266,0.398,66,171,0.386,40,46,0.87,32,161,193,57,48,23,33,87,318,440,1.73,1.46,2017,18,3.8780487804878048,1.7272727272727273,160,6,166,1.1626506024096386
2017-18,RegularSeason,1713,285,Vince Carter,1610612758,SAC,58,1026,114,283,0.403,57,165,0.345,28,37,0.757,18,130,148,69,42,26,36,96,313,384,1.92,1.17,2017,18,5.396551724137931,1.9166666666666667,169,9,178,0.8314606741573034
2017-18,RegularSeason,1626188,286,Quinn Cook,1610612744,GSW,33,741,122,252,0.484,46,104,0.442,22,25,0.88,10,72,82,89,12,1,32,59,312,331,2.78,0.38,2017,18,9.454545454545455,2.78125,130,3,133,0.6165413533834586
2017-18,RegularSeason,200757,286,Thabo Sefolosha,1610612762,UTA,38,806,118,240,0.492,32,84,0.381,44,54,0.815,29,132,161,33,52,12,30,59,312,408,1.1,1.73,2017,18,8.210526315789474,1.1,122,10,132,1.2196969696969697
2017-18,RegularSeason,1626158,288,Richaun Holmes,1610612755,PHI,48,746,135,241,0.56,4,31,0.129,37,56,0.661,57,154,211,61,20,29,25,97,311,482,2.44,0.8,2017,18,6.479166666666667,2.44,106,19,125,1.688
2017-18,RegularSeason,201580,289,JaVale McGee,1610612744,GSW,65,615,136,219,0.621,0,6,0.0,38,52,0.731,59,110,169,33,21,57,27,91,310,466,1.22,0.78,2017,18,4.769230769230769,1.2222222222222223,83,14,97,1.7422680412371134
2017-18,RegularSeason,1626245,290,Cristiano Felicio,1610612741,CHI,55,977,127,215,0.591,0,2,0.0,54,81,0.667,83,150,233,55,16,11,54,104,308,454,1.02,0.3,2017,18,5.6,1.0185185185185186,88,27,115,2.026086956521739
2017-18,RegularSeason,201573,291,Jerryd Bayless,1610612755,PHI,39,925,109,262,0.416,54,146,0.37,35,44,0.795,15,65,80,54,23,6,46,91,307,262,1.17,0.5,2017,18,7.871794871794871,1.173913043478261,153,9,162,0.49382716049382713
2017-18,RegularSeason,202684,291,Tristan Thompson,1610612739,CLE,53,1072,132,235,0.562,0,0,0.0,43,79,0.544,126,226,352,33,16,17,36,102,307,550,0.92,0.44,2017,18,5.7924528301886795,0.9166666666666666,103,36,139,2.5323741007194243
2017-18,RegularSeason,1626155,293,Sam Dekker,1610612746,LAC,73,883,128,259,0.494,10,60,0.167,37,56,0.661,44,130,174,38,24,9,33,71,303,365,1.15,0.73,2017,18,4.1506849315068495,1.1515151515151516,131,19,150,1.16
2017-18,RegularSeason,201956,294,Omri Casspi,1610612744,GSW,53,742,120,207,0.58,10,22,0.455,50,69,0.725,30,170,200,51,18,19,37,71,300,445,1.38,0.49,2017,18,5.660377358490566,1.3783783783783783,87,19,106,1.8867924528301887
2017-18,RegularSeason,2199,294,Tyson Chandler,1610612756,PHX,46,1151,121,187,0.647,0,0,0.0,58,93,0.624,134,284,418,53,16,27,59,106,300,654,0.9,0.27,2017,18,6.521739130434782,0.8983050847457628,66,35,101,4.138613861386139
2017-18,RegularSeason,1627789,296,Timothe Luwawu-Cabarrot,1610612755,PHI,52,807,100,267,0.375,53,158,0.335,46,58,0.793,14,58,72,54,12,5,38,97,299,225,1.42,0.32,2017,18,5.75,1.4210526315789473,167,12,179,0.4022346368715084
2017-18,RegularSeason,202498,297,Lance Thomas,1610612752,NYK,73,1353,102,267,0.382,50,124,0.403,44,53,0.83,44,131,175,44,30,14,41,134,298,346,1.07,0.73,2017,18,4.082191780821918,1.0731707317073171,165,9,174,1.0057471264367817
2017-18,RegularSeason,1628380,298,Zach Collins,1610612757,POR,66,1045,115,289,0.398,35,113,0.31,27,42,0.643,45,176,221,52,17,31,58,133,292,366,0.9,0.29,2017,18,4.424242424242424,0.896551724137931,174,15,189,1.1693121693121693
2017-18,RegularSeason,1627820,299,Tyrone Wallace,1610612746,LAC,30,851,110,247,0.445,10,40,0.25,61,78,0.782,21,84,105,71,27,13,46,83,291,307,1.54,0.59,2017,18,9.7,1.5434782608695652,137,17,154,0.6818181818181818
2017-18,RegularSeason,202718,300,Chandler Parsons,1610612763,MEM,36,691,108,234,0.462,51,121,0.421,17,27,0.63,14,76,90,69,18,11,35,53,284,301,1.97,0.51,2017,18,7.888888888888889,1.9714285714285715,126,10,136,0.6617647058823529
2017-18,RegularSeason,1628414,301,Sindarius Thornwell,1610612746,LAC,73,1156,100,233,0.429,23,61,0.377,59,88,0.67,33,107,140,68,48,25,53,125,282,348,1.28,0.91,2017,18,3.863013698630137,1.2830188679245282,133,29,162,0.8641975308641975
2017-18,RegularSeason,1626203,302,Treveon Graham,1610612766,CHA,63,1050,96,221,0.434,40,97,0.412,41,59,0.695,42,79,121,59,33,2,27,109,273,318,2.19,1.22,2017,18,4.333333333333333,2.185185185185185,125,18,143,0.8461538461538461
2017-18,RegularSeason,1626172,303,Kevon Looney,1610612744,GSW,66,910,112,193,0.58,1,5,0.2,42,77,0.545,83,132,215,42,34,56,31,106,267,467,1.35,1.1,2017,18,4.045454545454546,1.3548387096774193,81,35,116,1.853448275862069
2017-18,RegularSeason,101112,304,Channing Frye,1610612747,LAL,53,695,104,212,0.491,39,115,0.339,17,19,0.895,12,123,135,38,18,13,21,69,264,337,1.81,0.86,2017,18,4.981132075471698,1.8095238095238095,108,2,110,1.2272727272727273
2017-18,RegularSeason,203943,304,Noah Vonleh,1610612741,CHI,54,876,104,234,0.444,20,66,0.303,36,58,0.621,70,241,311,34,19,17,31,68,264,462,1.1,0.61,2017,18,4.888888888888889,1.096774193548387,130,22,152,2.0460526315789473
2017-18,RegularSeason,1628395,306,Jordan Bell,1610612744,GSW,57,809,116,185,0.627,0,4,0.0,30,44,0.682,60,147,207,102,35,56,51,92,262,528,2.0,0.69,2017,18,4.5964912280701755,2.0,69,14,83,2.4939759036144578
2017-18,RegularSeason,202337,307,Luke Babbitt,1610612748,MIA,50,715,91,215,0.423,60,156,0.385,17,22,0.773,7,89,96,31,8,7,19,54,259,253,1.63,0.42,2017,18,5.18,1.631578947368421,124,5,129,0.7441860465116279
2017-18,RegularSeason,101181,308,Jose Calderon,1610612739,CLE,57,914,93,185,0.503,45,97,0.464,24,30,0.8,14,70,84,117,27,2,41,81,255,346,2.85,0.66,2017,18,4.473684210526316,2.8536585365853657,92,6,98,0.8571428571428571
2017-18,RegularSeason,1627767,309,Cheick Diallo,1610612740,NOP,52,581,102,176,0.58,0,0,0.0,50,66,0.758,47,164,211,19,11,21,28,82,254,398,0.68,0.39,2017,18,4.884615384615385,0.6785714285714286,74,16,90,2.3444444444444446
2017-18,RegularSeason,2744,310,Al Jefferson,1610612754,IND,36,484,111,208,0.534,0,3,0.0,30,36,0.833,30,113,143,30,16,23,21,66,252,340,1.43,0.76,2017,18,7.0,1.4285714285714286,97,6,103,1.3883495145631068
2017-18,RegularSeason,2749,311,Jameer Nelson,1610612765,DET,50,1013,95,244,0.389,41,124,0.331,16,20,0.8,13,91,104,179,27,4,67,81,247,341,2.67,0.4,2017,18,4.94,2.671641791044776,149,4,153,0.6797385620915033
2017-18,RegularSeason,1626195,312,Willy Hernangomez,1610612766,CHA,48,494,91,164,0.555,5,12,0.417,59,90,0.656,61,122,183,33,18,16,35,64,246,357,0.94,0.51,2017,18,5.125,0.9428571428571428,73,31,104,1.7596153846153846
2017-18,RegularSeason,203487,313,Michael Carter-Williams,1610612766,CHA,52,835,76,229,0.332,14,59,0.237,73,89,0.82,37,101,138,116,44,23,52,99,239,339,2.23,0.85,2017,18,4.596153846153846,2.230769230769231,153,16,169,0.8165680473372781
2017-18,RegularSeason,1626224,314,Cedi Osman,1610612739,CLE,61,673,90,186,0.484,32,87,0.368,26,46,0.565,19,101,120,41,22,3,32,78,238,276,1.28,0.69,2017,18,3.901639344262295,1.28125,96,20,116,1.0344827586206897
2017-18,RegularSeason,203101,315,Miles Plumlee,1610612737,ATL,55,918,105,180,0.583,0,0,0.0,27,60,0.45,77,151,228,45,17,30,63,79,237,386,0.71,0.27,2017,18,4.3090909090909095,0.7142857142857143,75,33,108,2.111111111111111
2017-18,RegularSeason,1626147,316,Justin Anderson,1610612755,PHI,38,519,87,202,0.431,34,103,0.33,28,38,0.737,25,68,93,25,15,7,16,54,236,235,1.56,0.94,2017,18,6.2105263157894735,1.5625,115,10,125,0.744
2017-18,RegularSeason,1626246,317,Boban Marjanovic,1610612746,LAC,39,338,79,148,0.534,0,0,0.0,77,97,0.794,48,96,144,22,10,11,36,51,235,297,0.61,0.28,2017,18,6.0256410256410255,0.6111111111111112,69,20,89,1.6179775280898876
2017-18,RegularSeason,203469,318,Cody Zeller,1610612766,CHA,33,627,85,156,0.545,2,3,0.667,61,85,0.718,67,110,177,31,14,21,33,81,233,348,0.94,0.42,2017,18,7.0606060606060606,0.9393939393939394,71,24,95,1.8631578947368421
2017-18,RegularSeason,1628393,319,Jawun Evans,1610612746,LAC,48,778,89,253,0.352,15,54,0.278,38,49,0.776,9,75,84,100,36,6,44,97,231,238,2.27,0.82,2017,18,4.8125,2.272727272727273,164,11,175,0.48
2017-18,RegularSeason,203499,319,Shane Larkin,1610612738,BOS,54,775,84,219,0.384,31,86,0.36,32,37,0.865,15,77,92,98,29,2,33,58,231,279,2.97,0.88,2017,18,4.277777777777778,2.9696969696969697,135,5,140,0.6571428571428571
2017-18,RegularSeason,1627775,321,Patrick McCaw,1610612744,GSW,57,961,92,225,0.409,19,80,0.238,26,34,0.765,16,66,82,81,43,10,41,67,229,263,1.98,1.05,2017,18,4.017543859649122,1.975609756097561,133,8,141,0.5815602836879432
2017-18,RegularSeason,1628411,321,Wes Iwundu,1610612753,ORL,62,1020,93,218,0.427,9,46,0.196,34,47,0.723,36,101,137,57,33,12,30,81,229,300,1.9,1.1,2017,18,3.693548387096774,1.9,125,13,138,0.9927536231884058
2017-18,RegularSeason,203530,323,Joffrey Lauvergne,1610612759,SAS,55,534,98,190,0.516,0,5,0.0,30,47,0.638,63,108,171,41,9,3,33,45,226,308,1.24,0.27,2017,18,4.109090909090909,1.2424242424242424,92,17,109,1.5688073394495412
2017-18,RegularSeason,203898,324,Tyler Ennis,1610612747,LAL,54,683,94,224,0.42,14,56,0.25,22,29,0.759,19,76,95,105,30,10,38,75,224,289,2.76,0.79,2017,18,4.148148148148148,2.763157894736842,130,7,137,0.6934306569343066
2017-18,RegularSeason,1626166,325,Cameron Payne,1610612741,CHI,25,582,87,215,0.405,35,91,0.385,12,16,0.75,18,51,69,113,26,9,36,44,221,270,3.14,0.72,2017,18,8.84,3.138888888888889,128,4,132,0.5227272727272727
2017-18,RegularSeason,1627835,326,Paul Zipser,1610612741,CHI,54,824,81,234,0.346,37,110,0.336,19,25,0.76,13,118,131,46,20,15,43,86,218,228,1.07,0.47,2017,18,4.037037037037037,1.069767441860465,153,6,159,0.8238993710691824
2017-18,RegularSeason,1628425,327,Sterling Brown,1610612749,MIL,54,776,82,205,0.4,32,91,0.352,21,24,0.875,27,116,143,25,31,13,25,80,217,278,1.0,1.24,2017,18,4.018518518518518,1.0,123,3,126,1.1349206349206349
2017-18,RegularSeason,202779,328,Dwight Buycks,1610612765,DET,29,427,82,198,0.414,15,45,0.333,36,41,0.878,12,29,41,59,19,2,39,39,215,176,1.51,0.49,2017,18,7.413793103448276,1.5128205128205128,116,5,121,0.33884297520661155
2017-18,RegularSeason,1626257,329,Salah Mejri,1610612742,DAL,61,729,88,137,0.642,0,3,0.0,38,66,0.576,85,161,246,35,22,67,39,121,214,468,0.9,0.56,2017,18,3.5081967213114753,0.8974358974358975,49,28,77,3.1948051948051948
2017-18,RegularSeason,203498,329,Shabazz Muhammad,1610612749,MIL,43,418,84,188,0.447,7,27,0.259,39,50,0.78,23,53,76,14,9,3,6,30,214,195,2.33,1.5,2017,18,4.976744186046512,2.3333333333333335,104,11,115,0.6608695652173913
2017-18,RegularSeason,203710,331,C.J. Williams,1610612746,LAC,38,707,87,197,0.442,22,78,0.282,13,16,0.813,12,44,56,43,31,13,20,63,209,219,2.15,1.55,2017,18,5.5,2.15,110,3,113,0.49557522123893805
2017-18,RegularSeason,201565,331,Derrick Rose,1610612750,MIN,25,419,81,186,0.435,7,30,0.233,40,46,0.87,13,22,35,37,7,4,35,16,209,146,1.06,0.2,2017,18,8.36,1.0571428571428572,105,6,111,0.3153153153153153
2017-18,RegularSeason,203082,331,Terrence Ross,1610612753,ORL,24,600,76,191,0.398,30,93,0.323,27,36,0.75,10,63,73,38,27,11,29,45,209,205,1.31,0.93,2017,18,8.708333333333334,1.3103448275862069,115,9,124,0.5887096774193549
2017-18,RegularSeason,1626202,334,Joe Young,1610612754,IND,53,558,80,186,0.43,25,66,0.379,22,29,0.759,12,51,63,39,14,1,26,39,207,185,1.5,0.54,2017,18,3.9056603773584904,1.5,106,7,113,0.5575221238938053
2017-18,RegularSeason,201144,335,Mike Conley,1610612763,MEM,12,373,64,168,0.381,24,77,0.312,53,66,0.803,0,27,27,49,12,3,18,24,205,161,2.72,0.67,2017,18,17.083333333333332,2.7222222222222223,104,13,117,0.23076923076923078
2017-18,RegularSeason,1628397,336,Ivan Rabb,1610612763,MEM,36,516,86,152,0.566,0,0,0.0,29,36,0.806,53,105,158,32,12,13,35,55,201,308,0.91,0.34,2017,18,5.583333333333333,0.9142857142857143,66,7,73,2.164383561643836
2017-18,RegularSeason,1628424,337,Kobi Simmons,1610612763,MEM,32,643,80,189,0.423,11,39,0.282,25,25,1.0,14,36,50,68,18,5,44,61,196,184,1.54,0.41,2017,18,6.125,1.5454545454545454,109,0,109,0.45871559633027525
2017-18,RegularSeason,1627736,337,Malik Beasley,1610612743,DEN,62,583,73,178,0.41,28,82,0.341,22,33,0.667,14,57,71,31,15,7,24,36,196,180,1.29,0.63,2017,18,3.161290322580645,1.2916666666666667,105,11,116,0.6120689655172413
2017-18,RegularSeason,1628400,339,Semi Ojeleye,1610612738,BOS,73,1150,65,188,0.346,40,125,0.32,25,41,0.61,37,124,161,20,21,4,25,91,195,237,0.8,0.84,2017,18,2.671232876712329,0.8,123,16,139,1.158273381294964
2017-18,RegularSeason,203186,339,Willie Reed,1610612765,DET,42,428,81,121,0.669,1,2,0.5,32,55,0.582,35,86,121,10,9,22,19,56,195,275,0.53,0.47,2017,18,4.642857142857143,0.5263157894736842,40,23,63,1.9206349206349207
2017-18,RegularSeason,203460,341,Andre Roberson,1610612760,OKC,39,1037,87,162,0.537,8,36,0.222,12,38,0.316,75,110,185,46,45,35,30,89,194,374,1.53,1.5,2017,18,4.9743589743589745,1.5333333333333334,75,26,101,1.8316831683168318
2017-18,RegularSeason,1628390,342,Terrance Ferguson,1610612760,OKC,61,763,70,169,0.414,40,120,0.333,9,10,0.9,19,28,47,19,24,10,11,83,189,178,1.73,2.18,2017,18,3.098360655737705,1.7272727272727273,99,1,100,0.47
2017-18,RegularSeason,202702,343,Kenneth Faried,1610612743,DEN,32,461,76,148,0.514,0,1,0.0,36,51,0.706,68,85,153,18,12,13,23,51,188,274,0.78,0.52,2017,18,5.875,0.782608695652174,72,15,87,1.7586206896551724
2017-18,RegularSeason,203526,344,Raul Neto,1610612762,UTA,41,498,69,151,0.457,19,47,0.404,26,35,0.743,7,42,49,75,13,4,36,38,183,197,2.08,0.36,2017,18,4.463414634146342,2.0833333333333335,82,9,91,0.5384615384615384
2017-18,RegularSeason,1628463,344,Tyler Cavanaugh,1610612737,ATL,39,519,67,152,0.441,32,89,0.36,17,21,0.81,45,82,127,27,9,4,13,61,183,248,2.08,0.69,2017,18,4.6923076923076925,2.076923076923077,85,4,89,1.4269662921348314
2017-18,RegularSeason,1628422,346,Damyean Dotson,1610612752,NYK,44,474,72,161,0.447,22,68,0.324,16,23,0.696,9,75,84,31,12,2,17,34,182,198,1.82,0.71,2017,18,4.136363636363637,1.8235294117647058,89,7,96,0.875
2017-18,RegularSeason,203917,347,Nik Stauskas,1610612751,BKN,41,523,60,154,0.39,40,100,0.4,21,29,0.724,4,60,64,39,9,4,26,24,181,169,1.5,0.35,2017,18,4.414634146341464,1.5,94,8,102,0.6274509803921569
2017-18,RegularSeason,204028,348,Tarik Black,1610612745,HOU,51,537,75,127,0.591,1,11,0.091,29,63,0.46,63,100,163,13,21,30,35,107,180,286,0.37,0.6,2017,18,3.5294117647058822,0.37142857142857144,52,34,86,1.8953488372093024
2017-18,RegularSeason,201167,349,Arron Afflalo,1610612753,ORL,53,682,65,162,0.401,27,70,0.386,22,26,0.846,4,62,66,30,4,9,21,56,179,166,1.43,0.19,2017,18,3.3773584905660377,1.4285714285714286,97,4,101,0.6534653465346535
2017-18,RegularSeason,203920,350,Khem Birch,1610612753,ORL,42,578,68,126,0.54,0,0,0.0,42,61,0.689,70,110,180,34,15,21,21,56,178,330,1.62,0.71,2017,18,4.238095238095238,1.619047619047619,58,19,77,2.3376623376623376
2017-18,RegularSeason,1626143,351,Jahlil Okafor,1610612751,BKN,28,353,77,138,0.558,1,4,0.25,21,29,0.724,21,64,85,12,3,18,21,51,176,204,0.57,0.14,2017,18,6.285714285714286,0.5714285714285714,61,8,69,1.2318840579710144
2017-18,RegularSeason,204025,351,Tim Frazier,1610612764,WAS,59,838,68,172,0.395,17,56,0.304,23,30,0.767,18,97,115,194,47,7,57,97,176,371,3.4,0.82,2017,18,2.983050847457627,3.4035087719298245,104,7,111,1.0360360360360361
2017-18,RegularSeason,1628407,353,Dwayne Bacon,1610612766,CHA,53,713,72,192,0.375,11,43,0.256,20,25,0.8,4,120,124,38,16,2,23,46,175,207,1.65,0.7,2017,18,3.30188679245283,1.6521739130434783,120,5,125,0.992
2017-18,RegularSeason,203477,354,Isaiah Canaan,1610612756,PHX,20,422,52,137,0.38,22,66,0.333,46,51,0.902,6,39,45,76,16,1,29,36,172,191,2.62,0.55,2017,18,8.6,2.6206896551724137,85,5,90,0.5
2017-18,RegularSeason,203948,355,Johnny O'Bryant III,1610612766,CHA,36,379,68,171,0.398,14,43,0.326,21,25,0.84,29,64,93,14,9,6,15,45,171,171,0.93,0.6,2017,18,4.75,0.9333333333333333,103,4,107,0.8691588785046729
2017-18,RegularSeason,1891,356,Jason Terry,1610612749,MIL,51,814,59,154,0.383,40,115,0.348,8,9,0.889,5,43,48,59,42,13,25,52,166,207,2.36,1.68,2017,18,3.2549019607843137,2.36,95,1,96,0.5
2017-18,RegularSeason,203521,357,Matthew Dellavedova,1610612749,MIL,38,713,55,152,0.362,29,78,0.372,25,27,0.926,14,50,64,145,14,0,49,67,164,239,2.96,0.29,2017,18,4.315789473684211,2.9591836734693877,97,2,99,0.6464646464646465
2017-18,RegularSeason,1628470,358,Torrey Craig,1610612743,DEN,39,629,62,137,0.453,17,58,0.293,22,35,0.629,40,87,127,25,12,15,20,63,163,234,1.25,0.6,2017,18,4.17948717948718,1.25,75,13,88,1.4431818181818181
2017-18,RegularSeason,202327,359,Ekpe Udoh,1610612762,UTA,63,810,60,120,0.5,0,1,0.0,42,56,0.75,68,82,150,53,43,74,20,105,162,388,2.65,2.15,2017,18,2.5714285714285716,2.65,60,14,74,2.027027027027027
2017-18,RegularSeason,1627814,360,Damion Lee,1610612737,ATL,15,404,62,152,0.408,15,60,0.25,22,29,0.759,11,60,71,29,19,1,14,25,161,170,2.07,1.36,2017,18,10.733333333333333,2.0714285714285716,90,7,97,0.7319587628865979
2017-18,RegularSeason,1627826,360,Ivica Zubac,1610612747,LAL,43,410,61,122,0.5,0,1,0.0,39,51,0.765,45,78,123,25,8,15,26,47,161,233,0.96,0.31,2017,18,3.744186046511628,0.9615384615384616,61,12,73,1.6849315068493151
2017-18,RegularSeason,203962,362,Josh Huestis,1610612760,OKC,69,982,60,182,0.33,33,115,0.287,6,20,0.3,42,119,161,20,15,43,26,82,159,236,0.77,0.58,2017,18,2.3043478260869565,0.7692307692307693,122,14,136,1.1838235294117647
2017-18,RegularSeason,1628388,363,T.J. Leaf,1610612754,IND,53,459,64,136,0.471,18,42,0.429,10,16,0.625,29,53,82,9,5,4,10,45,156,168,0.9,0.5,2017,18,2.943396226415094,0.9,72,6,78,1.0512820512820513
2017-18,RegularSeason,1627863,364,Danuel House Jr.,1610612756,PHX,23,403,56,129,0.434,15,58,0.259,25,31,0.806,13,63,76,25,7,6,11,23,152,176,2.27,0.64,2017,18,6.608695652173913,2.272727272727273,73,6,79,0.9620253164556962
2017-18,RegularSeason,201162,364,Jared Dudley,1610612756,PHX,48,687,48,122,0.393,29,80,0.363,27,35,0.771,8,86,94,78,24,11,28,85,152,249,2.79,0.86,2017,18,3.1666666666666665,2.7857142857142856,74,8,82,1.146341463414634
2017-18,RegularSeason,1627885,364,Shaquille Harrison,1610612756,PHX,23,384,59,124,0.476,6,26,0.231,28,38,0.737,9,52,61,55,26,7,22,42,152,204,2.5,1.18,2017,18,6.608695652173913,2.5,65,10,75,0.8133333333333334
2017-18,RegularSeason,1628469,367,Antonio Blakeney,1610612741,CHI,19,314,53,143,0.371,15,52,0.288,30,39,0.769,4,29,33,20,7,1,11,19,151,102,1.82,0.64,2017,18,7.947368421052632,1.8181818181818181,90,9,99,0.3333333333333333
2017-18,RegularSeason,1627740,367,Henry Ellenson,1610612765,DET,38,329,53,146,0.363,20,60,0.333,25,29,0.862,10,71,81,20,5,0,18,22,151,142,1.11,0.28,2017,18,3.973684210526316,1.1111111111111112,93,4,97,0.8350515463917526
2017-18,RegularSeason,203464,369,Brandon Paul,1610612759,SAS,64,576,55,127,0.433,15,54,0.278,22,43,0.512,6,62,68,37,25,7,29,58,147,162,1.28,0.86,2017,18,2.296875,1.2758620689655173,72,21,93,0.7311827956989247
2017-18,RegularSeason,1627846,370,Abdel Nader,1610612738,BOS,48,522,50,149,0.336,23,65,0.354,23,39,0.59,13,58,71,26,15,10,34,45,146,119,0.77,0.44,2017,18,3.0416666666666665,0.7647058823529411,99,16,115,0.6173913043478261
2017-18,RegularSeason,202695,370,Kawhi Leonard,1610612759,SAS,9,210,52,111,0.468,11,35,0.314,31,38,0.816,6,36,42,21,18,9,16,9,146,154,1.31,1.13,2017,18,16.22222222222222,1.3125,59,7,66,0.6363636363636364
2017-18,RegularSeason,1628371,372,Jonathan Isaac,1610612753,ORL,27,535,55,145,0.379,16,46,0.348,19,25,0.76,16,83,99,18,33,30,27,48,145,202,0.67,1.22,2017,18,5.37037037037037,0.6666666666666666,90,6,96,1.03125
2017-18,RegularSeason,203961,373,Eric Moreland,1610612765,DET,67,805,66,122,0.541,0,0,0.0,11,29,0.379,81,197,278,78,31,51,41,116,143,466,1.9,0.76,2017,18,2.1343283582089554,1.9024390243902438,56,18,74,3.7567567567567566
2017-18,RegularSeason,202705,374,MarShon Brooks,1610612763,MEM,7,193,51,102,0.5,19,32,0.594,20,23,0.87,8,13,21,25,11,3,16,6,141,131,1.56,0.69,2017,18,20.142857142857142,1.5625,51,3,54,0.3888888888888889
2017-18,RegularSeason,201148,375,Brandan Wright,1610612745,HOU,28,381,59,102,0.578,0,0,0.0,21,33,0.636,33,62,95,13,13,26,8,32,139,223,1.63,1.63,2017,18,4.964285714285714,1.625,43,12,55,1.7272727272727273
2017-18,RegularSeason,1627761,376,DeAndre' Bembry,1610612737,ATL,26,455,53,128,0.414,11,30,0.367,19,33,0.576,8,64,72,49,21,12,47,38,136,154,1.04,0.45,2017,18,5.230769230769231,1.0425531914893618,75,14,89,0.8089887640449438
2017-18,RegularSeason,201196,376,Ramon Sessions,1610612764,WAS,28,392,42,117,0.359,8,26,0.308,44,57,0.772,6,32,38,77,14,2,30,29,136,149,2.57,0.47,2017,18,4.857142857142857,2.566666666666667,75,13,88,0.4318181818181818
2017-18,RegularSeason,1627936,378,Alex Caruso,1610612747,LAL,37,562,50,116,0.431,13,43,0.302,21,30,0.7,15,50,65,75,23,10,42,52,134,190,1.79,0.55,2017,18,3.6216216216216215,1.7857142857142858,66,9,75,0.8666666666666667
2017-18,RegularSeason,1628436,378,Luke Kornet,1610612752,NYK,20,326,49,125,0.392,28,79,0.354,8,11,0.727,11,53,64,26,6,16,12,28,134,155,2.17,0.5,2017,18,6.7,2.1666666666666665,76,3,79,0.810126582278481
2017-18,RegularSeason,201976,378,Patrick Beverley,1610612746,LAC,11,334,48,119,0.403,24,60,0.4,14,17,0.824,16,29,45,32,19,5,25,34,134,136,1.28,0.76,2017,18,12.181818181818182,1.28,71,3,74,0.6081081081081081
2017-18,RegularSeason,1627786,381,Troy Williams,1610612752,NYK,21,307,51,109,0.468,11,38,0.289,20,30,0.667,22,41,63,16,20,4,19,34,133,149,0.84,1.05,2017,18,6.333333333333333,0.8421052631578947,58,10,68,0.9264705882352942
2017-18,RegularSeason,203457,382,Nerlens Noel,1610612742,DAL,30,472,55,105,0.524,0,1,0.0,21,28,0.75,48,120,168,20,31,22,26,59,131,289,0.77,1.19,2017,18,4.366666666666666,0.7692307692307693,50,7,57,2.9473684210526314
2017-18,RegularSeason,202389,382,Timofey Mozgov,1610612751,BKN,31,359,52,93,0.559,4,18,0.222,23,30,0.767,32,66,98,11,5,13,33,39,131,177,0.33,0.15,2017,18,4.225806451612903,0.3333333333333333,41,7,48,2.0416666666666665
2017-18,RegularSeason,1627827,384,Dorian Finney-Smith,1610612742,DAL,21,448,46,121,0.38,20,67,0.299,11,15,0.733,22,53,75,26,10,4,21,43,123,138,1.24,0.48,2017,18,5.857142857142857,1.2380952380952381,75,4,79,0.9493670886075949
2017-18,RegularSeason,203512,385,Lucas Nogueira,1610612761,TOR,49,418,49,80,0.613,5,19,0.263,19,28,0.679,18,69,87,22,23,43,16,49,122,241,1.38,1.44,2017,18,2.489795918367347,1.375,31,9,40,2.175
2017-18,RegularSeason,1627790,386,Ante Zizic,1610612739,CLE,32,214,49,67,0.731,0,0,0.0,21,29,0.724,24,36,60,5,2,13,11,30,119,162,0.46,0.18,2017,18,3.71875,0.45454545454545453,18,8,26,2.3076923076923075
2017-18,RegularSeason,203957,387,Dante Exum,1610612762,UTA,14,235,42,87,0.483,5,18,0.278,25,31,0.806,4,22,26,43,8,3,20,20,114,123,2.15,0.4,2017,18,8.142857142857142,2.15,45,6,51,0.5098039215686274
2017-18,RegularSeason,2731,387,Emeka Okafor,1610612740,NOP,26,353,48,95,0.505,0,0,0.0,18,22,0.818,47,73,120,8,8,25,13,30,114,211,0.61,0.61,2017,18,4.384615384615385,0.6153846153846154,47,4,51,2.3529411764705883
2017-18,RegularSeason,201160,389,Jason Smith,1610612764,WAS,33,285,45,115,0.391,4,32,0.125,19,21,0.905,18,35,53,14,3,13,16,44,113,108,0.88,0.19,2017,18,3.4242424242424243,0.875,70,2,72,0.7361111111111112
2017-18,RegularSeason,203086,390,Meyers Leonard,1610612757,POR,33,254,46,78,0.59,11,26,0.423,9,11,0.818,12,58,70,17,7,0,10,36,112,162,1.7,0.7,2017,18,3.393939393939394,1.7,32,2,34,2.0588235294117645
2017-18,RegularSeason,1627988,391,Myke Henry,1610612763,MEM,20,378,41,109,0.376,19,58,0.328,6,10,0.6,10,28,38,22,31,6,19,28,107,113,1.16,1.63,2017,18,5.35,1.1578947368421053,68,4,72,0.5277777777777778
2017-18,RegularSeason,203966,392,Jamil Wilson,1610612746,LAC,15,274,38,81,0.469,27,63,0.429,2,4,0.5,3,29,32,10,5,8,8,34,105,107,1.25,0.63,2017,18,7.0,1.25,43,2,45,0.7111111111111111
2017-18,RegularSeason,203960,393,JaKarr Sampson,1610612758,SAC,22,344,44,81,0.543,5,10,0.5,10,16,0.625,21,57,78,9,8,22,8,48,103,169,1.13,1.0,2017,18,4.681818181818182,1.125,37,6,43,1.813953488372093
2017-18,RegularSeason,2754,393,Tony Allen,1610612740,NOP,22,273,44,91,0.484,4,12,0.333,11,21,0.524,20,27,47,9,11,3,19,49,103,97,0.47,0.58,2017,18,4.681818181818182,0.47368421052631576,47,10,57,0.8245614035087719
2017-18,RegularSeason,202732,395,DeAndre Liggins,1610612740,NOP,58,724,40,106,0.377,19,53,0.358,2,5,0.4,7,68,75,48,37,14,20,81,101,186,2.4,1.85,2017,18,1.7413793103448276,2.4,66,3,69,1.0869565217391304
2017-18,RegularSeason,1627858,395,Kyle Collinsworth,1610612742,DAL,32,480,38,99,0.384,4,17,0.235,21,40,0.525,32,75,107,56,17,9,24,44,101,186,2.33,0.71,2017,18,3.15625,2.3333333333333335,61,19,80,1.3375
2017-18,RegularSeason,1627785,397,Isaiah Whitehead,1610612751,BKN,16,180,40,86,0.465,7,18,0.389,13,19,0.684,4,22,26,20,8,2,24,23,100,80,0.83,0.33,2017,18,6.25,0.8333333333333334,46,6,52,0.5
2017-18,RegularSeason,1628365,397,Markelle Fultz,1610612755,PHI,14,253,45,111,0.405,0,1,0.0,10,21,0.476,11,32,43,53,12,4,17,22,100,118,3.12,0.71,2017,18,7.142857142857143,3.1176470588235294,66,11,77,0.5584415584415584
2017-18,RegularSeason,1628405,399,Johnathan Motley,1610612742,DAL,11,176,40,75,0.533,1,6,0.167,15,28,0.536,14,35,49,7,3,2,9,18,96,100,0.78,0.33,2017,18,8.727272727272727,0.7777777777777778,35,13,48,1.0208333333333333
2017-18,RegularSeason,1628681,399,Rodney Purvis,1610612753,ORL,16,290,35,107,0.327,13,52,0.25,13,15,0.867,1,26,27,17,3,3,10,26,96,62,1.7,0.3,2017,18,6.0,1.7,72,2,74,0.36486486486486486
2017-18,RegularSeason,203922,401,Glenn Robinson III,1610612754,IND,23,338,36,85,0.424,14,34,0.412,9,11,0.818,11,26,37,17,13,1,5,14,95,107,3.4,2.6,2017,18,4.130434782608695,3.4,49,2,51,0.7254901960784313
2017-18,RegularSeason,1626175,402,Jordan Mickey,1610612748,MIA,23,284,39,82,0.476,2,16,0.125,13,19,0.684,18,63,81,9,6,10,18,36,93,132,0.5,0.33,2017,18,4.043478260869565,0.5,43,6,49,1.653061224489796
2017-18,RegularSeason,203585,403,Rodney McGruder,1610612748,MIA,18,299,36,73,0.493,15,35,0.429,4,8,0.5,11,22,33,17,8,3,4,21,91,107,4.25,2.0,2017,18,5.055555555555555,4.25,37,4,41,0.8048780487804879
2017-18,RegularSeason,1627781,404,Malachi Richardson,1610612761,TOR,26,323,30,90,0.333,12,40,0.3,17,22,0.773,5,29,34,13,10,1,10,27,89,72,1.3,1.0,2017,18,3.423076923076923,1.3,60,5,65,0.5230769230769231
2017-18,RegularSeason,1628409,405,Alec Peters,1610612756,PHX,20,225,28,74,0.378,18,58,0.31,8,10,0.8,8,29,37,12,2,2,4,13,82,83,3.0,0.5,2017,18,4.1,3.0,46,2,48,0.7708333333333334
2017-18,RegularSeason,1627823,405,Juancho Hernangomez,1610612743,DEN,25,277,29,75,0.387,14,50,0.28,10,12,0.833,18,36,54,12,6,3,9,25,82,100,1.33,0.67,2017,18,3.28,1.3333333333333333,46,2,48,1.125
2017-18,RegularSeason,1628439,407,Isaiah Hicks,1610612752,NYK,18,239,33,72,0.458,2,9,0.222,12,18,0.667,10,31,41,16,2,4,16,45,80,82,1.0,0.13,2017,18,4.444444444444445,1.0,39,6,45,0.9111111111111111
2017-18,RegularSeason,1627824,408,Guerschon Yabusele,1610612738,BOS,33,235,26,61,0.426,12,37,0.324,15,22,0.682,17,35,52,16,4,5,12,23,79,102,1.33,0.33,2017,18,2.393939393939394,1.3333333333333333,35,7,42,1.2380952380952381
2017-18,RegularSeason,1628503,409,Jamel Artis,1610612753,ORL,15,279,31,79,0.392,8,29,0.276,7,12,0.583,4,34,38,18,2,3,8,11,77,77,2.25,0.25,2017,18,5.133333333333334,2.25,48,5,53,0.7169811320754716
2017-18,RegularSeason,201166,410,Aaron Brooks,1610612750,MIN,32,189,28,69,0.406,11,31,0.355,8,11,0.727,7,10,17,20,6,0,11,28,75,63,1.82,0.55,2017,18,2.34375,1.8181818181818181,41,3,44,0.38636363636363635
2017-18,RegularSeason,204037,410,Travis Wear,1610612747,LAL,17,228,25,72,0.347,17,47,0.362,8,8,1.0,0,38,38,7,4,5,6,30,75,76,1.17,0.67,2017,18,4.411764705882353,1.1666666666666667,47,0,47,0.8085106382978723
2017-18,RegularSeason,1627883,412,Jalen Jones,1610612742,DAL,16,181,26,68,0.382,10,26,0.385,12,19,0.632,13,25,38,4,5,1,7,22,74,66,0.57,0.71,2017,18,4.625,0.5714285714285714,42,7,49,0.7755102040816326
2017-18,RegularSeason,201943,413,Brandon Jennings,1610612749,MIL,14,205,27,72,0.375,9,33,0.273,10,10,1.0,5,26,31,44,6,4,18,11,73,95,2.44,0.33,2017,18,5.214285714285714,2.4444444444444446,45,0,45,0.6888888888888889
2017-18,RegularSeason,203141,414,Mirza Teletovic,1610612749,MIL,10,159,25,57,0.439,21,45,0.467,0,0,0.0,3,20,23,10,4,1,7,14,71,70,1.43,0.57,2017,18,7.1,1.4285714285714286,32,0,32,0.71875
2017-18,RegularSeason,1627758,414,Ron Baker,1610612752,NYK,29,385,20,59,0.339,11,33,0.333,20,26,0.769,5,25,30,47,26,6,18,33,71,117,2.61,1.44,2017,18,2.4482758620689653,2.611111111111111,39,6,45,0.6666666666666666
2017-18,RegularSeason,1628510,416,Andrew White III,1610612737,ATL,15,209,25,73,0.342,18,49,0.367,1,4,0.25,4,30,34,6,3,1,8,12,69,54,0.75,0.38,2017,18,4.6,0.75,48,3,51,0.6666666666666666
2017-18,RegularSeason,1627780,416,Gary Payton II,1610612747,LAL,23,221,30,74,0.405,6,25,0.24,3,9,0.333,13,31,44,21,7,3,7,30,69,87,3.0,1.0,2017,18,3.0,3.0,44,6,50,0.88
2017-18,RegularSeason,1626173,418,Rashad Vaughn,1610612753,ORL,28,212,23,56,0.411,14,37,0.378,4,6,0.667,3,18,21,13,5,3,6,15,64,65,2.17,0.83,2017,18,2.2857142857142856,2.1666666666666665,33,2,35,0.6
2017-18,RegularSeason,1628432,419,Davon Reed,1610612756,PHX,21,242,22,76,0.289,11,38,0.289,8,12,0.667,2,37,39,13,10,2,10,17,63,59,1.3,1.0,2017,18,3.0,1.3,54,4,58,0.6724137931034483
2017-18,RegularSeason,202697,420,Iman Shumpert,1610612758,SAC,14,276,22,58,0.379,7,26,0.269,11,15,0.733,7,34,41,17,9,4,16,22,62,77,1.06,0.56,2017,18,4.428571428571429,1.0625,36,4,40,1.025
2017-18,RegularSeason,1628403,421,Caleb Swanigan,1610612757,POR,27,189,24,60,0.4,1,8,0.125,12,18,0.667,15,39,54,14,5,3,18,37,61,77,0.78,0.28,2017,18,2.259259259259259,0.7777777777777778,36,6,42,1.2857142857142858
2017-18,RegularSeason,1627884,421,Derrick Jones Jr.,1610612748,MIA,20,245,21,53,0.396,3,18,0.167,16,24,0.667,21,17,38,9,4,13,7,24,61,78,1.29,0.57,2017,18,3.05,1.2857142857142858,32,8,40,0.95
2017-18,RegularSeason,1626151,423,Aaron Harrison,1610612742,DAL,9,233,19,69,0.275,9,43,0.209,13,17,0.765,4,20,24,11,9,2,3,27,60,49,3.67,3.0,2017,18,6.666666666666667,3.6666666666666665,50,4,54,0.4444444444444444
2017-18,RegularSeason,1627875,424,Marcus Georges-Hunt,1610612750,MIN,42,224,21,48,0.438,4,15,0.267,13,21,0.619,7,9,16,7,6,0,3,32,59,50,2.33,2.0,2017,18,1.4047619047619047,2.3333333333333335,27,8,35,0.45714285714285713
2017-18,RegularSeason,1627770,425,Kay Felder,1610612765,DET,16,140,21,70,0.3,4,19,0.211,11,12,0.917,3,15,18,20,3,1,16,11,57,33,1.25,0.19,2017,18,3.5625,1.25,49,1,50,0.36
2017-18,RegularSeason,1626177,426,Dakari Johnson,1610612760,OKC,31,161,22,39,0.564,0,0,0.0,11,20,0.55,16,18,34,8,6,8,3,27,55,82,2.67,2.0,2017,18,1.7741935483870968,2.6666666666666665,17,9,26,1.3076923076923077
2017-18,RegularSeason,201589,427,Darrell Arthur,1610612743,DEN,19,141,22,47,0.468,8,23,0.348,2,3,0.667,3,12,15,9,8,3,15,22,54,48,0.6,0.53,2017,18,2.8421052631578947,0.6,25,1,26,0.5769230769230769
2017-18,RegularSeason,1628401,427,Derrick White,1610612759,SAS,17,139,16,33,0.485,8,13,0.615,14,20,0.7,5,21,26,9,4,3,6,8,54,67,1.5,0.67,2017,18,3.176470588235294,1.5,17,6,23,1.1304347826086956
2017-18,RegularSeason,204066,427,John Holland,1610612739,CLE,24,174,17,59,0.288,11,36,0.306,9,13,0.692,6,18,24,5,7,2,8,10,54,38,0.63,0.88,2017,18,2.25,0.625,42,4,46,0.5217391304347826
2017-18,RegularSeason,201628,430,Bobby Brown,1610612745,HOU,20,115,19,58,0.328,11,40,0.275,1,2,0.5,0,7,7,11,4,0,9,6,50,23,1.22,0.44,2017,18,2.5,1.2222222222222223,39,1,40,0.175
2017-18,RegularSeason,1627362,430,Briante Weber,1610612763,MEM,18,237,19,43,0.442,4,11,0.364,8,10,0.8,8,27,35,22,18,5,15,28,50,89,1.47,1.2,2017,18,2.7777777777777777,1.4666666666666666,24,2,26,1.3461538461538463
2017-18,RegularSeason,1627853,432,Ryan Arcidiacono,1610612741,CHI,24,304,17,41,0.415,9,31,0.29,5,6,0.833,1,24,25,35,13,0,13,18,48,83,2.69,1.0,2017,18,2.0,2.6923076923076925,24,1,25,1.0
2017-18,RegularSeason,1626191,433,Chris McCullough,1610612764,WAS,19,90,18,42,0.429,1,8,0.125,9,14,0.643,7,18,25,4,0,5,2,8,46,49,2.0,0.0,2017,18,2.4210526315789473,2.0,24,5,29,0.8620689655172413
2017-18,RegularSeason,203705,433,Josh Magette,1610612737,ATL,18,216,15,46,0.326,8,22,0.364,8,8,1.0,2,17,19,57,8,1,9,16,46,91,6.33,0.89,2017,18,2.5555555555555554,6.333333333333333,31,0,31,0.6129032258064516
2017-18,RegularSeason,202347,435,Quincy Pondexter,1610612741,CHI,23,196,14,49,0.286,3,22,0.136,14,17,0.824,8,19,27,9,8,2,11,24,45,42,0.82,0.73,2017,18,1.9565217391304348,0.8181818181818182,35,3,38,0.7105263157894737
2017-18,RegularSeason,1627744,436,Brice Johnson,1610612763,MEM,18,98,20,42,0.476,0,1,0.0,3,5,0.6,9,22,31,2,9,6,5,13,43,62,0.4,1.8,2017,18,2.388888888888889,0.4,22,2,24,1.2916666666666667
2017-18,RegularSeason,202720,436,Jon Leuer,1610612765,DET,8,136,15,36,0.417,0,3,0.0,13,15,0.867,7,25,32,5,1,3,7,16,43,54,0.71,0.14,2017,18,5.375,0.7142857142857143,21,2,23,1.391304347826087
2017-18,RegularSeason,204022,438,Jack Cooley,1610612758,SAC,7,87,13,27,0.481,0,0,0.0,14,19,0.737,14,16,30,6,1,0,3,13,40,55,2.0,0.33,2017,18,5.714285714285714,2.0,14,5,19,1.5789473684210527
2017-18,RegularSeason,1628444,439,Jabari Bird,1610612738,BOS,13,115,15,26,0.577,3,7,0.429,6,13,0.462,6,13,19,8,3,1,8,7,39,44,1.0,0.38,2017,18,3.0,1.0,11,7,18,1.0555555555555556
2017-18,RegularSeason,1626259,440,Malcolm Miller,1610612761,TOR,15,126,13,28,0.464,8,21,0.381,4,4,1.0,4,11,15,3,1,2,5,10,38,39,0.6,0.2,2017,18,2.533333333333333,0.6,15,0,15,1.0
2017-18,RegularSeason,1627735,440,Wade Baldwin IV,1610612757,POR,7,80,14,21,0.667,4,5,0.8,6,10,0.6,1,7,8,5,2,1,4,12,38,39,1.25,0.5,2017,18,5.428571428571429,1.25,7,4,11,0.7272727272727273
2017-18,RegularSeason,101106,442,Andrew Bogut,1610612747,LAL,24,216,17,25,0.68,0,0,0.0,2,2,1.0,26,52,78,15,4,13,19,40,36,119,0.79,0.21,2017,18,1.5,0.7894736842105263,8,0,8,9.75
2017-18,RegularSeason,1627834,442,Georgios Papagiannis,1610612757,POR,17,122,18,42,0.429,0,0,0.0,0,0,0.0,13,24,37,9,4,6,8,12,36,60,1.13,0.5,2017,18,2.1176470588235294,1.125,24,0,24,1.5416666666666667
2017-18,RegularSeason,1627774,444,Jake Layman,1610612757,POR,35,160,14,47,0.298,4,20,0.2,2,3,0.667,4,12,16,11,6,4,5,13,34,32,2.2,1.2,2017,18,0.9714285714285714,2.2,33,1,34,0.47058823529411764
2017-18,RegularSeason,1626780,444,Jonathan Gibson,1610612738,BOS,4,40,14,23,0.609,6,12,0.5,0,0,0.0,0,3,3,4,0,0,3,5,34,29,1.33,0.0,2017,18,8.5,1.3333333333333333,9,0,9,0.3333333333333333
2017-18,RegularSeason,1628495,444,Milton Doyle,1610612751,BKN,10,125,13,47,0.277,4,23,0.174,4,8,0.5,3,15,18,10,6,2,2,13,34,30,5.0,3.0,2017,18,3.4,5.0,34,4,38,0.47368421052631576
2017-18,RegularSeason,2863,447,Damien Wilkins,1610612754,IND,19,152,13,39,0.333,4,18,0.222,3,4,0.75,5,11,16,9,2,1,5,7,33,29,1.8,0.4,2017,18,1.736842105263158,1.8,26,1,27,0.5925925925925926
2017-18,RegularSeason,202348,447,Jordan Crawford,1610612740,NOP,5,53,12,27,0.444,8,14,0.571,1,1,1.0,2,2,4,13,1,1,5,7,33,32,2.6,0.2,2017,18,6.6,2.6,15,0,15,0.26666666666666666
2017-18,RegularSeason,1627982,449,Josh Gray,1610612756,PHX,5,86,11,41,0.268,3,13,0.231,7,11,0.636,2,8,10,12,8,2,7,8,32,23,1.71,1.14,2017,18,6.4,1.7142857142857142,30,4,34,0.29411764705882354
2017-18,RegularSeason,203485,449,Lorenzo Brown,1610612761,TOR,14,139,14,34,0.412,2,12,0.167,2,2,1.0,1,14,15,13,5,0,3,7,32,42,4.33,1.67,2017,18,2.2857142857142856,4.333333333333333,20,0,20,0.75
2017-18,RegularSeason,2555,451,Nick Collison,1610612760,OKC,15,75,13,19,0.684,0,0,0.0,5,13,0.385,7,13,20,4,0,0,7,7,31,34,0.57,0.0,2017,18,2.066666666666667,0.5714285714285714,6,8,14,1.4285714285714286
2017-18,RegularSeason,2210,452,Richard Jefferson,1610612743,DEN,20,163,12,27,0.444,2,7,0.286,4,7,0.571,2,15,17,15,2,1,5,11,30,42,3.0,0.4,2017,18,1.5,3.0,15,3,18,0.9444444444444444
2017-18,RegularSeason,1628476,453,Derrick Walton Jr.,1610612748,MIA,16,147,8,25,0.32,7,17,0.412,6,6,1.0,2,14,16,16,7,3,2,7,29,52,8.0,3.5,2017,18,1.8125,8.0,17,0,17,0.9411764705882353
2017-18,RegularSeason,203524,453,Solomon Hill,1610612740,NOP,12,187,11,41,0.268,4,21,0.19,3,6,0.5,9,27,36,22,7,1,9,22,29,53,2.44,0.78,2017,18,2.4166666666666665,2.4444444444444446,30,3,33,1.0909090909090908
2017-18,RegularSeason,1628504,453,Xavier Rathan-Mayes,1610612763,MEM,5,118,12,42,0.286,1,14,0.071,4,9,0.444,0,5,5,18,6,3,11,18,29,15,1.64,0.55,2017,18,5.8,1.6363636363636365,30,5,35,0.14285714285714285
2017-18,RegularSeason,1628537,456,Jaylen Morris,1610612737,ATL,6,98,13,32,0.406,2,10,0.2,0,0,0.0,2,14,16,7,2,1,6,2,28,29,1.17,0.33,2017,18,4.666666666666667,1.1666666666666667,19,0,19,0.8421052631578947
2017-18,RegularSeason,1628502,457,Nigel Hayes,1610612758,SAC,9,122,11,33,0.333,4,16,0.25,1,3,0.333,4,18,22,6,2,3,2,8,27,34,3.0,1.0,2017,18,3.0,3.0,22,2,24,0.9166666666666666
2017-18,RegularSeason,1627816,458,Alex Poythress,1610612754,IND,25,104,11,26,0.423,4,11,0.364,0,0,0.0,7,10,17,2,3,1,2,16,26,32,1.0,1.5,2017,18,1.04,1.0,15,0,15,1.1333333333333333
2017-18,RegularSeason,203998,458,Bruno Caboclo,1610612758,SAC,12,106,9,31,0.29,3,17,0.176,5,6,0.833,7,15,22,4,3,4,4,8,26,32,1.0,0.75,2017,18,2.1666666666666665,1.0,22,1,23,0.9565217391304348
2017-18,RegularSeason,1627745,460,Damian Jones,1610612744,GSW,15,89,11,22,0.5,0,0,0.0,3,5,0.6,5,9,14,2,1,3,4,14,25,28,0.5,0.25,2017,18,1.6666666666666667,0.5,11,2,13,1.0769230769230769
2017-18,RegularSeason,201281,461,Andre Ingram,1610612747,LAL,2,64,8,17,0.471,5,9,0.556,3,3,1.0,1,5,6,7,3,3,3,3,24,31,2.33,1.0,2017,18,12.0,2.3333333333333335,9,0,9,0.6666666666666666
2017-18,RegularSeason,1628499,462,Antonius Cleveland,1610612737,ATL,17,123,8,21,0.381,3,4,0.75,4,6,0.667,3,11,14,2,7,5,7,23,23,29,0.29,1.0,2017,18,1.3529411764705883,0.2857142857142857,13,2,15,0.9333333333333333
2017-18,RegularSeason,1627788,462,Furkan Korkmaz,1610612755,PHI,14,80,8,28,0.286,5,17,0.294,2,4,0.5,2,9,11,4,2,1,2,12,23,17,2.0,1.0,2017,18,1.6428571428571428,2.0,20,2,22,0.5
2017-18,RegularSeason,202713,462,Kyle Singler,1610612760,OKC,12,59,7,21,0.333,2,5,0.4,7,13,0.538,1,9,10,2,1,0,3,4,23,13,0.67,0.33,2017,18,1.9166666666666667,0.6666666666666666,14,6,20,0.5
2017-18,RegularSeason,204179,465,Omari Johnson,1610612763,MEM,4,75,9,21,0.429,4,12,0.333,0,0,0.0,4,7,11,7,2,0,3,6,22,27,2.33,0.67,2017,18,5.5,2.3333333333333335,12,0,12,0.9166666666666666
2017-18,RegularSeason,1628418,465,Thomas Bryant,1610612747,LAL,15,72,8,21,0.381,1,10,0.1,5,9,0.556,3,14,17,6,1,2,2,6,22,29,3.0,0.5,2017,18,1.4666666666666666,3.0,13,4,17,1.0
2017-18,RegularSeason,1627753,465,Zhou Qi,1610612745,HOU,18,124,6,32,0.188,2,19,0.105,8,12,0.667,6,16,22,2,2,14,10,14,22,22,0.2,0.2,2017,18,1.2222222222222223,0.2,26,4,30,0.7333333333333333
2017-18,RegularSeason,201600,465,Ömer Aşik,1610612741,CHI,18,182,9,22,0.409,0,0,0.0,4,13,0.308,9,38,47,3,2,4,9,20,22,47,0.33,0.22,2017,18,1.2222222222222223,0.3333333333333333,13,9,22,2.1363636363636362
2017-18,RegularSeason,203940,469,Adreian Payne,1610612753,ORL,5,43,7,10,0.7,2,3,0.667,5,6,0.833,2,7,9,0,2,0,2,6,21,26,0.0,1.0,2017,18,4.2,0.0,3,1,4,2.25
2017-18,RegularSeason,1628035,469,Alfonzo McKinnie,1610612761,TOR,14,53,8,15,0.533,3,9,0.333,2,3,0.667,1,6,7,1,1,1,3,8,21,20,0.33,0.33,2017,18,1.5,0.3333333333333333,7,1,8,0.875
2017-18,RegularSeason,1628391,469,D.J. Wilson,1610612749,MIL,22,71,9,16,0.563,2,5,0.4,1,2,0.5,2,8,10,3,3,1,4,7,21,26,0.75,0.75,2017,18,0.9545454545454546,0.75,7,1,8,1.25
2017-18,RegularSeason,1626210,472,Alan Williams,1610612756,PHX,5,70,7,18,0.389,0,0,0.0,6,9,0.667,3,19,22,8,5,1,7,13,20,35,1.14,0.71,2017,18,4.0,1.1428571428571428,11,3,14,1.5714285714285714
2017-18,RegularSeason,1628492,472,Gian Clavell,1610612742,DAL,7,64,6,18,0.333,6,15,0.4,2,2,1.0,1,6,7,3,2,0,2,8,20,18,1.5,1.0,2017,18,2.857142857142857,1.5,12,0,12,0.5833333333333334
2017-18,RegularSeason,1627855,472,Okaro White,1610612739,CLE,6,80,7,16,0.438,4,11,0.364,2,3,0.667,3,8,11,2,1,1,1,6,20,24,2.0,1.0,2017,18,3.3333333333333335,2.0,9,1,10,1.1
2017-18,RegularSeason,202933,475,Julyan Stone,1610612766,CHA,23,175,6,13,0.462,6,13,0.462,1,2,0.5,1,28,29,26,4,2,7,21,19,65,3.71,0.57,2017,18,0.8260869565217391,3.7142857142857144,7,1,8,3.625
2017-18,RegularSeason,1628443,475,Kadeem Allen,1610612738,BOS,18,107,6,22,0.273,0,11,0.0,7,9,0.778,4,7,11,12,3,2,9,15,19,20,1.33,0.33,2017,18,1.0555555555555556,1.3333333333333333,16,2,18,0.6111111111111112
2017-18,RegularSeason,1626154,475,RJ Hunter,1610612745,HOU,5,45,7,20,0.35,3,14,0.214,2,2,1.0,0,5,5,3,3,0,2,7,19,15,1.5,1.5,2017,18,3.8,1.5,13,0,13,0.38461538461538464
2017-18,RegularSeason,202391,478,Jeremy Lin,1610612751,BKN,1,25,5,12,0.417,1,2,0.5,7,7,1.0,0,0,0,4,0,0,3,3,18,12,1.33,0.0,2017,18,18.0,1.3333333333333333,7,0,7,0.0
2017-18,RegularSeason,1627866,479,Jameel Warney,1610612742,DAL,3,27,7,12,0.583,0,0,0.0,3,5,0.6,4,5,9,0,0,0,1,2,17,18,0.0,0.0,2017,18,5.666666666666667,0.0,5,2,7,1.2857142857142858
2017-18,RegularSeason,203923,479,James Young,1610612755,PHI,6,61,5,14,0.357,3,10,0.3,4,6,0.667,0,2,2,2,0,0,1,4,17,9,2.0,0.0,2017,18,2.8333333333333335,2.0,9,2,11,0.18181818181818182
2017-18,RegularSeason,203580,479,Larry Drew II,1610612740,NOP,10,70,7,24,0.292,3,9,0.333,0,0,0.0,3,0,3,10,0,0,3,6,17,10,3.33,0.0,2017,18,1.7,3.3333333333333335,17,0,17,0.17647058823529413
2017-18,RegularSeason,1627215,479,Walt Lemon Jr.,1610612740,NOP,5,35,7,16,0.438,1,1,1.0,2,3,0.667,0,2,2,5,0,1,4,5,17,11,1.25,0.0,2017,18,3.4,1.25,9,1,10,0.2
2017-18,RegularSeason,1626199,483,Darrun Hilliard,1610612759,SAS,14,95,5,19,0.263,0,6,0.0,6,7,0.857,0,7,7,11,2,0,4,7,16,17,2.75,0.5,2017,18,1.1428571428571428,2.75,14,1,15,0.4666666666666667
2017-18,RegularSeason,1627743,483,Demetrius Jackson,1610612755,PHI,15,80,7,18,0.389,1,7,0.143,1,2,0.5,5,7,12,9,5,1,10,7,16,21,0.9,0.5,2017,18,1.0666666666666667,0.9,11,1,12,1.0
2017-18,RegularSeason,1627821,483,James Webb III,1610612751,BKN,10,120,6,24,0.25,4,19,0.211,0,0,0.0,8,16,24,4,1,0,4,10,16,23,1.0,0.25,2017,18,1.6,1.0,18,0,18,1.3333333333333333
2017-18,RegularSeason,203481,486,Jeff Withey,1610612742,DAL,10,39,6,16,0.375,2,10,0.2,1,2,0.5,1,9,10,0,0,3,2,3,15,15,0.0,0.0,2017,18,1.5,0.0,10,1,11,0.9090909090909091
2017-18,RegularSeason,1627850,487,Marshall Plumlee,1610612749,MIL,8,52,1,3,0.333,0,0,0.0,12,16,0.75,4,13,17,2,0,1,3,10,14,25,0.67,0.0,2017,18,1.75,0.6666666666666666,2,4,6,2.8333333333333335
2017-18,RegularSeason,1628387,488,Ike Anigbogu,1610612754,IND,11,30,4,9,0.444,0,0,0.0,5,6,0.833,5,4,9,0,1,3,2,1,13,18,0.0,0.5,2017,18,1.1818181818181819,0.0,5,1,6,1.5
2017-18,RegularSeason,202332,489,Cole Aldrich,1610612750,MIN,21,49,5,15,0.333,0,0,0.0,2,6,0.333,3,12,15,3,2,1,1,11,12,18,3.0,2.0,2017,18,0.5714285714285714,3.0,10,4,14,1.0714285714285714
2017-18,RegularSeason,1627772,489,Daniel Hamilton,1610612760,OKC,6,28,5,11,0.455,2,5,0.4,0,0,0.0,0,5,5,8,1,0,2,2,12,18,4.0,0.5,2017,18,2.0,4.0,6,0,6,0.8333333333333334
2017-18,RegularSeason,201149,489,Joakim Noah,1610612752,NYK,7,40,5,10,0.5,0,0,0.0,2,4,0.5,6,8,14,4,2,2,4,5,12,23,1.0,0.5,2017,18,1.7142857142857142,1.0,5,2,7,2.0
2017-18,RegularSeason,1627779,489,Marcus Paige,1610612766,CHA,5,28,4,14,0.286,2,8,0.25,2,2,1.0,0,4,4,3,0,0,0,0,12,9,0.0,0.0,2017,18,2.4,inf,10,0,10,0.4
2017-18,RegularSeason,203104,493,Marquis Teague,1610612763,MEM,3,74,4,16,0.25,1,4,0.25,2,5,0.4,1,5,6,13,4,0,3,5,11,16,4.33,1.33,2017,18,3.6666666666666665,4.333333333333333,12,3,15,0.4
2017-18,RegularSeason,204065,494,David Stockton,1610612762,UTA,3,9,2,3,0.667,2,3,0.667,4,4,1.0,0,0,0,0,0,0,1,3,10,8,0.0,0.0,2017,18,3.3333333333333335,0.0,1,0,1,0.0
2017-18,RegularSeason,1628420,494,Monte Morris,1610612743,DEN,3,25,4,6,0.667,0,1,0.0,2,2,1.0,0,2,2,7,3,0,1,1,10,19,7.0,3.0,2017,18,3.3333333333333335,7.0,2,0,2,1.0
2017-18,RegularSeason,1627777,496,Georges Niang,1610612762,UTA,9,32,4,11,0.364,0,4,0.0,1,2,0.5,3,6,9,3,2,0,3,1,9,12,1.0,0.67,2017,18,1.0,1.0,7,1,8,1.125
2017-18,RegularSeason,1627762,496,Joel Bolomboy,1610612749,MIL,6,38,3,6,0.5,0,1,0.0,3,6,0.5,6,4,10,0,2,0,2,3,9,13,0.0,1.0,2017,18,1.5,0.0,3,3,6,1.6666666666666667
2017-18,RegularSeason,1628935,498,Aaron Jackson,1610612745,HOU,1,35,3,9,0.333,1,4,0.25,1,2,0.5,2,1,3,1,0,0,1,4,8,4,1.0,0.0,2017,18,8.0,1.0,6,1,7,0.42857142857142855
2017-18,RegularSeason,203949,498,James Michael McAdoo,1610612755,PHI,3,18,2,7,0.286,2,7,0.286,2,2,1.0,0,2,2,0,0,1,1,1,8,5,0.0,0.0,2017,18,2.6666666666666665,0.0,5,0,5,0.4
2017-18,RegularSeason,1628493,498,Mangok Mathiang,1610612766,CHA,4,20,4,7,0.571,0,0,0.0,0,1,0.0,3,7,10,0,1,0,0,5,8,15,0.0,0.0,2017,18,2.0,,3,1,4,2.5
2017-18,RegularSeason,1628396,498,Tony Bradley,1610612762,UTA,9,29,3,11,0.273,0,1,0.0,2,2,1.0,4,7,11,1,0,0,0,1,8,12,0.0,0.0,2017,18,0.8888888888888888,inf,8,0,8,1.375
2017-18,RegularSeason,2617,498,Udonis Haslem,1610612748,MIA,14,72,3,15,0.2,1,8,0.125,1,2,0.5,3,7,10,5,0,2,2,3,8,10,2.5,0.0,2017,18,0.5714285714285714,2.5,12,1,13,0.7692307692307693
2017-18,RegularSeason,1628506,503,London Perrantes,1610612739,CLE,14,66,2,13,0.154,0,3,0.0,3,5,0.6,1,3,4,5,2,1,1,6,7,5,5.0,2.0,2017,18,0.5,5.0,11,2,13,0.3076923076923077
2017-18,RegularSeason,1628429,504,Charles Cooke,1610612740,NOP,13,38,2,14,0.143,1,8,0.125,1,2,0.5,0,2,2,1,1,0,1,0,6,-4,1.0,1.0,2017,18,0.46153846153846156,1.0,12,1,13,0.15384615384615385
2017-18,RegularSeason,1626205,504,Vincent Hunter,1610612763,MEM,4,7,3,5,0.6,0,0,0.0,0,0,0.0,2,1,3,0,0,1,1,0,6,7,0.0,0.0,2017,18,1.5,0.0,2,0,2,1.5
2017-18,RegularSeason,203900,506,Markel Brown,1610612745,HOU,4,31,2,7,0.286,1,5,0.2,0,0,0.0,1,4,5,2,0,0,2,6,5,5,1.0,0.0,2017,18,1.25,1.0,5,0,5,1.0
2017-18,RegularSeason,1628475,506,Matt Williams Jr.,1610612748,MIA,3,11,2,6,0.333,1,5,0.2,0,0,0.0,0,1,1,0,0,0,1,1,5,1,0.0,0.0,2017,18,1.6666666666666667,0.0,4,0,4,0.25
2017-18,RegularSeason,1627778,508,Chinanu Onuaku,1610612745,HOU,1,22,2,5,0.4,0,0,0.0,0,0,0.0,1,3,4,1,0,0,3,4,4,3,0.33,0.0,2017,18,4.0,0.3333333333333333,3,0,3,1.3333333333333333
2017-18,RegularSeason,1628451,508,Jacob Wiley,1610612751,BKN,5,33,1,4,0.25,1,2,0.5,1,2,0.5,2,9,11,2,1,0,0,4,4,14,0.0,0.0,2017,18,0.8,inf,3,1,4,2.75
2017-18,RegularSeason,1627856,508,Matt Costello,1610612759,SAS,4,32,2,4,0.5,0,0,0.0,0,0,0.0,1,8,9,2,2,2,1,7,4,16,2.0,2.0,2017,18,1.0,2.0,2,0,2,4.5
2017-18,RegularSeason,1627817,508,Tim Quarterman,1610612745,HOU,3,13,1,3,0.333,0,2,0.0,2,2,1.0,0,3,3,1,0,0,2,1,4,4,0.5,0.0,2017,18,1.3333333333333333,0.5,2,0,2,1.5
2017-18,RegularSeason,1626148,512,Anthony Brown,1610612750,MIN,1,4,1,1,1.0,1,1,1.0,0,0,0.0,0,0,0,1,0,0,0,0,3,4,0.0,0.0,2017,18,3.0,inf,0,0,0,
2017-18,RegularSeason,2570,512,Kendrick Perkins,1610612739,CLE,1,15,1,2,0.5,0,0,0.0,1,2,0.5,0,1,1,2,1,0,1,1,3,4,2.0,1.0,2017,18,3.0,2.0,1,1,2,0.5
2017-18,RegularSeason,1628513,512,Naz Mitrou-Long,1610612762,UTA,1,1,1,1,1.0,1,1,1.0,0,0,0.0,0,0,0,0,0,0,0,0,3,3,0.0,0.0,2017,18,3.0,,0,0,0,
2017-18,RegularSeason,203687,512,Reggie Hearn,1610612765,DET,3,7,1,2,0.5,1,2,0.5,0,0,0.0,0,0,0,0,0,0,0,0,3,2,0.0,0.0,2017,18,1.0,,1,0,1,0.0
2017-18,RegularSeason,203505,512,Vander Blue,1610612747,LAL,5,45,1,5,0.2,0,2,0.0,1,2,0.5,0,1,1,3,1,0,3,2,3,0,1.0,0.33,2017,18,0.6,1.0,4,1,5,0.2
2017-18,RegularSeason,204098,512,Xavier Munford,1610612749,MIL,6,21,1,6,0.167,0,2,0.0,1,2,0.5,1,0,1,4,1,0,2,4,3,1,2.0,0.5,2017,18,0.5,2.0,5,1,6,0.16666666666666666
2017-18,RegularSeason,202682,518,Derrick Williams,1610612747,LAL,2,9,1,4,0.25,0,2,0.0,0,0,0.0,0,1,1,0,0,0,0,0,2,0,0.0,0.0,2017,18,1.0,,3,0,3,0.3333333333333333
2017-18,RegularSeason,1628421,518,Devin Robinson,1610612764,WAS,1,13,1,3,0.333,0,0,0.0,0,0,0.0,2,3,5,0,1,0,0,2,2,6,0.0,0.0,2017,18,2.0,,2,0,2,2.5
2017-18,RegularSeason,1628410,518,Edmond Sumner,1610612754,IND,1,2,1,1,1.0,0,0,0.0,0,0,0.0,0,1,1,0,0,0,0,1,2,3,0.0,0.0,2017,18,2.0,,0,0,0,inf
2017-18,RegularSeason,202330,518,Gordon Hayward,1610612738,BOS,1,5,1,2,0.5,0,1,0.0,0,0,0.0,0,1,1,0,0,0,0,1,2,2,0.0,0.0,2017,18,2.0,,1,0,1,1.0
2017-18,RegularSeason,1626643,518,Jacob Pullen,1610612755,PHI,3,6,1,2,0.5,0,1,0.0,0,0,0.0,0,0,0,0,0,0,1,0,2,0,0.0,0.0,2017,18,0.6666666666666666,0.0,1,0,1,0.0
2017-18,RegularSeason,202379,518,Jeremy Evans,1610612737,ATL,1,5,1,1,1.0,0,0,0.0,0,0,0.0,1,0,1,0,0,0,1,1,2,2,0.0,0.0,2017,18,2.0,0.0,0,0,0,inf
2017-18,RegularSeason,2746,518,Josh Smith,1610612740,NOP,3,12,1,4,0.25,0,0,0.0,0,0,0.0,3,1,4,0,0,0,0,3,2,3,0.0,0.0,2017,18,0.6666666666666666,,3,0,3,1.3333333333333333
2017-18,RegularSeason,1628383,518,Justin Patton,1610612750,MIN,1,4,1,2,0.5,0,0,0.0,0,0,0.0,0,0,0,0,1,0,0,1,2,2,0.0,0.0,2017,18,2.0,,1,0,1,0.0
2017-18,RegularSeason,2736,518,Luol Deng,1610612747,LAL,1,13,1,2,0.5,0,0,0.0,0,0,0.0,0,0,0,1,1,0,1,0,2,2,1.0,1.0,2017,18,2.0,1.0,1,0,1,0.0
2017-18,RegularSeason,203489,518,Nate Wolters,1610612762,UTA,5,19,1,6,0.167,0,0,0.0,0,0,0.0,1,1,2,1,0,0,0,1,2,0,0.0,0.0,2017,18,0.4,inf,5,0,5,0.4
2017-18,RegularSeason,1628408,518,PJ Dozier,1610612760,OKC,2,3,1,2,0.5,0,0,0.0,0,0,0.0,0,1,1,0,0,0,1,1,2,1,0.0,0.0,2017,18,1.0,0.0,1,0,1,1.0
2017-18,RegularSeason,203816,529,Scotty Hopson,1610612742,DAL,1,8,0,1,0.0,0,0,0.0,1,2,0.5,0,0,0,1,0,0,1,0,1,-1,1.0,0.0,2017,18,1.0,1.0,1,1,2,0.0
2017-18,RegularSeason,1628500,530,Ben Moore,1610612754,IND,2,9,0,0,0.0,0,0,0.0,0,0,0.0,0,1,1,1,0,0,0,4,0,2,0.0,0.0,2017,18,0.0,inf,0,0,0,inf
2017-18,RegularSeason,1628449,530,Chris Boucher,1610612744,GSW,1,1,0,1,0.0,0,1,0.0,0,0,0.0,0,1,1,0,0,0,0,0,0,0,0.0,0.0,2017,18,0.0,,1,0,1,1.0
2017-18,RegularSeason,1628571,530,Erik McCree,1610612762,UTA,4,8,0,2,0.0,0,1,0.0,0,0,0.0,0,1,1,0,1,0,1,0,0,-1,0.0,1.0,2017,18,0.0,0.0,2,0,2,0.5
2017-18,RegularSeason,204067,530,Jarell Eddie,1610612741,CHI,3,9,0,2,0.0,0,2,0.0,0,0,0.0,0,1,1,0,1,0,0,0,0,0,0.0,0.0,2017,18,0.0,,2,0,2,0.5
2017-18,RegularSeason,201177,530,Josh McRoberts,1610612742,DAL,2,6,0,1,0.0,0,1,0.0,0,0,0.0,0,0,0,0,0,0,0,2,0,-1,0.0,0.0,2017,18,0.0,,1,0,1,0.0
2017-18,RegularSeason,1626242,530,Luis Montero,1610612765,DET,2,8,0,1,0.0,0,0,0.0,0,0,0.0,0,2,2,0,0,0,2,0,0,-1,0.0,0.0,2017,18,0.0,0.0,1,0,1,2.0
2017-18,RegularSeason,1627851,530,Mindaugas Kuzminskas,1610612752,NYK,1,2,0,2,0.0,0,0,0.0,0,0,0.0,0,0,0,0,0,0,0,0,0,-2,0.0,0.0,2017,18,0.0,,2,0,2,0.0
2017-18,RegularSeason,1627852,530,Nicolas Brussino,1610612737,ATL,4,10,0,2,0.0,0,2,0.0,0,0,0.0,0,3,3,0,0,0,0,0,0,1,0.0,0.0,2017,18,0.0,,2,0,2,1.5
2017-18,RegularSeason,203590,530,Trey McKinney-Jones,1610612754,IND,1,1,0,0,0.0,0,0,0.0,0,0,0.0,0,0,0,0,0,0,0,0,0,0,0.0,0.0,2017,18,0.0,,0,0,0,
2017-18,RegularSeason,1628399,530,Tyler Lydon,1610612743,DEN,1,2,0,0,0.0,0,0,0.0,0,0,0.0,0,0,0,0,0,0,0,0,0,0,0.0,0.0,2017,18,0.0,,0,0,0,
2017-18,RegularSeason,202918,530,Xavier Silas,1610612738,BOS,2,8,0,3,0.0,0,2,0.0,0,0,0.0,1,1,2,0,1,0,0,1,0,0,0.0,0.0,2017,18,0.0,,3,0,3,0.6666666666666666
2017-18,Playoffs,2544,1,LeBron James,1610612739,CLE,22,922,275,510,0.539,39,114,0.342,159,213,0.746,31,169,200,198,30,23,94,52,748,816,2.11,0.32,2017,18,34.0,2.106382978723404,235,54,289,0.6920415224913494
2017-18,Playoffs,201142,2,Kevin Durant,1610612744,GSW,21,807,212,435,0.487,47,138,0.341,137,152,0.901,13,150,163,99,15,25,50,43,608,622,1.98,0.3,2017,18,28.952380952380953,1.98,223,15,238,0.6848739495798319
2017-18,Playoffs,201935,3,James Harden,1610612745,HOU,17,621,158,385,0.41,52,174,0.299,118,133,0.887,14,75,89,116,38,11,65,46,486,433,1.78,0.58,2017,18,28.58823529411765,1.7846153846153847,227,15,242,0.3677685950413223
2017-18,Playoffs,202691,4,Klay Thompson,1610612744,GSW,21,794,159,342,0.465,67,157,0.427,27,31,0.871,11,75,86,38,16,6,31,48,412,340,1.23,0.52,2017,18,19.61904761904762,1.2258064516129032,183,4,187,0.45989304812834225
2017-18,Playoffs,201939,5,Stephen Curry,1610612744,GSW,15,555,137,304,0.451,64,162,0.395,45,47,0.957,9,82,91,81,26,11,43,38,383,380,1.88,0.6,2017,18,25.533333333333335,1.8837209302325582,167,2,169,0.5384615384615384
2017-18,Playoffs,1628369,6,Jayson Tatum,1610612738,BOS,19,683,123,261,0.471,23,71,0.324,82,97,0.845,10,73,83,52,23,10,41,50,351,325,1.27,0.56,2017,18,18.473684210526315,1.2682926829268293,138,15,153,0.5424836601307189
2017-18,Playoffs,1627759,7,Jaylen Brown,1610612738,BOS,18,583,124,266,0.466,44,112,0.393,32,50,0.64,16,71,87,26,14,10,23,58,324,278,1.13,0.61,2017,18,18.0,1.1304347826086956,142,18,160,0.54375
2017-18,Playoffs,101108,8,Chris Paul,1610612745,HOU,15,517,118,257,0.459,37,99,0.374,44,53,0.83,9,80,89,87,30,4,28,47,317,351,3.11,1.07,2017,18,21.133333333333333,3.107142857142857,139,9,148,0.6013513513513513
2017-18,Playoffs,201567,9,Kevin Love,1610612739,CLE,21,660,109,278,0.392,36,106,0.34,59,64,0.922,49,166,215,34,15,8,41,58,313,370,0.83,0.37,2017,18,14.904761904761905,0.8292682926829268,169,5,174,1.235632183908046
2017-18,Playoffs,1626179,9,Terry Rozier,1610612738,BOS,19,696,108,266,0.406,51,147,0.347,46,56,0.821,8,92,100,109,24,6,22,38,313,362,4.96,1.09,2017,18,16.473684210526315,4.954545454545454,158,10,168,0.5952380952380952
2017-18,Playoffs,201143,11,Al Horford,1610612738,BOS,19,679,111,204,0.544,15,43,0.349,62,75,0.827,32,125,157,63,19,22,32,39,299,422,1.97,0.59,2017,18,15.736842105263158,1.96875,93,13,106,1.4811320754716981
2017-18,Playoffs,203076,12,Anthony Davis,1610612740,NOP,9,358,106,204,0.52,6,22,0.273,53,64,0.828,24,97,121,15,18,21,23,30,271,314,0.65,0.78,2017,18,30.11111111111111,0.6521739130434783,98,11,109,1.110091743119266
2017-18,Playoffs,1628378,13,Donovan Mitchell,1610612762,UTA,11,411,102,243,0.42,25,80,0.313,39,43,0.907,9,56,65,46,16,4,32,35,268,222,1.44,0.5,2017,18,24.363636363636363,1.4375,141,4,145,0.4482758620689655
2017-18,Playoffs,201569,14,Eric Gordon,1610612745,HOU,17,549,84,221,0.38,43,130,0.331,51,61,0.836,9,36,45,28,10,8,24,29,262,182,1.17,0.42,2017,18,15.411764705882353,1.1666666666666667,137,10,147,0.30612244897959184
2017-18,Playoffs,202694,15,Marcus Morris Sr.,1610612738,BOS,19,562,82,223,0.368,30,72,0.417,42,59,0.712,20,83,103,21,7,5,19,60,236,195,1.1,0.37,2017,18,12.421052631578947,1.105263157894737,141,17,158,0.6518987341772152
2017-18,Playoffs,201942,16,DeMar DeRozan,1610612761,TOR,10,354,87,199,0.437,10,35,0.286,43,53,0.811,6,30,36,40,5,6,23,24,227,169,1.74,0.22,2017,18,22.7,1.7391304347826086,112,10,122,0.29508196721311475
2017-18,Playoffs,203110,17,Draymond Green,1610612744,GSW,21,819,83,192,0.432,21,79,0.266,39,49,0.796,42,180,222,171,41,31,63,75,226,509,2.71,0.65,2017,18,10.761904761904763,2.7142857142857144,109,10,119,1.865546218487395
2017-18,Playoffs,203991,18,Clint Capela,1610612745,HOU,17,520,95,144,0.66,0,0,0.0,26,55,0.473,61,136,197,22,14,36,15,38,216,392,1.47,0.93,2017,18,12.705882352941176,1.4666666666666666,49,29,78,2.5256410256410255
2017-18,Playoffs,201950,19,Jrue Holiday,1610612740,NOP,9,348,88,170,0.518,16,50,0.32,21,30,0.7,9,42,51,57,10,5,23,22,213,222,2.48,0.43,2017,18,23.666666666666668,2.4782608695652173,82,9,91,0.5604395604395604
2017-18,Playoffs,2747,20,JR Smith,1610612739,CLE,22,706,65,187,0.348,44,120,0.367,17,22,0.773,10,50,60,25,21,4,19,54,191,155,1.32,1.1,2017,18,8.681818181818182,1.3157894736842106,122,5,127,0.47244094488188976
2017-18,Playoffs,200755,21,JJ Redick,1610612755,PHI,10,342,60,135,0.444,26,75,0.347,36,42,0.857,3,12,15,26,8,1,11,21,182,140,2.36,0.73,2017,18,18.2,2.3636363636363638,75,6,81,0.18518518518518517
2017-18,Playoffs,2594,21,Kyle Korver,1610612739,CLE,22,505,59,141,0.418,45,109,0.413,19,22,0.864,6,46,52,19,9,9,14,44,182,172,1.36,0.64,2017,18,8.272727272727273,1.3571428571428572,82,3,85,0.611764705882353
2017-18,Playoffs,203507,23,Giannis Antetokounmpo,1610612749,MIL,7,280,69,121,0.57,4,14,0.286,38,55,0.691,8,59,67,44,10,6,17,28,180,221,2.59,0.59,2017,18,25.714285714285715,2.588235294117647,52,17,69,0.9710144927536232
2017-18,Playoffs,201566,24,Russell Westbrook,1610612760,OKC,6,235,64,161,0.398,15,42,0.357,33,40,0.825,11,61,72,45,9,0,31,21,176,167,1.45,0.29,2017,18,29.333333333333332,1.4516129032258065,97,7,104,0.6923076923076923
2017-18,Playoffs,201588,25,George Hill,1610612739,CLE,19,557,59,131,0.45,16,51,0.314,41,53,0.774,13,28,41,42,10,8,22,52,175,170,1.91,0.46,2017,18,9.210526315789474,1.9090909090909092,72,12,84,0.4880952380952381
2017-18,Playoffs,200768,26,Kyle Lowry,1610612761,TOR,10,361,60,118,0.508,28,63,0.444,26,32,0.813,2,41,43,85,15,0,31,33,174,222,2.74,0.48,2017,18,17.4,2.7419354838709675,58,6,64,0.671875
2017-18,Playoffs,203114,27,Khris Middleton,1610612749,MIL,7,275,67,112,0.598,25,41,0.61,14,19,0.737,1,35,36,22,6,5,16,30,173,176,1.38,0.38,2017,18,24.714285714285715,1.375,45,5,50,0.72
2017-18,Playoffs,203967,28,Dario Saric,1610612755,PHI,10,329,59,140,0.421,20,52,0.385,34,40,0.85,32,41,73,35,10,4,15,28,172,192,2.33,0.67,2017,18,17.2,2.3333333333333335,81,6,87,0.8390804597701149
2017-18,Playoffs,203954,29,Joel Embiid,1610612755,PHI,8,278,60,138,0.435,8,29,0.276,43,61,0.705,23,78,101,24,7,14,29,31,171,192,0.83,0.24,2017,18,21.375,0.8275862068965517,78,18,96,1.0520833333333333
2017-18,Playoffs,201145,30,Jeff Green,1610612739,CLE,22,523,58,142,0.408,21,70,0.3,33,46,0.717,7,46,53,32,7,15,17,36,170,163,1.88,0.41,2017,18,7.7272727272727275,1.8823529411764706,84,13,97,0.5463917525773195
2017-18,Playoffs,1627732,31,Ben Simmons,1610612755,PHI,10,369,61,125,0.488,0,1,0.0,41,58,0.707,16,78,94,77,17,8,44,34,163,234,1.75,0.39,2017,18,16.3,1.75,64,17,81,1.1604938271604939
2017-18,Playoffs,204060,32,Joe Ingles,1610612762,UTA,11,382,57,121,0.471,35,77,0.455,11,17,0.647,5,43,48,37,6,2,26,29,160,157,1.42,0.23,2017,18,14.545454545454545,1.4230769230769231,64,6,70,0.6857142857142857
2017-18,Playoffs,203506,33,Victor Oladipo,1610612754,IND,7,261,53,127,0.417,23,57,0.404,30,41,0.732,3,55,58,42,17,3,24,11,159,170,1.75,0.71,2017,18,22.714285714285715,1.75,74,11,85,0.6823529411764706
2017-18,Playoffs,202322,34,John Wall,1610612764,WAS,6,234,56,127,0.441,4,21,0.19,40,47,0.851,3,31,34,69,14,8,27,16,156,176,2.56,0.52,2017,18,26.0,2.5555555555555554,71,7,78,0.4358974358974359
2017-18,Playoffs,200782,35,P.J. Tucker,1610612745,HOU,17,569,52,108,0.481,35,75,0.467,12,18,0.667,23,88,111,22,11,13,14,46,151,232,1.57,0.79,2017,18,8.882352941176471,1.5714285714285714,56,6,62,1.7903225806451613
2017-18,Playoffs,2772,36,Trevor Ariza,1610612745,HOU,17,582,50,139,0.36,26,91,0.286,23,31,0.742,9,56,65,22,19,2,10,44,149,150,2.2,1.9,2017,18,8.764705882352942,2.2,89,8,97,0.6701030927835051
2017-18,Playoffs,202331,37,Paul George,1610612760,OKC,6,251,49,120,0.408,19,52,0.365,31,36,0.861,4,32,36,16,8,4,24,17,148,112,0.67,0.33,2017,18,24.666666666666668,0.6666666666666666,71,5,76,0.47368421052631576
2017-18,Playoffs,203935,38,Marcus Smart,1610612738,BOS,15,449,48,143,0.336,15,68,0.221,36,49,0.735,14,42,56,80,26,10,36,44,147,175,2.22,0.72,2017,18,9.8,2.2222222222222223,95,13,108,0.5185185185185185
2017-18,Playoffs,202685,39,Jonas Valanciunas,1610612761,TOR,10,244,58,107,0.542,2,5,0.4,28,34,0.824,30,75,105,12,4,15,19,22,146,208,0.63,0.21,2017,18,14.6,0.631578947368421,49,6,55,1.9090909090909092
2017-18,Playoffs,203497,40,Rudy Gobert,1610612762,UTA,11,383,55,84,0.655,0,0,0.0,35,58,0.603,43,75,118,11,10,25,21,34,145,236,0.52,0.48,2017,18,13.181818181818182,0.5238095238095238,29,23,52,2.269230769230769
2017-18,Playoffs,2733,41,Shaun Livingston,1610612744,GSW,21,362,59,110,0.536,0,1,0.0,22,25,0.88,11,36,47,31,7,1,16,33,140,156,1.94,0.44,2017,18,6.666666666666667,1.9375,51,3,54,0.8703703703703703
2017-18,Playoffs,203078,42,Bradley Beal,1610612764,WAS,6,216,49,108,0.454,21,45,0.467,20,23,0.87,2,18,20,17,7,2,15,19,139,108,1.13,0.47,2017,18,23.166666666666668,1.1333333333333333,59,3,62,0.3225806451612903
2017-18,Playoffs,202703,43,Nikola Mirotic,1610612740,NOP,9,320,49,102,0.48,22,51,0.431,15,19,0.789,9,77,86,15,10,12,10,24,135,191,1.5,1.0,2017,18,15.0,1.5,53,4,57,1.5087719298245614
2017-18,Playoffs,201158,44,Marco Belinelli,1610612755,PHI,10,273,43,106,0.406,16,46,0.348,27,31,0.871,1,20,21,20,7,0,4,20,129,106,5.0,1.75,2017,18,12.9,5.0,63,4,67,0.31343283582089554
2017-18,Playoffs,2738,45,Andre Iguodala,1610612744,GSW,15,401,42,85,0.494,14,37,0.378,24,34,0.706,11,57,68,41,21,7,14,29,122,192,2.93,1.5,2017,18,8.133333333333333,2.9285714285714284,43,10,53,1.2830188679245282
2017-18,Playoffs,200746,46,LaMarcus Aldridge,1610612759,SAS,5,176,37,80,0.463,3,5,0.6,41,42,0.976,13,33,46,12,3,2,9,9,118,128,1.33,0.33,2017,18,23.6,1.3333333333333333,43,1,44,1.0454545454545454
2017-18,Playoffs,202684,46,Tristan Thompson,1610612739,CLE,19,416,49,83,0.59,0,1,0.0,20,27,0.741,44,68,112,11,2,8,11,26,118,199,1.0,0.18,2017,18,6.2105263157894735,1.0,34,7,41,2.731707317073171
2017-18,Playoffs,203382,48,Aron Baynes,1610612738,BOS,19,389,45,89,0.506,11,23,0.478,13,18,0.722,45,73,118,19,4,11,8,43,114,209,2.38,0.5,2017,18,6.0,2.375,44,5,49,2.4081632653061225
2017-18,Playoffs,203109,49,Jae Crowder,1610612762,UTA,11,323,35,108,0.324,22,66,0.333,18,28,0.643,4,52,56,19,15,2,14,25,110,105,1.36,1.07,2017,18,10.0,1.3571428571428572,73,10,83,0.6746987951807228
2017-18,Playoffs,101123,50,Gerald Green,1610612745,HOU,17,272,37,94,0.394,27,72,0.375,6,7,0.857,6,44,50,1,4,7,10,27,107,101,0.1,0.4,2017,18,6.294117647058823,0.1,57,1,58,0.8620689655172413
2017-18,Playoffs,202324,51,Derrick Favors,1610612762,UTA,11,286,42,68,0.618,2,5,0.4,16,33,0.485,20,37,57,13,8,11,10,17,102,138,1.3,0.8,2017,18,9.272727272727273,1.3,26,17,43,1.3255813953488371
2017-18,Playoffs,202734,51,E'Twaun Moore,1610612740,NOP,9,284,41,88,0.466,9,25,0.36,11,16,0.688,6,17,23,15,6,1,11,20,102,84,1.36,0.55,2017,18,11.333333333333334,1.3636363636363635,47,5,52,0.4423076923076923
2017-18,Playoffs,203468,53,CJ McCollum,1610612757,POR,4,155,40,77,0.519,11,26,0.423,10,13,0.769,0,8,8,14,5,1,9,11,101,80,1.56,0.56,2017,18,25.25,1.5555555555555556,37,3,40,0.2
2017-18,Playoffs,101139,54,CJ Miles,1610612761,TOR,10,227,32,71,0.451,19,45,0.422,13,16,0.813,6,18,24,8,7,3,9,21,96,87,0.89,0.78,2017,18,9.6,0.8888888888888888,39,3,42,0.5714285714285714
2017-18,Playoffs,1626204,54,Larry Nance Jr.,1610612739,CLE,20,307,41,60,0.683,0,1,0.0,14,31,0.452,35,55,90,18,16,14,12,35,96,186,1.5,1.33,2017,18,4.8,1.5,19,17,36,2.5
2017-18,Playoffs,202339,56,Eric Bledsoe,1610612749,MIL,7,225,37,84,0.44,7,22,0.318,14,20,0.7,3,22,25,26,7,6,15,19,95,91,1.73,0.47,2017,18,13.571428571428571,1.7333333333333334,47,6,53,0.4716981132075472
2017-18,Playoffs,101141,57,Ersan Ilyasova,1610612755,PHI,10,233,36,84,0.429,9,31,0.29,12,21,0.571,26,50,76,13,7,4,10,25,93,126,1.3,0.7,2017,18,9.3,1.3,48,9,57,1.3333333333333333
2017-18,Playoffs,201609,57,Goran Dragic,1610612748,MIA,5,156,35,75,0.467,8,21,0.381,15,22,0.682,3,10,13,23,5,0,15,15,93,72,1.53,0.33,2017,18,18.6,1.5333333333333334,40,7,47,0.2765957446808511
2017-18,Playoffs,200765,57,Rajon Rondo,1610612740,NOP,9,302,38,92,0.413,8,19,0.421,9,14,0.643,9,59,68,110,13,2,33,20,93,194,3.33,0.39,2017,18,10.333333333333334,3.3333333333333335,54,5,59,1.152542372881356
2017-18,Playoffs,203918,60,Rodney Hood,1610612739,CLE,17,260,39,92,0.424,4,24,0.167,9,12,0.75,7,24,31,18,5,4,13,30,91,80,1.39,0.39,2017,18,5.352941176470588,1.3846153846153846,53,3,56,0.5535714285714286
2017-18,Playoffs,203903,61,Jordan Clarkson,1610612739,CLE,19,286,37,123,0.301,11,46,0.239,5,6,0.833,9,23,32,13,8,3,13,21,90,46,1.0,0.61,2017,18,4.7368421052631575,1.0,86,1,87,0.367816091954023
2017-18,Playoffs,202711,62,Bojan Bogdanovic,1610612754,IND,7,238,32,81,0.395,17,45,0.378,6,10,0.6,1,23,24,13,6,0,13,23,87,64,1.0,0.46,2017,18,12.428571428571429,1.0,49,4,53,0.4528301886792453
2017-18,Playoffs,1627734,62,Domantas Sabonis,1610612754,IND,7,166,36,62,0.581,1,7,0.143,14,18,0.778,14,18,32,5,1,2,7,22,87,90,0.71,0.14,2017,18,12.428571428571429,0.7142857142857143,26,4,30,1.0666666666666667
2017-18,Playoffs,1626167,62,Myles Turner,1610612754,IND,7,196,33,54,0.611,6,13,0.462,15,19,0.789,6,30,36,4,2,4,11,25,87,97,0.36,0.18,2017,18,12.428571428571429,0.36363636363636365,21,4,25,1.44
2017-18,Playoffs,201586,62,Serge Ibaka,1610612761,TOR,10,260,30,72,0.417,9,24,0.375,18,22,0.818,13,46,59,11,1,13,16,21,87,109,0.69,0.06,2017,18,8.7,0.6875,42,4,46,1.2826086956521738
2017-18,Playoffs,1626153,66,Delon Wright,1610612761,TOR,10,215,31,68,0.456,9,21,0.429,15,16,0.938,3,19,22,23,15,9,9,10,86,108,2.56,1.67,2017,18,8.6,2.5555555555555554,37,1,38,0.5789473684210527
2017-18,Playoffs,1626172,66,Kevon Looney,1610612744,GSW,21,387,39,72,0.542,0,2,0.0,8,21,0.381,42,47,89,19,14,8,8,50,86,162,2.38,1.75,2017,18,4.095238095238095,2.375,33,13,46,1.934782608695652
2017-18,Playoffs,201580,68,JaVale McGee,1610612744,GSW,13,158,39,58,0.672,0,1,0.0,6,9,0.667,16,26,42,4,3,11,5,20,84,117,0.8,0.6,2017,18,6.461538461538462,0.8,19,3,22,1.9090909090909092
2017-18,Playoffs,201937,68,Ricky Rubio,1610612762,UTA,6,181,28,79,0.354,10,32,0.313,18,23,0.783,5,39,44,42,8,3,18,13,84,107,2.33,0.44,2017,18,14.0,2.3333333333333335,51,5,56,0.7857142857142857
2017-18,Playoffs,2548,70,Dwyane Wade,1610612748,MIA,5,127,31,70,0.443,0,4,0.0,21,26,0.808,3,18,21,18,7,1,11,11,83,75,1.64,0.64,2017,18,16.6,1.6363636363636365,39,5,44,0.4772727272727273
2017-18,Playoffs,202692,71,Alec Burks,1610612762,UTA,9,120,30,64,0.469,9,20,0.45,13,15,0.867,2,22,24,17,4,1,8,9,82,84,2.13,0.5,2017,18,9.11111111111111,2.125,34,2,36,0.6666666666666666
2017-18,Playoffs,1626188,72,Quinn Cook,1610612744,GSW,17,175,30,67,0.448,7,31,0.226,14,17,0.824,2,21,23,11,4,2,5,13,81,76,2.2,0.8,2017,18,4.764705882352941,2.2,37,3,40,0.575
2017-18,Playoffs,203496,72,Robert Covington,1610612755,PHI,10,281,27,83,0.325,15,48,0.313,12,16,0.75,12,41,53,25,11,9,11,30,81,108,2.27,1.0,2017,18,8.1,2.272727272727273,56,4,60,0.8833333333333333
2017-18,Playoffs,203952,74,Andrew Wiggins,1610612750,MIN,5,164,30,68,0.441,7,21,0.333,12,20,0.6,5,21,26,10,2,2,9,14,79,64,1.11,0.22,2017,18,15.8,1.1111111111111112,38,8,46,0.5652173913043478
2017-18,Playoffs,201954,74,Darren Collison,1610612754,IND,7,214,31,68,0.456,8,23,0.348,9,12,0.75,1,20,21,33,7,0,9,7,79,91,3.67,0.78,2017,18,11.285714285714286,3.6666666666666665,37,3,40,0.525
2017-18,Playoffs,202710,74,Jimmy Butler,1610612750,MIN,5,170,28,63,0.444,8,17,0.471,15,18,0.833,3,27,30,20,4,1,5,9,79,91,4.0,0.8,2017,18,15.8,4.0,35,3,38,0.7894736842105263
2017-18,Playoffs,1628384,74,OG Anunoby,1610612761,TOR,10,238,29,52,0.558,13,29,0.448,8,11,0.727,9,12,21,7,6,4,6,23,79,85,1.17,1.0,2017,18,7.9,1.1666666666666667,23,3,26,0.8076923076923077
2017-18,Playoffs,201152,74,Thaddeus Young,1610612754,IND,7,237,36,60,0.6,2,7,0.286,5,13,0.385,22,32,54,10,12,6,7,22,79,122,1.43,1.71,2017,18,11.285714285714286,1.4285714285714286,24,8,32,1.6875
2017-18,Playoffs,1626220,79,Royce O'Neale,1610612762,UTA,11,259,28,56,0.5,10,28,0.357,12,19,0.632,3,35,38,15,10,4,16,30,78,94,0.94,0.63,2017,18,7.090909090909091,0.9375,28,7,35,1.0857142857142856
2017-18,Playoffs,1626157,80,Karl-Anthony Towns,1610612750,MIN,5,170,28,60,0.467,3,11,0.273,17,23,0.739,15,52,67,11,2,5,12,14,76,111,0.92,0.17,2017,18,15.2,0.9166666666666666,32,6,38,1.763157894736842
2017-18,Playoffs,203081,81,Damian Lillard,1610612757,POR,4,162,25,71,0.352,9,30,0.3,15,17,0.882,3,15,18,19,5,0,16,8,74,52,1.19,0.31,2017,18,18.5,1.1875,46,2,48,0.375
2017-18,Playoffs,202362,82,Lance Stephenson,1610612754,IND,7,149,30,65,0.462,8,26,0.308,5,9,0.556,3,16,19,20,2,1,9,20,73,67,2.22,0.22,2017,18,10.428571428571429,2.2222222222222223,35,4,39,0.48717948717948717
2017-18,Playoffs,2546,83,Carmelo Anthony,1610612760,OKC,6,194,27,72,0.375,6,28,0.214,11,15,0.733,3,31,34,2,10,4,6,14,71,66,0.33,1.67,2017,18,11.833333333333334,0.3333333333333333,45,4,49,0.6938775510204082
2017-18,Playoffs,201565,83,Derrick Rose,1610612750,MIN,5,119,29,57,0.509,7,10,0.7,6,7,0.857,1,8,9,13,2,0,8,9,71,58,1.63,0.25,2017,18,14.2,1.625,28,1,29,0.3103448275862069
2017-18,Playoffs,203546,85,Ian Clark,1610612740,NOP,9,190,28,66,0.424,10,28,0.357,4,4,1.0,2,8,10,11,8,2,9,20,70,54,1.22,0.89,2017,18,7.777777777777778,1.2222222222222223,38,0,38,0.2631578947368421
2017-18,Playoffs,203953,85,Jabari Parker,1610612749,MIL,7,167,28,62,0.452,6,19,0.316,8,13,0.615,8,35,43,10,7,4,6,15,70,89,1.67,1.17,2017,18,10.0,1.6666666666666667,34,5,39,1.1025641025641026
2017-18,Playoffs,202329,87,Al-Farouq Aminu,1610612757,POR,4,131,27,52,0.519,13,30,0.433,2,2,1.0,12,24,36,5,4,2,6,8,69,85,0.83,0.67,2017,18,17.25,0.8333333333333334,25,0,25,1.44
2017-18,Playoffs,201988,88,Patty Mills,1610612759,SAS,5,165,25,57,0.439,13,35,0.371,4,5,0.8,2,8,10,13,3,1,9,15,67,52,1.44,0.33,2017,18,13.4,1.4444444444444444,32,1,33,0.30303030303030304
2017-18,Playoffs,1627783,89,Pascal Siakam,1610612761,TOR,10,179,25,41,0.61,3,4,0.75,13,20,0.65,9,27,36,8,1,6,7,27,66,87,1.14,0.14,2017,18,6.6,1.1428571428571428,16,7,23,1.565217391304348
2017-18,Playoffs,201952,90,Jeff Teague,1610612750,MIN,5,153,23,51,0.451,7,18,0.389,12,17,0.706,3,15,18,29,3,2,14,19,65,70,2.07,0.21,2017,18,13.0,2.0714285714285716,28,5,33,0.5454545454545454
2017-18,Playoffs,203118,90,Mike Scott,1610612764,WAS,6,126,26,41,0.634,7,11,0.636,6,6,1.0,6,15,21,4,2,1,5,10,65,73,0.8,0.4,2017,18,10.833333333333334,0.8,15,0,15,1.4
2017-18,Playoffs,203482,92,Kelly Olynyk,1610612748,MIA,5,146,21,44,0.477,8,19,0.421,14,20,0.7,7,16,23,19,7,6,8,19,64,82,2.38,0.88,2017,18,12.8,2.375,23,6,29,0.7931034482758621
2017-18,Playoffs,203500,93,Steven Adams,1610612760,OKC,6,200,27,46,0.587,0,0,0.0,9,13,0.692,19,26,45,9,4,4,4,15,63,98,2.25,1.0,2017,18,10.5,2.25,19,4,23,1.9565217391304348
2017-18,Playoffs,201949,94,James Johnson,1610612748,MIA,5,161,23,42,0.548,7,13,0.538,9,14,0.643,3,27,30,24,6,6,10,17,62,94,2.4,0.6,2017,18,12.4,2.4,19,5,24,1.25
2017-18,Playoffs,1627763,95,Malcolm Brogdon,1610612749,MIL,7,186,24,55,0.436,5,19,0.263,8,10,0.8,3,21,24,17,1,0,12,14,61,58,1.42,0.08,2017,18,8.714285714285714,1.4166666666666667,31,2,33,0.7272727272727273
2017-18,Playoffs,200752,95,Rudy Gay,1610612759,SAS,5,160,26,65,0.4,4,18,0.222,5,9,0.556,9,19,28,11,8,1,6,16,61,60,1.83,1.33,2017,18,12.2,1.8333333333333333,39,4,43,0.6511627906976745
2017-18,Playoffs,2561,97,David West,1610612744,GSW,18,175,27,45,0.6,1,2,0.5,4,4,1.0,11,26,37,32,6,10,10,23,59,116,3.2,0.6,2017,18,3.2777777777777777,3.2,18,0,18,2.0555555555555554
2017-18,Playoffs,2037,97,Jamal Crawford,1610612750,MIN,5,123,21,47,0.447,7,17,0.412,10,13,0.769,1,12,13,12,5,0,5,6,59,55,2.4,1.0,2017,18,11.8,2.4,26,3,29,0.4482758620689655
2017-18,Playoffs,202693,97,Markieff Morris,1610612764,WAS,6,181,24,49,0.49,2,12,0.167,9,10,0.9,14,31,45,10,4,5,6,22,59,91,1.67,0.67,2017,18,9.833333333333334,1.6666666666666667,25,1,26,1.7307692307692308
2017-18,Playoffs,1626162,100,Kelly Oubre Jr.,1610612764,WAS,6,148,18,48,0.375,4,19,0.211,16,18,0.889,1,22,23,4,6,3,5,16,56,55,0.8,1.2,2017,18,9.333333333333334,0.8,30,2,32,0.71875
2017-18,Playoffs,204456,101,T.J. McConnell,1610612755,PHI,10,155,25,36,0.694,2,3,0.667,3,5,0.6,6,20,26,23,6,0,6,13,55,91,3.83,1.0,2017,18,5.5,3.8333333333333335,11,2,13,2.0
2017-18,Playoffs,202328,102,Greg Monroe,1610612738,BOS,11,105,19,38,0.5,0,0,0.0,15,22,0.682,14,21,35,5,2,2,14,9,53,57,0.36,0.14,2017,18,4.818181818181818,0.35714285714285715,19,7,26,1.3461538461538463
2017-18,Playoffs,101162,103,Marcin Gortat,1610612764,WAS,6,160,24,43,0.558,0,0,0.0,4,7,0.571,13,25,38,6,0,2,6,15,52,70,1.0,0.0,2017,18,8.666666666666666,1.0,19,3,22,1.7272727272727273
2017-18,Playoffs,201156,103,Nick Young,1610612744,GSW,20,206,16,53,0.302,14,47,0.298,6,8,0.75,1,11,12,4,1,0,2,18,52,28,2.0,0.5,2017,18,2.6,2.0,37,2,39,0.3076923076923077
2017-18,Playoffs,203957,105,Dante Exum,1610612762,UTA,10,114,20,41,0.488,2,7,0.286,9,12,0.75,4,10,14,10,1,1,15,15,51,38,0.67,0.07,2017,18,5.1,0.6666666666666666,21,3,24,0.5833333333333334
2017-18,Playoffs,203490,106,Otto Porter Jr.,1610612764,WAS,5,158,20,41,0.488,5,12,0.417,5,8,0.625,1,24,25,8,6,5,3,6,50,67,2.67,2.0,2017,18,10.0,2.6666666666666665,21,3,24,1.0416666666666667
2017-18,Playoffs,1627751,107,Jakob Poeltl,1610612761,TOR,9,140,17,31,0.548,0,1,0.0,15,19,0.789,15,21,36,6,3,4,8,25,49,72,0.75,0.38,2017,18,5.444444444444445,0.75,14,4,18,2.0
2017-18,Playoffs,1626159,107,Justise Winslow,1610612748,MIA,5,125,15,42,0.357,7,19,0.368,12,17,0.706,7,26,33,13,4,4,8,17,49,63,1.63,0.5,2017,18,9.8,1.625,27,5,32,1.03125
2017-18,Playoffs,203994,109,Jusuf Nurkic,1610612757,POR,4,94,19,39,0.487,0,0,0.0,9,11,0.818,12,20,32,4,6,5,3,14,47,69,1.33,2.0,2017,18,11.75,1.3333333333333333,20,2,22,1.4545454545454546
2017-18,Playoffs,1938,110,Manu Ginobili,1610612759,SAS,5,107,15,37,0.405,6,18,0.333,9,11,0.818,1,14,15,16,7,1,7,13,45,53,2.29,1.0,2017,18,9.0,2.2857142857142856,22,2,24,0.625
2017-18,Playoffs,203121,111,Darius Miller,1610612740,NOP,9,162,14,34,0.412,9,24,0.375,6,6,1.0,2,18,20,11,5,0,6,10,43,53,1.83,0.83,2017,18,4.777777777777778,1.8333333333333333,20,0,20,1.0
2017-18,Playoffs,203924,111,Jerami Grant,1610612760,OKC,6,133,18,35,0.514,2,8,0.25,5,11,0.455,8,12,20,6,4,3,6,15,43,47,1.0,0.67,2017,18,7.166666666666667,1.0,17,6,23,0.8695652173913043
2017-18,Playoffs,1626196,113,Josh Richardson,1610612748,MIA,5,130,15,40,0.375,6,19,0.316,6,7,0.857,4,11,15,14,11,5,5,17,42,56,2.8,2.2,2017,18,8.4,2.8,25,1,26,0.5769230769230769
2017-18,Playoffs,1627832,114,Fred VanVleet,1610612761,TOR,6,114,13,39,0.333,8,28,0.286,7,8,0.875,0,10,10,13,0,0,4,8,41,33,3.25,0.0,2017,18,6.833333333333333,3.25,26,1,27,0.37037037037037035
2017-18,Playoffs,1628395,114,Jordan Bell,1610612744,GSW,17,173,17,32,0.531,0,1,0.0,7,14,0.5,15,32,47,15,6,9,6,18,41,90,2.5,1.0,2017,18,2.411764705882353,2.5,15,7,22,2.1363636363636362
2017-18,Playoffs,203499,114,Shane Larkin,1610612738,BOS,11,154,16,35,0.457,4,13,0.308,5,5,1.0,1,10,11,20,5,0,6,15,41,52,3.33,0.83,2017,18,3.727272727272727,3.3333333333333335,19,0,19,0.5789473684210527
2017-18,Playoffs,204020,117,Tyler Johnson,1610612748,MIA,5,81,14,26,0.538,6,10,0.6,6,7,0.857,1,7,8,4,2,0,2,14,40,39,2.0,1.0,2017,18,8.0,2.0,12,1,13,0.6153846153846154
2017-18,Playoffs,1627749,118,Dejounte Murray,1610612759,SAS,5,96,14,31,0.452,4,6,0.667,7,9,0.778,4,17,21,9,5,2,5,11,39,52,1.8,1.0,2017,18,7.8,1.8,17,2,19,1.105263157894737
2017-18,Playoffs,201961,118,Wayne Ellington,1610612748,MIA,5,101,12,35,0.343,12,30,0.4,3,3,1.0,1,7,8,3,2,2,3,9,39,28,1.0,0.67,2017,18,7.8,1.0,23,0,23,0.34782608695652173
2017-18,Playoffs,201147,120,Corey Brewer,1610612760,OKC,6,151,13,25,0.52,5,11,0.455,6,6,1.0,4,9,13,5,7,5,2,17,37,53,2.5,3.5,2017,18,6.166666666666667,2.5,12,0,12,1.0833333333333333
2017-18,Playoffs,202709,121,Cory Joseph,1610612754,IND,7,143,12,33,0.364,3,11,0.273,6,6,1.0,2,15,17,21,9,2,4,10,33,57,5.25,2.25,2017,18,4.714285714285714,5.25,21,0,21,0.8095238095238095
2017-18,Playoffs,203524,121,Solomon Hill,1610612740,NOP,9,114,9,25,0.36,6,16,0.375,9,10,0.9,6,11,17,7,1,1,6,17,33,36,1.17,0.17,2017,18,3.6666666666666665,1.1666666666666667,16,1,17,1.0
2017-18,Playoffs,1627748,121,Thon Maker,1610612749,MIL,6,130,11,28,0.393,6,20,0.3,5,7,0.714,6,17,23,5,2,11,4,17,33,51,1.25,0.5,2017,18,5.5,1.25,17,2,19,1.2105263157894737
2017-18,Playoffs,2225,121,Tony Parker,1610612759,SAS,5,67,14,37,0.378,0,5,0.0,5,7,0.714,0,4,4,6,2,0,4,2,33,16,1.5,0.5,2017,18,6.6,1.5,23,2,25,0.16
2017-18,Playoffs,1628400,125,Semi Ojeleye,1610612738,BOS,17,230,10,33,0.303,6,22,0.273,6,7,0.857,4,24,28,2,3,0,2,21,32,39,1.0,1.5,2017,18,1.8823529411764706,1.0,23,1,24,1.1666666666666667
2017-18,Playoffs,2403,126,Nene,1610612745,HOU,11,107,12,20,0.6,0,0,0.0,7,11,0.636,6,22,28,5,2,5,8,18,31,51,0.63,0.25,2017,18,2.8181818181818183,0.625,8,4,12,2.3333333333333335
2017-18,Playoffs,101109,126,Raymond Felton,1610612760,OKC,6,79,12,31,0.387,7,14,0.5,0,2,0.0,2,11,13,9,4,2,5,7,31,33,1.8,0.8,2017,18,5.166666666666667,1.8,19,2,21,0.6190476190476191
2017-18,Playoffs,201959,126,Taj Gibson,1610612750,MIN,5,123,14,22,0.636,0,0,0.0,3,3,1.0,7,13,20,2,1,2,4,8,31,44,0.5,0.25,2017,18,6.2,0.5,8,0,8,2.5
2017-18,Playoffs,101133,129,Ian Mahinmi,1610612764,WAS,6,52,10,14,0.714,0,0,0.0,10,11,0.909,4,7,11,1,4,5,1,10,30,45,1.0,4.0,2017,18,5.0,1.0,4,1,5,2.2
2017-18,Playoffs,2200,129,Pau Gasol,1610612759,SAS,5,90,10,20,0.5,1,3,0.333,9,10,0.9,2,22,24,14,0,1,6,5,30,52,2.33,0.0,2017,18,6.0,2.3333333333333335,10,1,11,2.1818181818181817
2017-18,Playoffs,201951,131,Ty Lawson,1610612764,WAS,5,96,9,26,0.346,5,8,0.625,6,6,1.0,2,11,13,15,3,0,3,6,29,40,5.0,1.0,2017,18,5.8,5.0,17,0,17,0.7647058823529411
2017-18,Playoffs,202323,132,Evan Turner,1610612757,POR,3,87,12,33,0.364,2,7,0.286,2,2,1.0,5,7,12,10,3,1,6,8,28,27,1.67,0.5,2017,18,9.333333333333334,1.6666666666666667,21,0,21,0.5714285714285714
2017-18,Playoffs,1628380,132,Zach Collins,1610612757,POR,4,70,11,30,0.367,3,14,0.214,3,4,0.75,3,9,12,6,3,2,2,10,28,29,3.0,1.5,2017,18,7.0,3.0,19,1,20,0.6
2017-18,Playoffs,203937,134,Kyle Anderson,1610612759,SAS,5,73,12,20,0.6,0,4,0.0,3,4,0.75,5,8,13,3,6,1,3,10,27,38,1.0,2.0,2017,18,5.4,1.0,8,1,9,1.4444444444444444
2017-18,Playoffs,101161,135,Amir Johnson,1610612755,PHI,8,94,11,21,0.524,0,0,0.0,4,5,0.8,14,9,23,9,2,1,3,10,26,47,3.0,0.67,2017,18,3.25,3.0,10,1,11,2.090909090909091
2017-18,Playoffs,202355,135,Hassan Whiteside,1610612748,MIA,5,77,9,20,0.45,0,0,0.0,8,13,0.615,10,20,30,1,0,6,12,16,26,35,0.08,0.0,2017,18,5.2,0.08333333333333333,11,5,16,1.875
2017-18,Playoffs,201601,137,Luc Mbah a Moute,1610612745,HOU,9,149,9,36,0.25,3,15,0.2,4,7,0.571,3,19,22,3,6,4,6,8,25,24,0.5,1.0,2017,18,2.7777777777777777,0.5,27,3,30,0.7333333333333333
2017-18,Playoffs,203498,137,Shabazz Muhammad,1610612749,MIL,4,29,9,20,0.45,4,5,0.8,3,5,0.6,0,4,4,0,2,1,2,2,25,17,0.0,1.0,2017,18,6.25,0.0,11,2,13,0.3076923076923077
2017-18,Playoffs,203518,139,Alex Abrines,1610612760,OKC,6,110,8,20,0.4,6,13,0.462,2,2,1.0,3,13,16,2,5,2,1,11,24,36,2.0,5.0,2017,18,4.0,2.0,12,0,12,1.3333333333333333
2017-18,Playoffs,101181,139,Jose Calderon,1610612739,CLE,13,104,9,26,0.346,4,18,0.222,2,2,1.0,2,9,11,9,5,0,5,15,24,27,1.8,1.0,2017,18,1.8461538461538463,1.8,17,0,17,0.6470588235294118
2017-18,Playoffs,202357,141,Nemanja Bjelica,1610612750,MIN,5,47,7,16,0.438,4,7,0.571,5,7,0.714,4,11,15,3,3,0,1,6,23,32,3.0,3.0,2017,18,4.6,3.0,9,2,11,1.3636363636363635
2017-18,Playoffs,201980,142,Danny Green,1610612759,SAS,5,103,8,30,0.267,5,20,0.25,0,0,0.0,4,7,11,1,1,4,2,8,21,14,0.5,0.5,2017,18,4.2,0.5,22,0,22,0.5
2017-18,Playoffs,203526,142,Raul Neto,1610612762,UTA,8,72,7,23,0.304,2,7,0.286,5,5,1.0,2,8,10,10,2,0,4,7,21,23,2.5,0.5,2017,18,2.625,2.5,16,0,16,0.625
2017-18,Playoffs,203089,144,John Henson,1610612749,MIL,2,74,9,13,0.692,0,0,0.0,1,2,0.5,4,8,12,5,0,7,4,4,19,34,1.25,0.0,2017,18,9.5,1.25,4,1,5,2.4
2017-18,Playoffs,201973,144,Jonas Jerebko,1610612762,UTA,10,79,8,19,0.421,1,6,0.167,2,2,1.0,4,12,16,3,3,0,1,9,19,29,3.0,3.0,2017,18,1.9,3.0,11,0,11,1.4545454545454546
2017-18,Playoffs,202348,144,Jordan Crawford,1610612740,NOP,2,15,8,13,0.615,3,8,0.375,0,0,0.0,0,4,4,1,1,0,3,1,19,17,0.33,0.33,2017,18,9.5,0.3333333333333333,5,0,5,0.8
2017-18,Playoffs,201583,144,Ryan Anderson,1610612745,HOU,11,95,7,20,0.35,5,15,0.333,0,0,0.0,4,9,13,6,3,1,3,10,19,26,2.0,1.0,2017,18,1.7272727272727273,2.0,13,0,13,1.0
2017-18,Playoffs,203503,144,Tony Snell,1610612749,MIL,7,134,7,24,0.292,5,21,0.238,0,0,0.0,1,12,13,4,3,4,3,10,19,23,1.33,1.0,2017,18,2.7142857142857144,1.3333333333333333,17,0,17,0.7647058823529411
2017-18,Playoffs,202344,149,Trevor Booker,1610612754,IND,7,64,6,10,0.6,0,1,0.0,6,7,0.857,5,13,18,0,1,1,1,12,18,32,0.0,1.0,2017,18,2.5714285714285716,0.0,4,1,5,3.6
2017-18,Playoffs,1628389,150,Bam Adebayo,1610612748,MIA,5,77,7,15,0.467,0,1,0.0,3,14,0.214,9,11,20,0,0,2,2,8,17,18,0.0,0.0,2017,18,3.4,0.0,8,11,19,1.0526315789473684
2017-18,Playoffs,1627854,150,Bryn Forbes,1610612759,SAS,4,54,5,17,0.294,2,9,0.222,5,7,0.714,1,2,3,2,0,0,0,3,17,8,0.0,0.0,2017,18,4.25,inf,12,2,14,0.21428571428571427
2017-18,Playoffs,202722,150,Dāvis Bertāns,1610612759,SAS,5,82,3,18,0.167,3,16,0.188,8,11,0.727,1,10,11,6,2,0,1,10,17,17,6.0,2.0,2017,18,3.4,6.0,15,3,18,0.6111111111111112
2017-18,Playoffs,203476,150,Gorgui Dieng,1610612750,MIN,5,70,6,18,0.333,2,5,0.4,3,4,0.75,3,15,18,4,2,4,1,6,17,31,4.0,2.0,2017,18,3.4,4.0,12,1,13,1.3846153846153846
2017-18,Playoffs,2585,150,Zaza Pachulia,1610612744,GSW,7,26,4,7,0.571,0,0,0.0,9,12,0.75,6,6,12,1,3,1,3,1,17,25,0.33,1.0,2017,18,2.4285714285714284,0.3333333333333333,3,3,6,2.0
2017-18,Playoffs,203090,155,Maurice Harkless,1610612757,POR,2,53,7,13,0.538,2,6,0.333,0,0,0.0,3,5,8,4,0,1,1,4,16,22,4.0,0.0,2017,18,8.0,4.0,6,0,6,1.3333333333333333
2017-18,Playoffs,1626192,155,Pat Connaughton,1610612757,POR,4,59,6,15,0.4,2,10,0.2,2,2,1.0,2,2,4,6,1,1,1,9,16,18,6.0,1.0,2017,18,4.0,6.0,9,0,9,0.4444444444444444
2017-18,Playoffs,1626224,157,Cedi Osman,1610612739,CLE,14,62,6,18,0.333,1,7,0.143,1,4,0.25,1,6,7,3,3,0,0,5,14,12,0.0,0.0,2017,18,1.0,inf,12,3,15,0.4666666666666667
2017-18,Playoffs,1627790,158,Ante Zizic,1610612739,CLE,8,23,5,10,0.5,0,0,0.0,3,6,0.5,1,5,6,1,0,1,2,2,13,11,0.5,0.0,2017,18,1.625,0.5,5,3,8,0.75
2017-18,Playoffs,1627846,159,Abdel Nader,1610612738,BOS,11,33,5,15,0.333,0,4,0.0,2,4,0.5,1,2,3,3,1,1,2,2,12,6,1.5,0.5,2017,18,1.0909090909090908,1.5,10,2,12,0.25
2017-18,Playoffs,2207,159,Joe Johnson,1610612745,HOU,8,54,6,17,0.353,0,3,0.0,0,0,0.0,0,10,10,3,0,1,3,4,12,12,1.0,0.0,2017,18,1.5,1.0,11,0,11,0.9090909090909091
2017-18,Playoffs,203521,159,Matthew Dellavedova,1610612749,MIL,6,78,4,12,0.333,2,9,0.222,2,2,1.0,1,4,5,16,2,0,6,6,12,21,2.67,0.33,2017,18,2.0,2.6666666666666665,8,0,8,0.625
2017-18,Playoffs,1626181,159,Norman Powell,1610612761,TOR,6,40,4,14,0.286,1,7,0.143,3,4,0.75,0,2,2,2,0,0,1,4,12,4,2.0,0.0,2017,18,2.0,2.0,10,1,11,0.18181818181818182
2017-18,Playoffs,202334,163,Ed Davis,1610612757,POR,4,71,5,10,0.5,0,0,0.0,1,4,0.25,5,27,32,0,0,1,4,7,11,32,0.0,0.0,2017,18,2.75,0.0,5,3,8,4.0
2017-18,Playoffs,203894,163,Shabazz Napier,1610612757,POR,2,35,5,11,0.455,0,4,0.0,1,2,0.5,0,2,2,3,3,0,6,1,11,6,0.5,0.5,2017,18,5.5,0.5,6,1,7,0.2857142857142857
2017-18,Playoffs,203092,163,Tyler Zeller,1610612749,MIL,7,66,4,5,0.8,0,0,0.0,3,4,0.75,2,12,14,3,4,3,1,11,11,32,3.0,4.0,2017,18,1.5714285714285714,3.0,1,1,2,7.0
2017-18,Playoffs,1627767,166,Cheick Diallo,1610612740,NOP,7,48,5,12,0.417,0,0,0.0,0,0,0.0,4,5,9,0,1,1,1,9,10,13,0.0,1.0,2017,18,1.4285714285714286,0.0,7,0,7,1.2857142857142858
2017-18,Playoffs,203485,167,Lorenzo Brown,1610612761,TOR,4,29,3,10,0.3,2,5,0.4,1,2,0.5,1,5,6,2,0,1,1,2,9,9,2.0,0.0,2017,18,2.25,2.0,7,1,8,0.75
2017-18,Playoffs,1626147,168,Justin Anderson,1610612755,PHI,7,33,3,8,0.375,2,7,0.286,0,0,0.0,1,8,9,0,1,0,2,8,8,11,0.0,0.5,2017,18,1.1428571428571428,0.0,5,0,5,1.8
2017-18,Playoffs,203086,168,Meyers Leonard,1610612757,POR,2,8,4,4,1.0,0,0,0.0,0,0,0.0,0,4,4,0,0,0,0,0,8,12,0.0,0.0,2017,18,4.0,,0,0,0,inf
2017-18,Playoffs,202335,168,Patrick Patterson,1610612760,OKC,6,58,3,6,0.5,2,4,0.5,0,0,0.0,1,10,11,3,1,0,3,8,8,17,1.0,0.33,2017,18,1.3333333333333333,1.0,3,0,3,3.6666666666666665
2017-18,Playoffs,1628401,171,Derrick White,1610612759,SAS,3,18,3,6,0.5,1,2,0.5,0,0,0.0,0,0,0,1,1,2,0,0,7,8,0.0,0.0,2017,18,2.3333333333333335,inf,3,0,3,0.0
2017-18,Playoffs,1628425,171,Sterling Brown,1610612749,MIL,3,13,3,5,0.6,1,3,0.333,0,0,0.0,1,1,2,0,1,0,0,2,7,8,0.0,0.0,2017,18,2.3333333333333335,,2,0,2,1.0
2017-18,Playoffs,203107,171,Tomas Satoransky,1610612764,WAS,6,60,2,13,0.154,0,3,0.0,3,4,0.75,5,4,9,3,0,0,3,4,7,4,1.0,0.0,2017,18,1.1666666666666667,1.0,11,1,12,0.75
2017-18,Playoffs,1627774,174,Jake Layman,1610612757,POR,1,8,3,3,1.0,0,0,0.0,0,0,0.0,0,1,1,1,2,0,0,0,6,10,0.0,0.0,2017,18,6.0,inf,0,0,0,inf
2017-18,Playoffs,1891,174,Jason Terry,1610612749,MIL,3,44,2,5,0.4,2,5,0.4,0,0,0.0,1,1,2,2,1,0,1,2,6,7,2.0,1.0,2017,18,2.0,2.0,3,0,3,0.6666666666666666
2017-18,Playoffs,1628935,176,Aaron Jackson,1610612745,HOU,7,17,2,4,0.5,0,2,0.0,1,2,0.5,2,2,4,2,0,0,2,2,5,6,1.0,0.0,2017,18,0.7142857142857143,1.0,2,1,3,1.3333333333333333
2017-18,Playoffs,1628365,176,Markelle Fultz,1610612755,PHI,3,23,1,7,0.143,0,0,0.0,3,4,0.75,0,3,3,5,2,0,1,4,5,7,5.0,2.0,2017,18,1.6666666666666667,5.0,6,1,7,0.42857142857142855
2017-18,Playoffs,201166,178,Aaron Brooks,1610612750,MIN,2,3,2,3,0.667,0,1,0.0,0,2,0.0,0,0,0,0,0,0,0,0,4,1,0.0,0.0,2017,18,2.0,,1,2,3,0.0
2017-18,Playoffs,1627745,178,Damian Jones,1610612744,GSW,4,11,1,2,0.5,0,0,0.0,2,3,0.667,1,2,3,0,0,0,3,4,4,2,0.0,0.0,2017,18,1.0,0.0,1,1,2,1.5
2017-18,Playoffs,1627824,178,Guerschon Yabusele,1610612738,BOS,12,48,1,9,0.111,0,6,0.0,2,5,0.4,3,8,11,3,2,0,0,9,4,9,0.0,0.0,2017,18,0.3333333333333333,inf,8,3,11,1.0
2017-18,Playoffs,1627775,178,Patrick McCaw,1610612744,GSW,6,16,1,2,0.5,0,1,0.0,2,2,1.0,1,2,3,0,2,0,0,1,4,8,0.0,0.0,2017,18,0.6666666666666666,,1,0,1,3.0
2017-18,Playoffs,1626145,178,Tyus Jones,1610612750,MIN,4,55,2,7,0.286,0,2,0.0,0,0,0.0,0,9,9,8,1,0,1,0,4,16,8.0,1.0,2017,18,1.0,8.0,5,0,5,1.8
2017-18,Playoffs,1627735,178,Wade Baldwin IV,1610612757,POR,4,19,1,4,0.25,1,1,1.0,1,2,0.5,0,3,3,3,1,1,3,1,4,5,1.0,0.33,2017,18,1.0,1.0,3,1,4,0.75
2017-18,Playoffs,1628403,184,Caleb Swanigan,1610612757,POR,1,8,0,2,0.0,0,1,0.0,3,4,0.75,0,2,2,1,0,0,1,1,3,2,1.0,0.0,2017,18,3.0,1.0,2,1,3,0.6666666666666666
2017-18,Playoffs,1627788,184,Furkan Korkmaz,1610612755,PHI,1,2,1,1,1.0,1,1,1.0,0,0,0.0,0,0,0,0,0,0,0,1,3,3,0.0,0.0,2017,18,3.0,,0,0,0,
2017-18,Playoffs,203962,184,Josh Huestis,1610612760,OKC,4,19,1,2,0.5,0,0,0.0,1,2,0.5,0,3,3,0,1,1,0,3,3,6,0.0,0.0,2017,18,0.75,,1,1,2,1.5
2017-18,Playoffs,1628390,184,Terrance Ferguson,1610612760,OKC,3,6,1,1,1.0,1,1,1.0,0,0,0.0,1,0,1,1,0,0,0,2,3,5,0.0,0.0,2017,18,1.0,inf,0,0,0,inf
2017-18,Playoffs,201943,188,Brandon Jennings,1610612749,MIL,1,5,0,2,0.0,0,2,0.0,2,2,1.0,0,0,0,0,0,0,1,0,2,-1,0.0,0.0,2017,18,2.0,0.0,2,0,2,0.0
2017-18,Playoffs,204065,188,David Stockton,1610612762,UTA,2,6,1,3,0.333,0,1,0.0,0,0,0.0,0,1,1,0,0,0,0,1,2,1,0.0,0.0,2017,18,1.0,,2,0,2,0.5
2017-18,Playoffs,202327,188,Ekpe Udoh,1610612762,UTA,6,21,1,1,1.0,0,0,0.0,0,4,0.0,1,2,3,0,0,2,1,2,2,2,0.0,0.0,2017,18,0.3333333333333333,0.0,0,4,4,0.75
2017-18,Playoffs,203922,188,Glenn Robinson III,1610612754,IND,2,6,1,1,1.0,0,0,0.0,0,0,0.0,0,1,1,0,0,0,0,0,2,3,0.0,0.0,2017,18,1.0,,0,0,0,inf
2017-18,Playoffs,203530,188,Joffrey Lauvergne,1610612759,SAS,1,6,1,1,1.0,0,0,0.0,0,0,0.0,0,1,1,0,0,0,0,0,2,3,0.0,0.0,2017,18,2.0,,0,0,0,inf
2017-18,Playoffs,203585,188,Rodney McGruder,1610612748,MIA,4,16,1,4,0.25,0,2,0.0,0,0,0.0,0,4,4,0,0,0,0,3,2,3,0.0,0.0,2017,18,0.5,,3,0,3,1.3333333333333333
2017-18,Playoffs,204028,188,Tarik Black,1610612745,HOU,7,19,1,4,0.25,0,0,0.0,0,0,0.0,2,4,6,2,0,1,1,5,2,7,2.0,0.0,2017,18,0.2857142857142857,2.0,3,0,3,2.0
2017-18,Playoffs,1628396,188,Tony Bradley,1610612762,UTA,1,2,1,2,0.5,0,0,0.0,0,0,0.0,1,0,1,0,0,0,0,0,2,2,0.0,0.0,2017,18,2.0,,1,0,1,1.0
2017-18,Playoffs,1627753,188,Zhou Qi,1610612745,HOU,3,6,1,1,1.0,0,0,0.0,0,0,0.0,0,1,1,0,0,0,0,0,2,3,0.0,0.0,2017,18,0.6666666666666666,,0,0,0,inf
2017-18,Playoffs,202732,197,DeAndre Liggins,1610612740,NOP,3,14,0,1,0.0,0,0,0.0,1,2,0.5,0,1,1,0,0,0,2,0,1,-2,0.0,0.0,2017,18,0.3333333333333333,0.0,1,1,2,0.5
2017-18,Playoffs,203512,197,Lucas Nogueira,1610612761,TOR,5,24,0,1,0.0,0,0,0.0,1,2,0.5,0,1,1,1,0,0,3,6,1,-2,0.33,0.0,2017,18,0.2,0.3333333333333333,1,1,2,0.5
2017-18,Playoffs,203464,199,Brandon Paul,1610612759,SAS,1,3,0,0,0.0,0,0,0.0,0,0,0.0,0,1,1,1,0,0,0,0,0,2,0.0,0.0,2017,18,0.0,inf,0,0,0,inf
2017-18,Playoffs,1627778,199,Chinanu Onuaku,1610612745,HOU,1,3,0,0,0.0,0,0,0.0,0,0,0.0,1,0,1,1,1,0,0,1,0,3,0.0,0.0,2017,18,0.0,inf,0,0,0,inf
2017-18,Playoffs,1626177,199,Dakari Johnson,1610612760,OKC,2,3,0,0,0.0,0,0,0.0,0,0,0.0,0,0,0,0,0,0,0,0,0,0,0.0,0.0,2017,18,0.0,,0,0,0,
2017-18,Playoffs,2731,199,Emeka Okafor,1610612740,NOP,1,4,0,1,0.0,0,0,0.0,0,0,0.0,0,0,0,0,0,0,0,1,0,-1,0.0,0.0,2017,18,0.0,,1,0,1,0.0
2017-18,Playoffs,201160,199,Jason Smith,1610612764,WAS,1,2,0,0,0.0,0,0,0.0,0,0,0.0,0,0,0,0,0,0,0,0,0,0,0.0,0.0,2017,18,0.0,,0,0,0,
2017-18,Playoffs,201573,199,Jerryd Bayless,1610612755,PHI,1,2,0,0,0.0,0,0,0.0,0,0,0.0,0,0,0,0,0,0,0,0,0,0,0.0,0.0,2017,18,0.0,,0,0,0,
2017-18,Playoffs,1626202,199,Joe Young,1610612754,IND,1,3,0,0,0.0,0,0,0.0,0,0,0.0,0,0,0,0,0,0,0,1,0,0,0.0,0.0,2017,18,0.0,,0,0,0,
2017-18,Playoffs,202337,199,Luke Babbitt,1610612748,MIA,2,3,0,1,0.0,0,0,0.0,0,0,0.0,0,0,0,0,0,0,0,0,0,-1,0.0,0.0,2017,18,0.0,,1,0,1,0.0
2017-18,Playoffs,1627875,199,Marcus Georges-Hunt,1610612750,MIN,2,3,0,1,0.0,0,0,0.0,0,0,0.0,1,0,1,0,0,0,0,0,0,0,0.0,0.0,2017,18,0.0,,1,0,1,1.0
2017-18,Playoffs,1626158,199,Richaun Holmes,1610612755,PHI,3,11,0,1,0.0,0,0,0.0,0,0,0.0,0,1,1,1,0,0,0,3,0,1,0.0,0.0,2017,18,0.0,inf,1,0,1,1.0
2017-18,Playoffs,1628388,199,T.J. Leaf,1610612754,IND,1,4,0,0,0.0,0,0,0.0,0,0,0.0,0,0,0,0,0,0,0,0,0,0,0.0,0.0,2017,18,0.0,,0,0,0,
2017-18,Playoffs,204025,199,Tim Frazier,1610612764,WAS,2,6,0,1,0.0,0,0,0.0,0,0,0.0,0,1,1,3,1,0,0,2,0,4,0.0,0.0,2017,18,0.0,inf,1,0,1,1.0
2018-19,RegularSeason,201935,1,James Harden,1610612745,HOU,78,2867,843,1909,0.442,378,1028,0.368,754,858,0.879,66,452,518,586,158,58,387,244,2818,2581,1.51,0.41,2018,19,36.12820512820513,1.5142118863049097,1066,104,1170,0.4427350427350427
2018-19,RegularSeason,202331,2,Paul George,1610612760,OKC,77,2841,707,1614,0.438,292,757,0.386,453,540,0.839,105,523,628,318,170,34,205,214,2159,2110,1.55,0.83,2018,19,28.038961038961038,1.551219512195122,907,87,994,0.6317907444668008
2018-19,RegularSeason,202689,3,Kemba Walker,1610612766,CHA,82,2863,731,1684,0.434,260,731,0.356,380,450,0.844,52,309,361,484,102,34,211,131,2102,1849,2.29,0.48,2018,19,25.634146341463413,2.293838862559242,953,70,1023,0.35288367546432065
2018-19,RegularSeason,203078,4,Bradley Beal,1610612764,WAS,82,3028,764,1609,0.475,209,596,0.351,362,448,0.808,89,322,411,448,121,58,224,226,2099,1982,2.0,0.54,2018,19,25.597560975609756,2.0,845,86,931,0.4414607948442535
2018-19,RegularSeason,203081,5,Damian Lillard,1610612757,POR,80,2838,681,1533,0.444,237,643,0.369,468,513,0.912,68,303,371,551,88,34,212,148,2067,2002,2.6,0.41,2018,19,25.8375,2.599056603773585,852,45,897,0.4136008918617614
2018-19,RegularSeason,201142,6,Kevin Durant,1610612744,GSW,78,2702,721,1383,0.521,137,388,0.353,448,506,0.885,33,464,497,457,58,84,225,155,2027,2178,2.03,0.26,2018,19,25.987179487179485,2.031111111111111,662,58,720,0.6902777777777778
2018-19,RegularSeason,203507,7,Giannis Antetokounmpo,1610612749,MIL,72,2358,721,1247,0.578,52,203,0.256,500,686,0.729,159,739,898,424,92,110,268,232,1994,2538,1.58,0.34,2018,19,27.694444444444443,1.5820895522388059,526,186,712,1.2612359550561798
2018-19,RegularSeason,201939,8,Stephen Curry,1610612744,GSW,69,2331,632,1340,0.472,354,810,0.437,263,287,0.916,45,324,369,361,92,25,192,166,1881,1804,1.88,0.48,2018,19,27.26086956521739,1.8802083333333333,708,24,732,0.5040983606557377
2018-19,RegularSeason,1626157,9,Karl-Anthony Towns,1610612750,MIN,77,2545,681,1314,0.518,142,355,0.4,376,450,0.836,263,691,954,259,67,125,240,292,1880,2338,1.08,0.28,2018,19,24.415584415584416,1.0791666666666666,633,74,707,1.3493635077793493
2018-19,RegularSeason,201933,10,Blake Griffin,1610612765,DET,75,2622,619,1341,0.462,189,522,0.362,414,550,0.753,100,465,565,402,52,28,253,199,1841,1777,1.59,0.21,2018,19,24.546666666666667,1.5889328063241106,722,136,858,0.6585081585081585
2018-19,RegularSeason,1628378,11,Donovan Mitchell,1610612762,UTA,77,2598,661,1530,0.432,188,519,0.362,319,396,0.806,59,257,316,322,106,31,218,208,1829,1440,1.48,0.49,2018,19,23.753246753246753,1.4770642201834863,869,77,946,0.33403805496828753
2018-19,RegularSeason,203954,12,Joel Embiid,1610612755,PHI,64,2154,580,1199,0.484,79,263,0.3,522,649,0.804,160,711,871,234,46,122,226,211,1761,2062,1.03,0.2,2018,19,27.515625,1.0353982300884956,619,127,746,1.1675603217158177
2018-19,RegularSeason,200746,13,LaMarcus Aldridge,1610612759,SAS,81,2687,684,1319,0.519,10,42,0.238,349,412,0.847,251,493,744,194,43,107,144,179,1727,1973,1.35,0.3,2018,19,21.320987654320987,1.3472222222222223,635,63,698,1.0659025787965617
2018-19,RegularSeason,1626156,14,D'Angelo Russell,1610612751,BKN,81,2448,659,1517,0.434,234,635,0.369,160,205,0.78,53,262,315,563,100,20,253,141,1712,1554,2.23,0.4,2018,19,21.135802469135804,2.225296442687747,858,45,903,0.3488372093023256
2018-19,RegularSeason,1626164,15,Devin Booker,1610612756,PHX,64,2242,586,1255,0.467,135,414,0.326,393,454,0.866,39,226,265,433,56,13,264,200,1700,1473,1.64,0.21,2018,19,26.5625,1.6401515151515151,669,61,730,0.363013698630137
2018-19,RegularSeason,1627741,16,Buddy Hield,1610612758,SAC,82,2615,623,1360,0.458,278,651,0.427,171,193,0.886,106,306,412,205,58,33,146,202,1695,1498,1.4,0.4,2018,19,20.670731707317074,1.404109589041096,737,22,759,0.5428194993412385
2018-19,RegularSeason,202691,17,Klay Thompson,1610612744,GSW,78,2652,655,1402,0.467,241,599,0.402,129,158,0.816,37,262,299,186,84,47,115,157,1680,1405,1.62,0.73,2018,19,21.53846153846154,1.617391304347826,747,29,776,0.3853092783505155
2018-19,RegularSeason,201566,18,Russell Westbrook,1610612760,OKC,73,2629,630,1473,0.428,119,411,0.29,296,451,0.656,109,698,807,784,142,33,325,245,1675,2118,2.41,0.44,2018,19,22.945205479452056,2.4123076923076923,843,155,998,0.8086172344689379
2018-19,RegularSeason,202696,19,Nikola Vucevic,1610612753,ORL,80,2510,701,1354,0.518,84,231,0.364,179,227,0.789,224,736,960,307,81,89,159,157,1665,2242,1.93,0.51,2018,19,20.8125,1.930817610062893,653,48,701,1.369472182596291
2018-19,RegularSeason,202699,20,Tobias Harris,1610612755,PHI,82,2848,611,1254,0.487,156,393,0.397,266,307,0.866,69,576,645,229,51,37,151,184,1644,1771,1.52,0.34,2018,19,20.048780487804876,1.5165562913907285,643,41,684,0.9429824561403509
2018-19,RegularSeason,201942,21,DeMar DeRozan,1610612759,SAS,77,2688,631,1313,0.481,7,45,0.156,366,441,0.83,54,408,462,475,86,36,199,177,1635,1738,2.39,0.43,2018,19,21.233766233766232,2.386934673366834,682,75,757,0.6103038309114928
2018-19,RegularSeason,203999,22,Nikola Jokic,1610612743,DEN,80,2504,616,1206,0.511,83,270,0.307,289,352,0.821,228,637,865,580,108,55,248,228,1604,2311,2.34,0.43,2018,19,20.05,2.338709677419355,590,63,653,1.324655436447167
2018-19,RegularSeason,202695,23,Kawhi Leonard,1610612761,TOR,60,2040,560,1129,0.496,112,302,0.371,364,426,0.854,78,361,439,199,106,24,121,87,1596,1612,1.65,0.88,2018,19,26.6,1.6446280991735538,569,62,631,0.6957210776545166
2018-19,RegularSeason,202681,23,Kyrie Irving,1610612738,BOS,67,2214,604,1241,0.487,174,434,0.401,214,245,0.873,71,264,335,464,103,34,172,167,1596,1692,2.7,0.6,2018,19,23.82089552238806,2.697674418604651,637,31,668,0.5014970059880239
2018-19,RegularSeason,203944,25,Julius Randle,1610612740,NOP,73,2232,571,1089,0.524,67,195,0.344,356,487,0.731,162,472,634,229,52,45,208,246,1565,1668,1.1,0.25,2018,19,21.438356164383563,1.1009615384615385,518,131,649,0.9768875192604006
2018-19,RegularSeason,1629027,26,Trae Young,1610612737,ATL,81,2503,525,1256,0.418,156,482,0.324,343,414,0.829,64,237,301,653,72,15,308,140,1549,1480,2.12,0.23,2018,19,19.123456790123456,2.1201298701298703,731,71,802,0.37531172069825436
2018-19,RegularSeason,1629029,27,Luka Doncic,1610612742,DAL,72,2318,506,1186,0.427,168,514,0.327,346,485,0.713,86,477,563,429,77,25,247,137,1526,1554,1.74,0.31,2018,19,21.194444444444443,1.736842105263158,680,139,819,0.6874236874236874
2018-19,RegularSeason,2544,28,LeBron James,1610612747,LAL,55,1937,558,1095,0.51,111,327,0.339,278,418,0.665,57,408,465,454,72,33,197,94,1505,1655,2.31,0.36,2018,19,27.363636363636363,2.3045685279187818,537,140,677,0.6868537666174298
2018-19,RegularSeason,101150,29,Lou Williams,1610612746,LAC,75,1993,484,1138,0.425,105,291,0.361,425,485,0.876,40,182,222,402,57,11,181,80,1498,1295,2.22,0.32,2018,19,19.973333333333333,2.2209944751381214,654,60,714,0.31092436974789917
2018-19,RegularSeason,203897,30,Zach LaVine,1610612741,CHI,63,2171,530,1135,0.467,120,321,0.374,312,375,0.832,40,254,294,283,60,26,215,140,1492,1272,1.32,0.28,2018,19,23.682539682539684,1.3162790697674418,605,63,668,0.44011976047904194
2018-19,RegularSeason,201144,31,Mike Conley,1610612763,MEM,70,2342,490,1120,0.438,155,426,0.364,343,406,0.845,40,199,239,449,94,22,130,123,1478,1459,3.45,0.72,2018,19,21.114285714285714,3.453846153846154,630,63,693,0.3448773448773449
2018-19,RegularSeason,203468,32,CJ McCollum,1610612757,POR,70,2375,571,1243,0.459,167,445,0.375,159,192,0.828,62,220,282,207,55,28,106,172,1468,1229,1.95,0.52,2018,19,20.97142857142857,1.9528301886792452,672,33,705,0.4
2018-19,RegularSeason,202711,33,Bojan Bogdanovic,1610612754,IND,81,2573,522,1051,0.497,164,386,0.425,246,305,0.807,33,300,333,161,69,1,134,138,1454,1296,1.2,0.52,2018,19,17.950617283950617,1.2014925373134329,529,59,588,0.5663265306122449
2018-19,RegularSeason,203076,34,Anthony Davis,1610612740,NOP,56,1850,530,1026,0.517,48,145,0.331,344,433,0.794,174,498,672,218,88,135,112,132,1452,1868,1.95,0.79,2018,19,25.928571428571427,1.9464285714285714,496,89,585,1.1487179487179486
2018-19,RegularSeason,201950,35,Jrue Holiday,1610612740,NOP,67,2402,547,1159,0.472,118,363,0.325,208,271,0.768,75,259,334,518,109,54,210,148,1420,1550,2.47,0.52,2018,19,21.19402985074627,2.466666666666667,612,63,675,0.4948148148148148
2018-19,RegularSeason,203114,36,Khris Middleton,1610612749,MIL,77,2393,506,1148,0.441,179,474,0.378,216,258,0.837,50,411,461,331,80,7,174,172,1407,1428,1.9,0.46,2018,19,18.272727272727273,1.9022988505747127,642,42,684,0.6739766081871345
2018-19,RegularSeason,1628368,37,De'Aaron Fox,1610612758,SAC,81,2546,505,1102,0.458,86,232,0.371,303,417,0.727,43,261,304,590,133,45,227,204,1399,1533,2.6,0.59,2018,19,17.271604938271604,2.5991189427312777,597,114,711,0.42756680731364277
2018-19,RegularSeason,200755,38,JJ Redick,1610612755,PHI,76,2379,452,1027,0.44,240,605,0.397,228,255,0.894,20,166,186,206,32,17,101,129,1372,1110,2.04,0.32,2018,19,18.05263157894737,2.0396039603960396,575,27,602,0.3089700996677741
2018-19,RegularSeason,1629012,39,Collin Sexton,1610612739,CLE,82,2605,519,1206,0.43,119,296,0.402,214,255,0.839,57,179,236,243,44,6,185,186,1371,987,1.31,0.24,2018,19,16.71951219512195,1.3135135135135134,687,41,728,0.3241758241758242
2018-19,RegularSeason,203083,40,Andre Drummond,1610612765,DET,79,2647,561,1052,0.533,5,38,0.132,243,412,0.59,423,809,1232,112,136,138,175,272,1370,2153,0.64,0.78,2018,19,17.341772151898734,0.64,491,169,660,1.8666666666666667
2018-19,RegularSeason,1627750,41,Jamal Murray,1610612743,DEN,75,2447,513,1173,0.437,152,414,0.367,189,223,0.848,65,252,317,363,67,27,158,153,1367,1289,2.3,0.42,2018,19,18.226666666666667,2.2974683544303796,660,34,694,0.45677233429394815
2018-19,RegularSeason,203903,42,Jordan Clarkson,1610612739,CLE,81,2215,529,1180,0.448,144,445,0.324,162,192,0.844,82,188,270,196,57,13,135,112,1364,1084,1.45,0.42,2018,19,16.839506172839506,1.451851851851852,651,30,681,0.3964757709251101
2018-19,RegularSeason,1626149,43,Montrezl Harrell,1610612746,LAC,82,2158,546,888,0.615,3,17,0.176,266,414,0.643,184,351,535,162,71,110,132,255,1361,1617,1.23,0.54,2018,19,16.597560975609756,1.2272727272727273,342,148,490,1.0918367346938775
2018-19,RegularSeason,1627783,44,Pascal Siakam,1610612761,TOR,80,2548,519,945,0.549,79,214,0.369,237,302,0.785,124,425,549,248,73,52,154,241,1354,1631,1.61,0.47,2018,19,16.925,1.6103896103896105,426,65,491,1.1181262729124237
2018-19,RegularSeason,201568,45,Danilo Gallinari,1610612746,LAC,68,2059,409,884,0.463,161,372,0.433,367,406,0.904,54,363,417,178,49,23,99,129,1346,1400,1.8,0.49,2018,19,19.794117647058822,1.797979797979798,475,39,514,0.811284046692607
2018-19,RegularSeason,1627732,46,Ben Simmons,1610612755,PHI,79,2700,540,960,0.563,0,6,0.0,257,428,0.6,172,525,697,610,112,61,274,209,1337,1952,2.23,0.41,2018,19,16.924050632911392,2.2262773722627736,420,171,591,1.1793570219966159
2018-19,RegularSeason,203952,47,Andrew Wiggins,1610612750,MIN,73,2543,498,1209,0.412,118,348,0.339,207,296,0.699,83,269,352,184,70,48,138,153,1321,1037,1.33,0.51,2018,19,18.095890410958905,1.3333333333333333,711,89,800,0.44
2018-19,RegularSeason,1628398,48,Kyle Kuzma,1610612747,LAL,70,2314,496,1087,0.456,128,422,0.303,188,250,0.752,60,322,382,178,41,26,133,170,1308,1149,1.34,0.31,2018,19,18.685714285714287,1.3383458646616542,591,62,653,0.5849923430321593
2018-19,RegularSeason,203497,49,Rudy Gobert,1610612762,UTA,81,2577,476,712,0.669,0,0,0.0,332,522,0.636,309,732,1041,161,66,187,130,231,1284,2183,1.24,0.51,2018,19,15.851851851851851,1.2384615384615385,236,190,426,2.443661971830986
2018-19,RegularSeason,203084,50,Harrison Barnes,1610612758,SAC,77,2533,431,1027,0.42,174,441,0.395,229,278,0.824,57,304,361,115,50,13,98,122,1265,1061,1.17,0.51,2018,19,16.428571428571427,1.1734693877551021,596,49,645,0.5596899224806201
2018-19,RegularSeason,202704,51,Reggie Jackson,1610612765,DET,82,2289,441,1047,0.421,174,471,0.369,204,236,0.864,45,171,216,344,55,9,148,208,1260,1098,2.32,0.37,2018,19,15.365853658536585,2.324324324324324,606,32,638,0.3385579937304075
2018-19,RegularSeason,203932,52,Aaron Gordon,1610612753,ORL,78,2633,470,1046,0.449,121,347,0.349,185,253,0.731,129,445,574,289,57,56,162,172,1246,1416,1.78,0.35,2018,19,15.974358974358974,1.7839506172839505,576,68,644,0.8913043478260869
2018-19,RegularSeason,1628369,53,Jayson Tatum,1610612738,BOS,79,2455,466,1036,0.45,116,311,0.373,195,228,0.855,70,407,477,168,84,57,122,168,1243,1304,1.38,0.69,2018,19,15.734177215189874,1.3770491803278688,570,33,603,0.7910447761194029
2018-19,RegularSeason,202339,54,Eric Bledsoe,1610612749,MIL,78,2272,470,971,0.484,124,377,0.329,177,236,0.75,82,280,362,430,116,29,165,156,1241,1453,2.61,0.7,2018,19,15.91025641025641,2.606060606060606,501,59,560,0.6464285714285715
2018-19,RegularSeason,203095,55,Evan Fournier,1610612753,ORL,81,2553,468,1069,0.438,153,450,0.34,137,170,0.806,38,220,258,295,71,12,154,225,1226,1074,1.92,0.46,2018,19,15.135802469135802,1.9155844155844155,601,33,634,0.4069400630914827
2018-19,RegularSeason,203471,56,Dennis Schroder,1610612760,OKC,79,2314,457,1104,0.414,124,364,0.341,186,227,0.819,38,246,284,323,65,12,172,189,1224,1048,1.88,0.38,2018,19,15.49367088607595,1.877906976744186,647,41,688,0.4127906976744186
2018-19,RegularSeason,203082,57,Terrence Ross,1610612753,ORL,81,2150,440,1027,0.428,217,566,0.383,126,144,0.875,27,253,280,135,72,29,90,119,1223,1044,1.5,0.8,2018,19,15.098765432098766,1.5,587,18,605,0.4628099173553719
2018-19,RegularSeason,202710,58,Jimmy Butler,1610612755,PHI,65,2185,418,904,0.462,67,193,0.347,312,365,0.855,121,221,342,263,123,39,95,111,1215,1348,2.77,1.29,2018,19,18.692307692307693,2.768421052631579,486,53,539,0.634508348794063
2018-19,RegularSeason,1626196,59,Josh Richardson,1610612748,MIA,73,2539,423,1026,0.412,164,460,0.357,199,231,0.861,54,209,263,298,79,34,113,200,1209,1135,2.64,0.7,2018,19,16.561643835616437,2.6371681415929205,603,32,635,0.4141732283464567
2018-19,RegularSeason,203087,60,Jeremy Lamb,1610612766,CHA,79,2250,431,979,0.44,115,330,0.348,231,260,0.888,65,369,434,172,88,32,80,140,1208,1277,2.15,1.1,2018,19,15.291139240506329,2.15,548,29,577,0.7521663778162911
2018-19,RegularSeason,1628381,61,John Collins,1610612737,ATL,61,1828,465,831,0.56,55,158,0.348,203,266,0.763,219,376,595,121,22,39,120,199,1188,1416,1.01,0.18,2018,19,19.475409836065573,1.0083333333333333,366,63,429,1.386946386946387
2018-19,RegularSeason,203501,62,Tim Hardaway Jr.,1610612742,DAL,65,2057,390,993,0.393,162,477,0.34,232,276,0.841,33,189,222,159,54,8,105,141,1174,865,1.51,0.51,2018,19,18.06153846153846,1.5142857142857142,603,44,647,0.34312210200927357
2018-19,RegularSeason,1629028,63,Deandre Ayton,1610612756,PHX,71,2183,509,870,0.585,0,4,0.0,141,189,0.746,223,506,729,125,61,67,126,209,1159,1606,0.99,0.48,2018,19,16.323943661971832,0.9920634920634921,361,48,409,1.78239608801956
2018-19,RegularSeason,203915,64,Spencer Dinwiddie,1610612751,BKN,68,1914,366,828,0.442,124,370,0.335,287,356,0.806,26,140,166,311,40,17,152,187,1143,994,2.05,0.26,2018,19,16.808823529411764,2.0460526315789473,462,69,531,0.3126177024482109
2018-19,RegularSeason,203994,65,Jusuf Nurkic,1610612757,POR,72,1974,420,826,0.508,3,29,0.103,282,365,0.773,243,505,748,233,71,103,168,250,1125,1623,1.39,0.42,2018,19,15.625,1.3869047619047619,406,83,489,1.5296523517382412
2018-19,RegularSeason,203991,66,Clint Capela,1610612745,HOU,67,2249,474,732,0.648,0,0,0.0,166,261,0.636,298,550,848,96,44,102,94,168,1114,1757,1.02,0.47,2018,19,16.62686567164179,1.0212765957446808,258,95,353,2.4022662889518416
2018-19,RegularSeason,201586,67,Serge Ibaka,1610612761,TOR,74,2010,464,877,0.529,49,169,0.29,135,177,0.763,156,445,601,99,29,103,114,211,1112,1375,0.87,0.25,2018,19,15.027027027027026,0.868421052631579,413,42,455,1.3208791208791208
2018-19,RegularSeason,203500,68,Steven Adams,1610612760,OKC,80,2669,481,809,0.595,0,2,0.0,146,292,0.5,391,369,760,124,117,76,135,204,1108,1576,0.92,0.87,2018,19,13.85,0.9185185185185185,328,146,474,1.6033755274261603
2018-19,RegularSeason,201569,69,Eric Gordon,1610612745,HOU,68,2158,384,938,0.409,216,600,0.36,119,152,0.783,17,131,148,129,41,27,90,143,1103,771,1.43,0.46,2018,19,16.220588235294116,1.4333333333333333,554,33,587,0.252129471890971
2018-19,RegularSeason,203924,70,Jerami Grant,1610612760,OKC,80,2612,409,823,0.497,115,293,0.392,157,221,0.71,96,321,417,79,61,100,67,214,1090,1202,1.18,0.91,2018,19,13.625,1.1791044776119404,414,64,478,0.8723849372384938
2018-19,RegularSeason,2548,71,Dwyane Wade,1610612748,MIA,72,1885,416,960,0.433,86,261,0.33,165,233,0.708,69,216,285,301,59,38,166,118,1083,988,1.81,0.35,2018,19,15.041666666666666,1.8132530120481927,544,68,612,0.46568627450980393
2018-19,RegularSeason,201188,72,Marc Gasol,1610612761,TOR,79,2436,390,870,0.448,99,273,0.363,192,253,0.759,80,547,627,349,84,86,155,217,1071,1521,2.25,0.54,2018,19,13.556962025316455,2.2516129032258063,480,61,541,1.1589648798521257
2018-19,RegularSeason,1626162,73,Kelly Oubre Jr.,1610612756,PHX,69,1935,375,842,0.445,108,338,0.32,189,244,0.775,71,254,325,84,84,59,103,181,1047,974,0.82,0.82,2018,19,15.173913043478262,0.8155339805825242,467,55,522,0.6226053639846744
2018-19,RegularSeason,202694,74,Marcus Morris Sr.,1610612738,BOS,75,2091,377,844,0.447,146,389,0.375,146,173,0.844,76,382,458,109,43,25,92,181,1046,1095,1.19,0.47,2018,19,13.946666666666667,1.184782608695652,467,27,494,0.9271255060728745
2018-19,RegularSeason,1627734,75,Domantas Sabonis,1610612754,IND,74,1838,413,700,0.59,9,17,0.529,208,291,0.715,186,504,690,212,48,30,160,239,1043,1493,1.32,0.3,2018,19,14.094594594594595,1.325,287,83,370,1.864864864864865
2018-19,RegularSeason,203925,76,Joe Harris,1610612751,BKN,76,2294,374,748,0.5,183,386,0.474,110,133,0.827,52,239,291,181,38,17,121,182,1041,1050,1.5,0.31,2018,19,13.697368421052632,1.4958677685950412,374,23,397,0.7329974811083123
2018-19,RegularSeason,201152,77,Thaddeus Young,1610612754,IND,81,2489,443,841,0.527,51,146,0.349,87,135,0.644,192,331,523,204,123,36,123,194,1024,1341,1.66,1.0,2018,19,12.641975308641975,1.6585365853658536,398,48,446,1.1726457399103138
2018-19,RegularSeason,201572,78,Brook Lopez,1610612749,MIL,81,2322,355,786,0.452,187,512,0.365,112,133,0.842,33,363,396,98,51,179,82,189,1009,1199,1.2,0.62,2018,19,12.45679012345679,1.1951219512195121,431,21,452,0.8761061946902655
2018-19,RegularSeason,1627763,79,Malcolm Brogdon,1610612749,MIL,64,1832,378,748,0.505,104,244,0.426,141,152,0.928,65,223,288,205,46,13,91,102,1001,1081,2.25,0.51,2018,19,15.640625,2.2527472527472527,370,11,381,0.7559055118110236
2018-19,RegularSeason,204060,80,Joe Ingles,1610612762,UTA,82,2568,359,802,0.448,189,483,0.391,87,123,0.707,35,295,330,469,98,20,193,180,994,1239,2.43,0.51,2018,19,12.121951219512194,2.430051813471503,443,36,479,0.6889352818371608
2018-19,RegularSeason,1626224,81,Cedi Osman,1610612739,CLE,76,2444,360,844,0.427,130,374,0.348,141,181,0.779,45,312,357,195,60,11,114,195,991,976,1.71,0.53,2018,19,13.039473684210526,1.7105263157894737,484,40,524,0.6812977099236641
2018-19,RegularSeason,203992,82,Bogdan Bogdanovic,1610612758,SAC,70,1947,361,863,0.418,134,372,0.36,134,162,0.827,40,203,243,267,72,15,117,142,990,940,2.28,0.61,2018,19,14.142857142857142,2.282051282051282,502,28,530,0.45849056603773586
2018-19,RegularSeason,1626167,83,Myles Turner,1610612754,IND,74,2119,380,780,0.487,76,196,0.388,148,201,0.736,101,430,531,115,60,199,100,195,984,1336,1.15,0.6,2018,19,13.297297297297296,1.15,400,53,453,1.1721854304635762
2018-19,RegularSeason,1628374,84,Lauri Markkanen,1610612741,CHI,52,1682,342,795,0.43,120,332,0.361,170,195,0.872,74,396,470,75,37,33,85,122,974,1026,0.88,0.43,2018,19,18.73076923076923,0.8823529411764706,453,25,478,0.9832635983263598
2018-19,RegularSeason,1627854,85,Bryn Forbes,1610612759,SAS,82,2293,361,791,0.456,176,413,0.426,69,78,0.885,18,221,239,175,45,4,80,159,967,911,2.19,0.56,2018,19,11.792682926829269,2.1875,430,9,439,0.5444191343963554
2018-19,RegularSeason,1626161,86,Willie Cauley-Stein,1610612758,SAC,81,2213,412,741,0.556,1,2,0.5,140,254,0.551,181,497,678,194,96,51,84,227,965,1457,2.31,1.14,2018,19,11.91358024691358,2.3095238095238093,329,114,443,1.5304740406320543
2018-19,RegularSeason,1627759,87,Jaylen Brown,1610612738,BOS,74,1913,368,792,0.465,95,276,0.344,133,202,0.658,65,248,313,100,69,32,99,186,964,886,1.01,0.7,2018,19,13.027027027027026,1.0101010101010102,424,69,493,0.6348884381338742
2018-19,RegularSeason,1628995,88,Kevin Knox II,1610612752,NYK,75,2158,338,914,0.37,125,364,0.343,162,226,0.717,61,274,335,82,43,24,114,175,963,693,0.72,0.38,2018,19,12.84,0.7192982456140351,576,64,640,0.5234375
2018-19,RegularSeason,203109,89,Jae Crowder,1610612762,UTA,80,2166,318,797,0.399,173,522,0.331,142,197,0.721,60,324,384,133,64,31,85,170,951,944,1.56,0.75,2018,19,11.8875,1.5647058823529412,479,55,534,0.7191011235955056
2018-19,RegularSeason,1627742,90,Brandon Ingram,1610612747,LAL,52,1761,362,729,0.497,31,94,0.33,195,289,0.675,41,226,267,154,28,31,129,149,950,840,1.19,0.22,2018,19,18.26923076923077,1.193798449612403,367,94,461,0.579175704989154
2018-19,RegularSeason,201571,91,D.J. Augustin,1610612753,ORL,81,2269,318,677,0.47,131,311,0.421,181,209,0.866,41,162,203,426,52,4,128,115,948,1118,3.33,0.41,2018,19,11.703703703703704,3.328125,359,28,387,0.524547803617571
2018-19,RegularSeason,201145,92,Jeff Green,1610612764,WAS,77,2097,326,687,0.475,111,320,0.347,183,206,0.888,57,252,309,137,43,39,101,160,946,989,1.36,0.43,2018,19,12.285714285714286,1.3564356435643565,361,23,384,0.8046875
2018-19,RegularSeason,200752,92,Rudy Gay,1610612759,SAS,69,1842,376,746,0.504,74,184,0.402,120,147,0.816,63,407,470,182,54,34,114,159,946,1175,1.6,0.47,2018,19,13.710144927536232,1.5964912280701755,370,27,397,1.1838790931989924
2018-19,RegularSeason,203484,94,Kentavious Caldwell-Pope,1610612747,LAL,82,2035,325,756,0.43,151,435,0.347,137,158,0.867,48,190,238,110,73,13,65,137,938,855,1.69,1.12,2018,19,11.439024390243903,1.6923076923076923,431,21,452,0.5265486725663717
2018-19,RegularSeason,203953,95,Jabari Parker,1610612764,WAS,64,1724,369,749,0.493,61,195,0.313,131,184,0.712,79,342,421,152,46,30,151,145,930,995,1.01,0.3,2018,19,14.53125,1.0066225165562914,380,53,433,0.9722863741339491
2018-19,RegularSeason,200768,96,Kyle Lowry,1610612761,TOR,65,2213,304,739,0.411,157,453,0.347,161,194,0.83,41,271,312,564,91,31,182,166,926,1274,3.1,0.5,2018,19,14.246153846153845,3.098901098901099,435,33,468,0.6666666666666666
2018-19,RegularSeason,201143,97,Al Horford,1610612738,BOS,68,1973,387,723,0.535,73,203,0.36,78,95,0.821,120,338,458,283,59,86,102,126,925,1356,2.77,0.58,2018,19,13.602941176470589,2.7745098039215685,336,17,353,1.2974504249291785
2018-19,RegularSeason,1628963,98,Marvin Bagley III,1610612758,SAC,62,1568,356,706,0.504,30,96,0.313,181,262,0.691,162,309,471,62,33,59,98,120,923,1019,0.63,0.34,2018,19,14.887096774193548,0.6326530612244898,350,81,431,1.0928074245939676
2018-19,RegularSeason,201565,99,Derrick Rose,1610612750,MIN,51,1392,363,753,0.482,54,146,0.37,137,160,0.856,33,107,140,220,31,12,82,57,917,825,2.68,0.38,2018,19,17.980392156862745,2.682926829268293,390,23,413,0.3389830508474576
2018-19,RegularSeason,1627736,99,Malik Beasley,1610612743,DEN,81,1879,349,737,0.474,163,405,0.402,56,66,0.848,35,165,200,97,55,10,55,116,917,826,1.76,1.0,2018,19,11.320987654320987,1.7636363636363637,388,10,398,0.5025125628140703
2018-19,RegularSeason,202683,101,Enes Freedom,1610612757,POR,67,1639,375,683,0.549,10,34,0.294,155,197,0.787,257,402,659,116,32,26,118,167,915,1280,0.98,0.27,2018,19,13.656716417910447,0.9830508474576272,308,42,350,1.8828571428571428
2018-19,RegularSeason,1628367,102,Josh Jackson,1610612756,PHX,79,1988,347,841,0.413,73,225,0.324,143,213,0.671,66,281,347,183,74,56,173,209,910,833,1.06,0.43,2018,19,11.518987341772151,1.0578034682080926,494,70,564,0.6152482269503546
2018-19,RegularSeason,101108,103,Chris Paul,1610612745,HOU,58,1857,302,720,0.419,127,355,0.358,175,203,0.862,36,229,265,473,114,18,152,146,906,1178,3.11,0.75,2018,19,15.620689655172415,3.111842105263158,418,28,446,0.594170403587444
2018-19,RegularSeason,202324,104,Derrick Favors,1610612762,UTA,76,1766,363,619,0.586,17,78,0.218,154,228,0.675,207,353,560,89,56,106,84,163,897,1294,1.06,0.67,2018,19,11.802631578947368,1.0595238095238095,256,74,330,1.696969696969697
2018-19,RegularSeason,201580,104,JaVale McGee,1610612747,LAL,75,1671,400,641,0.624,1,12,0.083,96,152,0.632,195,371,566,52,47,148,108,208,897,1305,0.48,0.43,2018,19,11.96,0.48148148148148145,241,56,297,1.9057239057239057
2018-19,RegularSeason,1628983,106,Shai Gilgeous-Alexander,1610612746,LAC,82,2174,341,716,0.476,51,139,0.367,156,195,0.8,57,175,232,270,96,45,141,175,889,977,1.92,0.68,2018,19,10.841463414634147,1.9148936170212767,375,39,414,0.5603864734299517
2018-19,RegularSeason,202355,107,Hassan Whiteside,1610612748,MIA,72,1674,388,680,0.571,2,16,0.125,109,243,0.449,257,560,817,56,46,136,97,192,887,1419,0.58,0.47,2018,19,12.319444444444445,0.5773195876288659,292,134,426,1.9178403755868545
2018-19,RegularSeason,200794,108,Paul Millsap,1610612743,DEN,70,1895,322,665,0.484,58,159,0.365,181,249,0.727,153,352,505,141,83,54,95,183,883,1160,1.48,0.87,2018,19,12.614285714285714,1.4842105263157894,343,68,411,1.2287104622871046
2018-19,RegularSeason,1626144,109,Emmanuel Mudiay,1610612752,NYK,59,1607,330,740,0.446,69,210,0.329,144,186,0.774,33,163,196,228,43,19,140,103,873,767,1.63,0.31,2018,19,14.796610169491526,1.6285714285714286,410,42,452,0.4336283185840708
2018-19,RegularSeason,1628386,109,Jarrett Allen,1610612751,BKN,80,2096,335,568,0.59,6,45,0.133,197,278,0.709,191,481,672,110,43,120,103,184,873,1401,1.07,0.42,2018,19,10.9125,1.0679611650485437,233,81,314,2.140127388535032
2018-19,RegularSeason,201937,111,Ricky Rubio,1610612762,UTA,68,1899,295,730,0.404,79,254,0.311,195,228,0.855,33,210,243,416,91,10,180,180,864,976,2.31,0.51,2018,19,12.705882352941176,2.311111111111111,435,33,468,0.5192307692307693
2018-19,RegularSeason,2772,112,Trevor Ariza,1610612764,WAS,69,2349,294,736,0.399,145,434,0.334,130,164,0.793,50,321,371,252,91,21,106,130,863,1016,2.38,0.86,2018,19,12.507246376811594,2.3773584905660377,442,34,476,0.7794117647058824
2018-19,RegularSeason,203967,113,Dario Saric,1610612750,MIN,81,2022,304,696,0.437,118,323,0.365,132,150,0.88,126,331,457,127,45,9,97,182,858,989,1.31,0.46,2018,19,10.592592592592593,1.309278350515464,392,18,410,1.1146341463414635
2018-19,RegularSeason,203200,114,Justin Holiday,1610612763,MEM,82,2607,300,777,0.386,162,465,0.348,95,106,0.896,46,277,323,146,121,36,104,164,857,891,1.4,1.16,2018,19,10.451219512195122,1.4038461538461537,477,11,488,0.6618852459016393
2018-19,RegularSeason,203458,115,Alex Len,1610612737,ATL,77,1544,320,648,0.494,74,204,0.363,140,216,0.648,158,266,424,86,27,69,97,200,854,959,0.89,0.28,2018,19,11.090909090909092,0.8865979381443299,328,76,404,1.0495049504950495
2018-19,RegularSeason,201954,116,Darren Collison,1610612754,IND,76,2143,308,659,0.467,79,194,0.407,158,190,0.832,36,196,232,459,110,9,125,138,853,1155,3.67,0.88,2018,19,11.223684210526315,3.672,351,32,383,0.6057441253263708
2018-19,RegularSeason,1628420,117,Monte Morris,1610612743,DEN,82,1970,346,702,0.493,94,227,0.414,65,81,0.802,35,159,194,297,73,4,52,102,851,995,5.71,1.4,2018,19,10.378048780487806,5.711538461538462,356,16,372,0.521505376344086
2018-19,RegularSeason,202083,118,Wesley Matthews,1610612754,IND,69,2091,279,698,0.4,150,403,0.372,132,163,0.81,32,138,170,160,54,17,91,160,840,700,1.76,0.59,2018,19,12.173913043478262,1.7582417582417582,419,31,450,0.37777777777777777
2018-19,RegularSeason,1626159,119,Justise Winslow,1610612748,MIA,66,1960,324,749,0.433,96,256,0.375,86,137,0.628,63,292,355,282,72,19,142,177,830,940,1.99,0.51,2018,19,12.575757575757576,1.9859154929577465,425,51,476,0.7457983193277311
2018-19,RegularSeason,201158,120,Marco Belinelli,1610612759,SAS,79,1815,285,690,0.413,147,395,0.372,112,124,0.903,16,182,198,132,35,8,72,121,829,713,1.83,0.49,2018,19,10.49367088607595,1.8333333333333333,405,12,417,0.4748201438848921
2018-19,RegularSeason,202330,121,Gordon Hayward,1610612738,BOS,72,1863,296,635,0.466,77,231,0.333,156,187,0.834,51,271,322,244,62,23,105,104,825,1001,2.32,0.59,2018,19,11.458333333333334,2.323809523809524,339,31,370,0.8702702702702703
2018-19,RegularSeason,201980,122,Danny Green,1610612761,TOR,80,2215,293,630,0.465,198,435,0.455,37,44,0.841,60,257,317,126,73,53,75,171,821,971,1.68,0.97,2018,19,10.2625,1.68,337,7,344,0.9215116279069767
2018-19,RegularSeason,203939,123,Dwight Powell,1610612742,DAL,77,1663,290,486,0.597,39,127,0.307,196,254,0.772,140,271,411,112,44,50,67,201,815,1111,1.67,0.66,2018,19,10.584415584415584,1.671641791044776,196,58,254,1.6181102362204725
2018-19,RegularSeason,201988,124,Patty Mills,1610612759,SAS,82,1908,282,663,0.425,159,404,0.394,88,103,0.854,24,158,182,245,49,10,93,129,811,808,2.63,0.53,2018,19,9.890243902439025,2.6344086021505375,381,15,396,0.4595959595959596
2018-19,RegularSeason,203918,125,Rodney Hood,1610612757,POR,72,1893,292,671,0.435,84,236,0.356,137,155,0.884,25,132,157,126,59,12,55,146,805,707,2.29,1.07,2018,19,11.180555555555555,2.290909090909091,379,18,397,0.3954659949622166
2018-19,RegularSeason,1628991,126,Jaren Jackson Jr.,1610612763,MEM,58,1515,298,589,0.506,51,142,0.359,151,197,0.766,73,199,272,64,52,82,98,220,798,833,0.65,0.53,2018,19,13.758620689655173,0.6530612244897959,291,46,337,0.8071216617210683
2018-19,RegularSeason,203482,127,Kelly Olynyk,1610612748,MIA,79,1812,261,564,0.463,113,319,0.354,152,185,0.822,72,303,375,140,53,37,114,183,787,942,1.23,0.47,2018,19,9.962025316455696,1.2280701754385965,303,33,336,1.1160714285714286
2018-19,RegularSeason,203490,128,Otto Porter Jr.,1610612741,CHI,56,1684,299,643,0.465,104,256,0.406,78,96,0.813,54,260,314,120,82,31,65,108,780,900,1.85,1.26,2018,19,13.928571428571429,1.8461538461538463,344,18,362,0.8674033149171271
2018-19,RegularSeason,1628422,129,Damyean Dotson,1610612752,NYK,73,2004,290,698,0.415,126,342,0.368,73,98,0.745,34,228,262,135,58,10,71,135,779,740,1.9,0.82,2018,19,10.67123287671233,1.9014084507042253,408,25,433,0.605080831408776
2018-19,RegularSeason,203145,129,Kent Bazemore,1610612737,ATL,67,1643,278,691,0.402,96,300,0.32,127,175,0.726,37,224,261,152,89,42,121,170,779,741,1.26,0.74,2018,19,11.626865671641792,1.256198347107438,413,48,461,0.5661605206073753
2018-19,RegularSeason,203933,131,T.J. Warren,1610612756,PHX,43,1360,297,611,0.486,77,180,0.428,101,124,0.815,31,143,174,64,51,29,52,119,772,701,1.23,0.98,2018,19,17.953488372093023,1.2307692307692308,314,23,337,0.516320474777448
2018-19,RegularSeason,202685,132,Jonas Valanciunas,1610612763,MEM,49,1091,301,538,0.559,14,48,0.292,147,185,0.795,106,313,419,70,19,53,90,146,763,959,0.78,0.21,2018,19,15.571428571428571,0.7777777777777778,237,38,275,1.5236363636363637
2018-19,RegularSeason,202329,133,Al-Farouq Aminu,1610612757,POR,81,2292,257,593,0.433,96,280,0.343,150,173,0.867,112,498,610,104,68,33,72,143,760,1144,1.44,0.94,2018,19,9.382716049382717,1.4444444444444444,336,23,359,1.6991643454038998
2018-19,RegularSeason,201599,134,DeAndre Jordan,1610612752,NYK,69,2047,286,446,0.641,0,0,0.0,186,264,0.705,225,677,902,156,42,73,153,167,758,1540,1.02,0.28,2018,19,10.985507246376812,1.0196078431372548,160,78,238,3.7899159663865545
2018-19,RegularSeason,1628418,134,Thomas Bryant,1610612764,WAS,72,1496,309,502,0.616,33,99,0.333,107,137,0.781,113,341,454,92,25,67,60,126,758,1113,1.53,0.42,2018,19,10.527777777777779,1.5333333333333334,193,30,223,2.0358744394618835
2018-19,RegularSeason,101107,136,Marvin Williams,1610612766,CHA,75,2133,275,652,0.422,140,382,0.366,66,86,0.767,76,331,407,92,71,61,47,156,756,943,1.96,1.51,2018,19,10.08,1.9574468085106382,377,20,397,1.0251889168765742
2018-19,RegularSeason,201959,137,Taj Gibson,1610612750,MIN,70,1686,304,537,0.566,11,34,0.324,134,177,0.757,172,286,458,84,53,39,73,186,753,1038,1.15,0.73,2018,19,10.757142857142858,1.1506849315068493,233,43,276,1.6594202898550725
2018-19,RegularSeason,201960,138,DeMarre Carroll,1610612751,BKN,67,1703,227,575,0.395,106,310,0.342,184,242,0.76,68,281,349,85,31,10,73,114,744,740,1.16,0.42,2018,19,11.104477611940299,1.1643835616438356,348,58,406,0.8596059113300493
2018-19,RegularSeason,1627752,139,Taurean Prince,1610612737,ATL,55,1552,262,594,0.441,123,315,0.39,95,116,0.819,22,177,199,118,53,19,100,141,742,678,1.18,0.53,2018,19,13.49090909090909,1.18,332,21,353,0.5637393767705382
2018-19,RegularSeason,202357,140,Nemanja Bjelica,1610612758,SAC,77,1788,284,593,0.479,103,257,0.401,70,92,0.761,125,319,444,147,54,56,82,197,741,1029,1.79,0.66,2018,19,9.623376623376624,1.7926829268292683,309,22,331,1.3413897280966767
2018-19,RegularSeason,203914,141,Gary Harris,1610612743,DEN,57,1639,270,637,0.424,82,242,0.339,115,144,0.799,41,119,160,127,55,19,68,113,737,634,1.87,0.81,2018,19,12.929824561403509,1.8676470588235294,367,29,396,0.40404040404040403
2018-19,RegularSeason,1628389,142,Bam Adebayo,1610612748,MIA,82,1913,280,486,0.576,3,15,0.2,166,226,0.735,165,432,597,184,71,65,121,203,729,1259,1.52,0.59,2018,19,8.890243902439025,1.5206611570247934,206,60,266,2.244360902255639
2018-19,RegularSeason,1628989,143,Kevin Huerter,1610612737,ATL,75,2049,275,657,0.419,136,353,0.385,41,56,0.732,60,185,245,214,65,25,109,155,727,770,1.96,0.6,2018,19,9.693333333333333,1.963302752293578,382,15,397,0.6171284634760705
2018-19,RegularSeason,1628372,144,Dennis Smith Jr.,1610612752,NYK,53,1508,278,650,0.428,67,208,0.322,99,156,0.635,32,123,155,252,67,20,154,129,722,633,1.64,0.43,2018,19,13.622641509433961,1.6363636363636365,372,57,429,0.3613053613053613
2018-19,RegularSeason,1629013,144,Landry Shamet,1610612746,LAC,79,1802,240,557,0.431,167,396,0.422,75,93,0.806,21,113,134,117,37,10,45,155,722,640,2.6,0.82,2018,19,9.139240506329115,2.6,317,18,335,0.4
2018-19,RegularSeason,1628371,146,Jonathan Isaac,1610612753,ORL,75,1996,262,611,0.429,86,266,0.323,110,135,0.815,99,312,411,80,59,98,75,143,720,919,1.07,0.79,2018,19,9.6,1.0666666666666667,349,25,374,1.0989304812834224
2018-19,RegularSeason,203493,147,Reggie Bullock Jr.,1610612747,LAL,63,1879,245,594,0.412,148,393,0.377,73,85,0.859,22,151,173,129,40,12,65,109,711,639,1.99,0.61,2018,19,11.285714285714286,1.9846153846153847,349,12,361,0.4792243767313019
2018-19,RegularSeason,1626171,148,Bobby Portis,1610612764,WAS,50,1298,279,628,0.444,75,191,0.393,77,97,0.794,109,294,403,72,35,20,74,145,710,797,0.97,0.47,2018,19,14.2,0.972972972972973,349,20,369,1.0921409214092141
2018-19,RegularSeason,203107,149,Tomas Satoransky,1610612764,WAS,80,2164,257,530,0.485,64,162,0.395,131,160,0.819,82,197,279,399,82,13,120,172,709,1060,3.33,0.68,2018,19,8.8625,3.325,273,29,302,0.9238410596026491
2018-19,RegularSeason,203935,150,Marcus Smart,1610612738,BOS,80,2200,239,567,0.422,126,346,0.364,104,129,0.806,57,177,234,321,143,28,123,201,708,958,2.61,1.16,2018,19,8.85,2.6097560975609757,328,25,353,0.6628895184135978
2018-19,RegularSeason,1626179,150,Terry Rozier,1610612738,BOS,79,1791,258,666,0.387,119,337,0.353,73,93,0.785,32,275,307,231,68,21,68,101,708,839,3.4,1.0,2018,19,8.962025316455696,3.3970588235294117,408,20,428,0.7172897196261683
2018-19,RegularSeason,202391,152,Jeremy Lin,1610612761,TOR,74,1436,238,541,0.44,55,187,0.294,176,210,0.838,22,157,179,231,47,13,124,144,707,716,1.86,0.38,2018,19,9.554054054054054,1.8629032258064515,303,34,337,0.5311572700296736
2018-19,RegularSeason,201936,153,Tyreke Evans,1610612754,IND,69,1402,257,660,0.389,77,216,0.356,115,160,0.719,33,168,201,166,58,18,118,117,706,583,1.41,0.49,2018,19,10.231884057971014,1.4067796610169492,403,45,448,0.4486607142857143
2018-19,RegularSeason,201577,154,Robin Lopez,1610612741,CHI,74,1606,304,535,0.568,7,31,0.226,89,123,0.724,140,146,286,89,11,78,96,124,704,807,0.93,0.12,2018,19,9.513513513513514,0.9270833333333334,231,34,265,1.079245283018868
2018-19,RegularSeason,1627832,155,Fred VanVleet,1610612761,TOR,64,1760,246,600,0.41,112,296,0.378,97,115,0.843,21,146,167,307,57,20,82,110,701,798,3.74,0.69,2018,19,10.953125,3.7439024390243905,354,18,372,0.4489247311827957
2018-19,RegularSeason,201587,156,Nicolas Batum,1610612766,CHA,75,2354,253,562,0.45,116,298,0.389,77,89,0.865,71,319,390,247,71,43,117,140,699,1012,2.11,0.61,2018,19,9.32,2.111111111111111,309,12,321,1.2149532710280373
2018-19,RegularSeason,202703,157,Nikola Mirotic,1610612749,MIL,46,1245,238,542,0.439,116,318,0.365,105,124,0.847,60,279,339,55,31,34,48,107,697,785,1.15,0.65,2018,19,15.152173913043478,1.1458333333333333,304,19,323,1.0495356037151702
2018-19,RegularSeason,1629019,158,Allonzo Trier,1610612752,NYK,64,1459,232,518,0.448,52,132,0.394,179,223,0.803,31,166,197,119,28,14,116,117,695,607,1.03,0.24,2018,19,10.859375,1.0258620689655173,286,44,330,0.5969696969696969
2018-19,RegularSeason,203473,159,Dewayne Dedmon,1610612737,ATL,64,1609,259,526,0.492,83,217,0.382,92,113,0.814,105,375,480,90,69,71,84,214,693,1031,1.07,0.82,2018,19,10.828125,1.0714285714285714,267,21,288,1.6666666666666667
2018-19,RegularSeason,1627761,160,DeAndre' Bembry,1610612737,ATL,82,1931,275,616,0.446,50,173,0.289,87,136,0.64,54,304,358,202,105,41,142,190,687,861,1.42,0.74,2018,19,8.378048780487806,1.4225352112676057,341,49,390,0.9179487179487179
2018-19,RegularSeason,1628969,161,Mikal Bridges,1610612756,PHX,82,2417,242,563,0.43,105,313,0.335,95,118,0.805,56,208,264,173,129,38,70,201,684,874,2.47,1.84,2018,19,8.341463414634147,2.4714285714285715,321,23,344,0.7674418604651163
2018-19,RegularSeason,1628973,162,Jalen Brunson,1610612742,DAL,73,1591,264,565,0.467,63,181,0.348,87,120,0.725,25,144,169,230,37,4,88,127,678,696,2.61,0.42,2018,19,9.287671232876713,2.6136363636363638,301,33,334,0.5059880239520959
2018-19,RegularSeason,101123,163,Gerald Green,1610612745,HOU,73,1473,231,578,0.4,156,441,0.354,57,68,0.838,30,152,182,40,33,27,55,126,675,544,0.73,0.6,2018,19,9.246575342465754,0.7272727272727273,347,11,358,0.5083798882681564
2018-19,RegularSeason,203506,163,Victor Oladipo,1610612754,IND,36,1147,249,588,0.423,74,216,0.343,103,141,0.73,21,181,202,186,60,11,82,72,675,675,2.27,0.73,2018,19,18.75,2.268292682926829,339,38,377,0.5358090185676393
2018-19,RegularSeason,204038,165,Langston Galloway,1610612765,DET,80,1745,228,587,0.388,135,380,0.355,81,96,0.844,49,122,171,85,37,8,24,135,672,575,3.54,1.54,2018,19,8.4,3.5416666666666665,359,15,374,0.4572192513368984
2018-19,RegularSeason,1628401,166,Derrick White,1610612759,SAS,67,1728,260,543,0.479,48,142,0.338,95,123,0.772,35,212,247,263,67,47,97,145,663,879,2.71,0.69,2018,19,9.895522388059701,2.711340206185567,283,28,311,0.7942122186495176
2018-19,RegularSeason,202322,166,John Wall,1610612764,WAS,32,1104,245,552,0.444,51,169,0.302,122,175,0.697,15,101,116,279,49,29,121,71,663,655,2.31,0.41,2018,19,20.71875,2.3057851239669422,307,53,360,0.32222222222222224
2018-19,RegularSeason,1626153,168,Delon Wright,1610612763,MEM,75,1698,242,558,0.434,50,168,0.298,119,150,0.793,68,198,266,248,88,30,77,103,653,861,3.22,1.14,2018,19,8.706666666666667,3.220779220779221,316,31,347,0.7665706051873199
2018-19,RegularSeason,1628370,168,Malik Monk,1610612766,CHA,73,1258,227,586,0.387,109,330,0.33,90,102,0.882,16,121,137,117,37,19,86,106,653,506,1.36,0.43,2018,19,8.945205479452055,1.3604651162790697,359,12,371,0.3692722371967655
2018-19,RegularSeason,203486,170,Mason Plumlee,1610612743,DEN,82,1731,262,442,0.593,2,10,0.2,111,198,0.561,165,359,524,243,66,76,126,252,637,1153,1.93,0.52,2018,19,7.7682926829268295,1.9285714285714286,180,87,267,1.9625468164794007
2018-19,RegularSeason,202734,171,E'Twaun Moore,1610612740,NOP,53,1463,256,532,0.481,76,176,0.432,45,59,0.763,35,92,127,102,40,8,59,112,633,561,1.73,0.68,2018,19,11.943396226415095,1.728813559322034,276,14,290,0.4379310344827586
2018-19,RegularSeason,203504,172,Trey Burke,1610612742,DAL,58,1125,236,548,0.431,56,159,0.352,103,124,0.831,28,71,99,159,33,7,49,58,631,547,3.25,0.67,2018,19,10.879310344827585,3.2448979591836733,312,21,333,0.2972972972972973
2018-19,RegularSeason,1626204,173,Larry Nance Jr.,1610612739,CLE,67,1795,249,479,0.52,33,98,0.337,96,134,0.716,168,384,552,214,100,40,97,192,627,1168,2.21,1.03,2018,19,9.35820895522388,2.2061855670103094,230,38,268,2.0597014925373136
2018-19,RegularSeason,202340,174,Avery Bradley,1610612763,MEM,63,1905,248,608,0.408,86,245,0.351,43,50,0.86,43,132,175,152,41,16,89,167,625,553,1.71,0.46,2018,19,9.920634920634921,1.7078651685393258,360,7,367,0.4768392370572207
2018-19,RegularSeason,204020,175,Tyler Johnson,1610612756,PHX,57,1529,217,526,0.413,90,260,0.346,95,127,0.748,34,139,173,166,54,27,77,97,619,621,2.16,0.7,2018,19,10.859649122807017,2.155844155844156,309,32,341,0.5073313782991202
2018-19,RegularSeason,203085,176,Austin Rivers,1610612745,HOU,76,2028,232,572,0.406,104,327,0.318,50,95,0.526,25,137,162,167,47,23,68,207,618,564,2.46,0.69,2018,19,8.131578947368421,2.4558823529411766,340,45,385,0.42077922077922075
2018-19,RegularSeason,1628379,177,Luke Kennard,1610612765,DET,63,1437,228,520,0.438,106,269,0.394,51,61,0.836,12,171,183,114,26,10,57,92,613,587,2.0,0.46,2018,19,9.73015873015873,2.0,292,10,302,0.6059602649006622
2018-19,RegularSeason,203210,178,JaMychal Green,1610612746,LAC,65,1371,230,476,0.483,71,176,0.403,80,101,0.792,104,305,409,50,45,34,87,193,611,795,0.57,0.52,2018,19,9.4,0.5747126436781609,246,21,267,1.5318352059925093
2018-19,RegularSeason,1627827,179,Dorian Finney-Smith,1610612742,DAL,81,1985,228,528,0.432,79,254,0.311,73,103,0.709,138,251,389,95,69,36,74,186,608,793,1.28,0.93,2018,19,7.506172839506172,1.2837837837837838,300,30,330,1.1787878787878787
2018-19,RegularSeason,202722,180,Dāvis Bertāns,1610612759,SAS,76,1632,204,453,0.45,145,338,0.429,53,60,0.883,23,241,264,100,35,33,43,133,606,739,2.33,0.81,2018,19,7.973684210526316,2.3255813953488373,249,7,256,1.03125
2018-19,RegularSeason,200782,181,P.J. Tucker,1610612745,HOU,82,2802,207,523,0.396,146,387,0.377,41,59,0.695,121,358,479,96,132,39,63,252,601,950,1.52,2.1,2018,19,7.329268292682927,1.5238095238095237,316,18,334,1.4341317365269461
2018-19,RegularSeason,2594,182,Kyle Korver,1610612762,UTA,70,1334,201,483,0.416,138,348,0.397,60,73,0.822,9,153,162,81,25,12,59,106,600,526,1.37,0.42,2018,19,8.571428571428571,1.3728813559322033,282,13,295,0.5491525423728814
2018-19,RegularSeason,1628970,183,Miles Bridges,1610612766,CHA,80,1696,237,511,0.464,65,200,0.325,58,77,0.753,67,256,323,95,55,49,50,111,597,776,1.9,1.1,2018,19,7.4625,1.9,274,19,293,1.1023890784982935
2018-19,RegularSeason,201976,184,Patrick Beverley,1610612746,LAC,78,2137,194,477,0.407,112,282,0.397,96,123,0.78,76,312,388,300,67,43,85,265,596,999,3.53,0.79,2018,19,7.641025641025641,3.5294117647058822,283,27,310,1.2516129032258065
2018-19,RegularSeason,202066,185,Garrett Temple,1610612746,LAC,75,2041,208,493,0.422,90,264,0.341,80,107,0.748,28,188,216,106,76,30,70,204,586,632,1.51,1.09,2018,19,7.8133333333333335,1.5142857142857142,285,27,312,0.6923076923076923
2018-19,RegularSeason,1628382,186,Justin Jackson,1610612742,DAL,81,1613,217,485,0.447,87,245,0.355,62,79,0.785,44,168,212,96,32,14,29,99,583,623,3.31,1.1,2018,19,7.197530864197531,3.310344827586207,268,17,285,0.743859649122807
2018-19,RegularSeason,203552,187,Seth Curry,1610612757,POR,74,1399,212,465,0.456,113,251,0.45,44,52,0.846,27,93,120,66,36,12,61,97,581,493,1.08,0.59,2018,19,7.851351351351352,1.0819672131147542,253,8,261,0.45977011494252873
2018-19,RegularSeason,1626158,188,Richaun Holmes,1610612756,PHX,70,1184,222,365,0.608,0,0,0.0,128,175,0.731,115,216,331,60,42,79,52,194,572,842,1.15,0.81,2018,19,8.17142857142857,1.1538461538461537,143,47,190,1.7421052631578948
2018-19,RegularSeason,203943,189,Noah Vonleh,1610612752,NYK,68,1722,207,440,0.47,46,137,0.336,111,156,0.712,113,415,528,129,46,51,88,174,571,959,1.47,0.52,2018,19,8.397058823529411,1.4659090909090908,233,45,278,1.8992805755395683
2018-19,RegularSeason,1629006,190,Josh Okogie,1610612750,MIN,74,1757,196,508,0.386,60,215,0.279,118,162,0.728,41,177,218,91,88,33,63,166,570,581,1.44,1.4,2018,19,7.702702702702703,1.4444444444444444,312,44,356,0.6123595505617978
2018-19,RegularSeason,203121,191,Darius Miller,1610612740,NOP,69,1757,189,484,0.39,133,364,0.365,56,71,0.789,14,114,128,146,40,23,59,165,567,535,2.48,0.68,2018,19,8.217391304347826,2.4745762711864407,295,15,310,0.4129032258064516
2018-19,RegularSeason,203926,192,Doug McDermott,1610612754,IND,77,1340,207,422,0.491,84,206,0.408,66,79,0.835,17,92,109,67,18,8,42,104,564,496,1.59,0.43,2018,19,7.324675324675325,1.5952380952380953,215,13,228,0.4780701754385965
2018-19,RegularSeason,1713,193,Vince Carter,1610612737,ATL,76,1330,196,468,0.419,123,316,0.389,47,66,0.712,31,163,194,87,44,27,48,141,562,575,1.81,0.92,2018,19,7.394736842105263,1.8125,272,19,291,0.6666666666666666
2018-19,RegularSeason,202692,194,Alec Burks,1610612758,SAC,64,1375,192,474,0.405,61,168,0.363,116,141,0.823,30,205,235,128,39,21,65,91,561,612,1.97,0.6,2018,19,8.765625,1.9692307692307693,282,25,307,0.7654723127035831
2018-19,RegularSeason,1627747,195,Caris LeVert,1610612751,BKN,40,1063,207,483,0.429,48,154,0.312,85,123,0.691,35,116,151,156,42,14,69,77,547,527,2.26,0.61,2018,19,13.675,2.260869565217391,276,38,314,0.48089171974522293
2018-19,RegularSeason,202693,195,Markieff Morris,1610612760,OKC,58,1271,204,484,0.421,68,203,0.335,71,92,0.772,61,204,265,79,36,22,54,175,547,594,1.46,0.67,2018,19,9.431034482758621,1.462962962962963,280,21,301,0.8803986710963455
2018-19,RegularSeason,1626168,197,Trey Lyles,1610612743,DEN,64,1120,207,495,0.418,51,200,0.255,81,116,0.698,44,202,246,87,30,23,68,93,546,541,1.28,0.44,2018,19,8.53125,1.2794117647058822,288,35,323,0.7616099071207431
2018-19,RegularSeason,201961,198,Wayne Ellington,1610612765,DET,53,1297,184,457,0.403,138,372,0.371,39,49,0.796,14,93,107,72,54,6,40,92,545,461,1.8,1.35,2018,19,10.283018867924529,1.8,273,10,283,0.37809187279151946
2018-19,RegularSeason,1627853,199,Ryan Arcidiacono,1610612741,CHI,81,1961,187,418,0.447,81,217,0.373,89,102,0.873,27,192,219,269,65,4,63,171,544,794,4.27,1.03,2018,19,6.716049382716049,4.26984126984127,231,13,244,0.8975409836065574
2018-19,RegularSeason,1627774,200,Jake Layman,1610612757,POR,71,1327,216,424,0.509,59,181,0.326,50,71,0.704,56,161,217,53,31,30,46,116,541,597,1.15,0.67,2018,19,7.619718309859155,1.1521739130434783,208,21,229,0.9475982532751092
2018-19,RegularSeason,202709,201,Cory Joseph,1610612754,IND,82,2063,226,548,0.412,55,171,0.322,30,43,0.698,39,240,279,321,94,22,80,131,537,838,4.01,1.18,2018,19,6.548780487804878,4.0125,322,13,335,0.8328358208955224
2018-19,RegularSeason,1629066,202,Rodions Kurucs,1610612751,BKN,63,1294,202,449,0.45,58,184,0.315,72,92,0.783,56,190,246,52,41,25,77,146,534,554,0.68,0.53,2018,19,8.476190476190476,0.6753246753246753,247,20,267,0.9213483146067416
2018-19,RegularSeason,2225,203,Tony Parker,1610612766,CHA,56,1003,213,463,0.46,13,51,0.255,91,124,0.734,14,69,83,207,21,7,75,53,530,490,2.76,0.28,2018,19,9.464285714285714,2.76,250,33,283,0.29328621908127206
2018-19,RegularSeason,203894,204,Shabazz Napier,1610612751,BKN,56,983,169,435,0.389,76,228,0.333,115,138,0.833,18,82,100,143,41,16,66,67,529,474,2.17,0.62,2018,19,9.446428571428571,2.1666666666666665,266,23,289,0.3460207612456747
2018-19,RegularSeason,203079,205,Dion Waiters,1610612748,MIA,44,1138,198,478,0.414,109,289,0.377,22,44,0.5,7,109,116,121,29,9,64,72,527,436,1.89,0.45,2018,19,11.977272727272727,1.890625,280,22,302,0.3841059602649007
2018-19,RegularSeason,1626178,205,Rondae Hollis-Jefferson,1610612751,BKN,59,1234,200,487,0.411,9,49,0.184,118,183,0.645,83,227,310,96,44,27,68,107,527,584,1.41,0.65,2018,19,8.932203389830509,1.411764705882353,287,65,352,0.8806818181818182
2018-19,RegularSeason,1627826,207,Ivica Zubac,1610612746,LAC,59,1039,212,379,0.559,0,0,0.0,101,126,0.802,115,247,362,63,14,51,70,137,525,753,0.9,0.2,2018,19,8.898305084745763,0.9,167,25,192,1.8854166666666667
2018-19,RegularSeason,1628404,207,Josh Hart,1610612747,LAL,67,1715,189,464,0.407,92,274,0.336,55,80,0.688,35,213,248,93,64,40,58,147,525,612,1.6,1.1,2018,19,7.835820895522388,1.603448275862069,275,25,300,0.8266666666666667
2018-19,RegularSeason,1627739,209,Kris Dunn,1610612741,CHI,46,1389,215,506,0.425,34,96,0.354,55,69,0.797,19,168,187,277,68,21,104,166,519,663,2.66,0.65,2018,19,11.282608695652174,2.6634615384615383,291,14,305,0.6131147540983607
2018-19,RegularSeason,1626181,210,Norman Powell,1610612761,TOR,60,1126,193,400,0.483,68,170,0.4,62,75,0.827,16,123,139,91,39,13,65,96,516,513,1.4,0.6,2018,19,8.6,1.4,207,13,220,0.6318181818181818
2018-19,RegularSeason,1627782,211,Wayne Selden,1610612741,CHI,75,1439,196,483,0.406,55,174,0.316,67,92,0.728,37,143,180,109,33,13,79,131,514,458,1.38,0.42,2018,19,6.8533333333333335,1.379746835443038,287,25,312,0.5769230769230769
2018-19,RegularSeason,1628390,212,Terrance Ferguson,1610612760,OKC,74,1931,185,431,0.429,106,290,0.366,37,51,0.725,33,108,141,72,40,16,47,231,513,475,1.53,0.85,2018,19,6.9324324324324325,1.5319148936170213,246,14,260,0.5423076923076923
2018-19,RegularSeason,1628380,213,Zach Collins,1610612757,POR,77,1356,189,400,0.473,40,121,0.331,94,126,0.746,109,215,324,71,25,66,77,174,512,678,0.92,0.33,2018,19,6.64935064935065,0.922077922077922,211,32,243,1.3333333333333333
2018-19,RegularSeason,1626209,214,Mario Hezonja,1610612752,NYK,58,1206,191,464,0.412,42,152,0.276,87,114,0.763,28,211,239,88,57,8,88,110,511,515,1.0,0.65,2018,19,8.810344827586206,1.0,273,27,300,0.7966666666666666
2018-19,RegularSeason,201952,215,Jeff Teague,1610612750,MIN,42,1264,176,416,0.423,35,105,0.333,123,153,0.804,16,90,106,343,43,18,97,90,510,653,3.54,0.44,2018,19,12.142857142857142,3.536082474226804,240,30,270,0.3925925925925926
2018-19,RegularSeason,1626188,216,Quinn Cook,1610612744,GSW,74,1059,204,439,0.465,81,200,0.405,20,26,0.769,22,135,157,116,20,3,50,92,509,514,2.32,0.4,2018,19,6.878378378378378,2.32,235,6,241,0.6514522821576764
2018-19,RegularSeason,2037,217,Jamal Crawford,1610612756,PHX,64,1211,174,438,0.397,67,202,0.332,93,110,0.845,8,77,85,229,33,12,99,75,508,487,2.31,0.33,2018,19,7.9375,2.313131313131313,264,17,281,0.302491103202847
2018-19,RegularSeason,203585,218,Rodney McGruder,1610612746,LAC,66,1550,186,461,0.403,79,225,0.351,52,72,0.722,60,178,238,112,36,12,64,115,503,542,1.75,0.56,2018,19,7.621212121212121,1.75,275,20,295,0.8067796610169492
2018-19,RegularSeason,202397,219,Ish Smith,1610612765,DET,56,1251,205,489,0.419,44,135,0.326,47,62,0.758,23,122,145,203,28,11,61,109,501,528,3.33,0.46,2018,19,8.946428571428571,3.3278688524590163,284,15,299,0.48494983277591974
2018-19,RegularSeason,1626172,220,Kevon Looney,1610612744,GSW,80,1481,217,347,0.625,1,10,0.1,65,105,0.619,194,223,417,123,46,53,51,211,500,918,2.41,0.9,2018,19,6.25,2.411764705882353,130,40,170,2.4529411764705884
2018-19,RegularSeason,203469,221,Cody Zeller,1610612766,CHA,49,1243,190,345,0.551,6,22,0.273,111,141,0.787,110,223,333,102,38,41,62,164,497,764,1.65,0.61,2018,19,10.142857142857142,1.6451612903225807,155,30,185,1.8
2018-19,RegularSeason,1628402,222,Frank Jackson,1610612740,NOP,61,1169,194,447,0.434,53,169,0.314,54,73,0.74,25,109,134,69,25,2,48,92,495,405,1.44,0.52,2018,19,8.114754098360656,1.4375,253,19,272,0.49264705882352944
2018-19,RegularSeason,202323,223,Evan Turner,1610612757,POR,73,1606,204,443,0.46,11,52,0.212,75,106,0.708,37,291,328,283,33,18,114,110,494,772,2.48,0.29,2018,19,6.767123287671233,2.482456140350877,239,31,270,1.2148148148148148
2018-19,RegularSeason,201609,223,Goran Dragic,1610612748,MIA,36,991,179,433,0.413,57,164,0.348,79,101,0.782,20,91,111,174,30,5,71,81,494,467,2.45,0.42,2018,19,13.722222222222221,2.4507042253521125,254,22,276,0.40217391304347827
2018-19,RegularSeason,203115,223,Will Barton,1610612743,DEN,43,1189,185,460,0.402,67,196,0.342,57,74,0.77,32,167,199,124,18,22,65,82,494,500,1.91,0.28,2018,19,11.488372093023257,1.9076923076923078,275,17,292,0.6815068493150684
2018-19,RegularSeason,202362,226,Lance Stephenson,1610612747,LAL,68,1123,184,432,0.426,73,197,0.371,50,73,0.685,32,183,215,140,41,7,86,111,491,537,1.63,0.48,2018,19,7.220588235294118,1.627906976744186,248,23,271,0.7933579335793358
2018-19,RegularSeason,202326,227,DeMarcus Cousins,1610612744,GSW,30,771,178,371,0.48,26,95,0.274,106,144,0.736,43,204,247,107,40,44,72,109,488,623,1.49,0.56,2018,19,16.266666666666666,1.4861111111111112,193,38,231,1.0692640692640694
2018-19,RegularSeason,203110,228,Draymond Green,1610612744,GSW,66,2065,188,422,0.445,47,165,0.285,63,91,0.692,60,421,481,454,95,70,169,197,486,1155,2.69,0.56,2018,19,7.363636363636363,2.6863905325443787,234,28,262,1.8358778625954197
2018-19,RegularSeason,203476,229,Gorgui Dieng,1610612750,MIN,76,1031,189,377,0.501,19,56,0.339,88,106,0.83,81,230,311,72,48,41,57,134,485,694,1.26,0.84,2018,19,6.381578947368421,1.263157894736842,188,18,206,1.5097087378640777
2018-19,RegularSeason,1628467,229,Maxi Kleber,1610612742,DAL,71,1502,175,386,0.453,77,218,0.353,58,74,0.784,90,239,329,70,36,78,54,143,485,717,1.3,0.67,2018,19,6.830985915492958,1.2962962962962963,211,16,227,1.449339207048458
2018-19,RegularSeason,1629011,229,Mitchell Robinson,1610612752,NYK,66,1360,202,291,0.694,0,0,0.0,81,135,0.6,177,246,423,37,52,161,35,217,485,980,1.06,1.49,2018,19,7.348484848484849,1.0571428571428572,89,54,143,2.958041958041958
2018-19,RegularSeason,1626143,232,Jahlil Okafor,1610612740,NOP,59,935,212,362,0.586,1,5,0.2,59,89,0.663,82,196,278,40,15,40,52,96,484,625,0.77,0.29,2018,19,8.203389830508474,0.7692307692307693,150,30,180,1.5444444444444445
2018-19,RegularSeason,204456,233,T.J. McConnell,1610612755,PHI,76,1470,220,419,0.525,14,42,0.333,29,37,0.784,28,146,174,258,79,17,91,105,483,713,2.83,0.87,2018,19,6.355263157894737,2.8351648351648353,199,8,207,0.8405797101449275
2018-19,RegularSeason,1627885,234,Shaquille Harrison,1610612741,CHI,73,1430,184,426,0.432,24,89,0.27,82,123,0.667,33,189,222,139,89,30,60,124,474,611,2.32,1.48,2018,19,6.493150684931507,2.316666666666667,242,41,283,0.784452296819788
2018-19,RegularSeason,202334,235,Ed Davis,1610612751,BKN,81,1446,186,302,0.616,0,2,0.0,100,162,0.617,216,478,694,61,35,33,64,226,472,1053,0.95,0.55,2018,19,5.827160493827161,0.953125,116,62,178,3.898876404494382
2018-19,RegularSeason,202684,236,Tristan Thompson,1610612739,CLE,43,1198,201,380,0.529,0,0,0.0,68,106,0.642,173,265,438,86,28,16,59,89,470,762,1.46,0.47,2018,19,10.930232558139535,1.4576271186440677,179,38,217,2.0184331797235022
2018-19,RegularSeason,1628384,237,OG Anunoby,1610612761,TOR,67,1352,183,404,0.453,67,202,0.332,36,62,0.581,58,139,197,47,46,22,55,140,469,479,0.85,0.84,2018,19,7.0,0.8545454545454545,221,26,247,0.7975708502024291
2018-19,RegularSeason,1626145,238,Tyus Jones,1610612750,MIN,68,1560,185,446,0.415,40,126,0.317,58,69,0.841,23,111,134,327,81,5,47,78,468,696,6.96,1.72,2018,19,6.882352941176471,6.957446808510638,261,11,272,0.49264705882352944
2018-19,RegularSeason,202697,239,Iman Shumpert,1610612745,HOU,62,1481,167,446,0.374,95,273,0.348,36,45,0.8,27,156,183,112,59,24,50,127,465,505,2.24,1.18,2018,19,7.5,2.24,279,9,288,0.6354166666666666
2018-19,RegularSeason,1628366,239,Lonzo Ball,1610612747,LAL,47,1423,185,456,0.406,75,228,0.329,20,48,0.417,54,197,251,255,69,19,103,114,465,657,2.48,0.67,2018,19,9.893617021276595,2.4757281553398056,271,28,299,0.8394648829431438
2018-19,RegularSeason,203496,239,Robert Covington,1610612750,MIN,35,1203,156,362,0.431,85,225,0.378,68,89,0.764,28,165,193,46,74,47,47,126,465,551,0.98,1.57,2018,19,13.285714285714286,0.9787234042553191,206,21,227,0.8502202643171806
2018-19,RegularSeason,203090,242,Maurice Harkless,1610612757,POR,60,1415,189,388,0.487,33,120,0.275,49,73,0.671,77,192,269,74,67,53,45,163,460,655,1.64,1.49,2018,19,7.666666666666667,1.6444444444444444,199,24,223,1.2062780269058295
2018-19,RegularSeason,1627790,243,Ante Zizic,1610612739,CLE,59,1082,183,331,0.553,0,0,0.0,93,132,0.705,108,212,320,53,13,22,61,113,459,619,0.87,0.21,2018,19,7.779661016949152,0.8688524590163934,148,39,187,1.7112299465240641
2018-19,RegularSeason,201973,243,Jonas Jerebko,1610612744,GSW,73,1218,163,355,0.459,69,188,0.367,64,80,0.8,72,216,288,96,27,18,43,137,459,637,2.23,0.63,2018,19,6.287671232876712,2.2325581395348837,192,16,208,1.3846153846153846
2018-19,RegularSeason,203118,243,Mike Scott,1610612755,PHI,79,1396,168,420,0.4,101,252,0.401,22,33,0.667,43,233,276,66,26,13,44,156,459,533,1.5,0.59,2018,19,5.810126582278481,1.5,252,11,263,1.049429657794677
2018-19,RegularSeason,201588,246,George Hill,1610612749,MIL,60,1302,170,376,0.452,48,153,0.314,70,85,0.824,39,109,148,135,52,8,51,102,458,529,2.65,1.02,2018,19,7.633333333333334,2.6470588235294117,206,15,221,0.669683257918552
2018-19,RegularSeason,1628976,247,Wendell Carter Jr.,1610612741,CHI,44,1110,180,371,0.485,6,32,0.188,89,112,0.795,87,220,307,78,26,58,65,152,455,645,1.2,0.4,2018,19,10.340909090909092,1.2,191,23,214,1.4345794392523366
2018-19,RegularSeason,1626169,248,Stanley Johnson,1610612740,NOP,66,1207,171,440,0.389,62,215,0.288,50,64,0.781,34,183,217,88,60,14,81,114,454,469,1.09,0.74,2018,19,6.878787878787879,1.0864197530864197,269,14,283,0.7667844522968198
2018-19,RegularSeason,101141,249,Ersan Ilyasova,1610612749,MIL,67,1231,167,381,0.438,58,160,0.363,61,74,0.824,94,208,302,52,32,20,48,172,453,584,1.08,0.67,2018,19,6.7611940298507465,1.0833333333333333,214,13,227,1.330396475770925
2018-19,RegularSeason,203488,250,Mike Muscala,1610612747,LAL,64,1306,145,361,0.402,89,256,0.348,70,85,0.824,57,187,244,76,22,38,48,130,449,550,1.58,0.46,2018,19,7.015625,1.5833333333333333,216,15,231,1.0562770562770563
2018-19,RegularSeason,203901,251,Elfrid Payton,1610612740,NOP,42,1250,179,412,0.434,33,105,0.314,55,74,0.743,49,171,220,320,44,17,112,81,446,683,2.86,0.39,2018,19,10.619047619047619,2.857142857142857,233,19,252,0.873015873015873
2018-19,RegularSeason,203503,252,Tony Snell,1610612749,MIL,74,1304,163,361,0.452,81,204,0.397,37,42,0.881,29,128,157,68,26,18,23,90,444,487,2.96,1.13,2018,19,6.0,2.9565217391304346,198,5,203,0.7733990147783252
2018-19,RegularSeason,202714,253,Shelvin Mack,1610612766,CHA,57,1247,163,403,0.404,46,130,0.354,58,84,0.69,18,86,104,183,47,4,66,84,430,436,2.77,0.71,2018,19,7.543859649122807,2.772727272727273,240,26,266,0.39097744360902253
2018-19,RegularSeason,1628470,253,Torrey Craig,1610612743,DEN,75,1503,160,362,0.442,61,188,0.324,49,70,0.7,89,174,263,72,37,46,44,175,430,581,1.64,0.84,2018,19,5.733333333333333,1.6363636363636365,202,21,223,1.1793721973094171
2018-19,RegularSeason,2734,255,Devin Harris,1610612742,DAL,68,1071,132,347,0.38,62,200,0.31,102,134,0.761,12,100,112,122,35,16,56,133,428,410,2.18,0.63,2018,19,6.294117647058823,2.1785714285714284,215,32,247,0.4534412955465587
2018-19,RegularSeason,201949,255,James Johnson,1610612748,MIA,55,1164,164,379,0.433,50,149,0.336,50,70,0.714,22,154,176,135,35,27,74,114,428,492,1.82,0.47,2018,19,7.781818181818182,1.8243243243243243,215,20,235,0.7489361702127659
2018-19,RegularSeason,203077,257,Michael Kidd-Gilchrist,1610612766,CHA,64,1179,158,332,0.476,16,47,0.34,95,123,0.772,88,158,246,61,32,39,43,156,427,560,1.42,0.74,2018,19,6.671875,1.4186046511627908,174,28,202,1.2178217821782178
2018-19,RegularSeason,1626220,258,Royce O'Neale,1610612762,UTA,82,1671,163,343,0.475,68,176,0.386,32,42,0.762,22,263,285,124,54,24,70,172,426,653,1.77,0.77,2018,19,5.195121951219512,1.7714285714285714,180,10,190,1.5
2018-19,RegularSeason,200765,259,Rajon Rondo,1610612747,LAL,46,1369,175,432,0.405,51,142,0.359,23,36,0.639,34,209,243,367,57,7,127,100,424,701,2.89,0.45,2018,19,9.217391304347826,2.8897637795275593,257,13,270,0.9
2018-19,RegularSeason,1627751,260,Jakob Poeltl,1610612759,SAS,77,1273,187,290,0.645,0,0,0.0,49,92,0.533,178,232,410,93,29,68,48,124,423,829,1.94,0.6,2018,19,5.4935064935064934,1.9375,103,43,146,2.808219178082192
2018-19,RegularSeason,1626246,261,Boban Marjanovic,1610612755,PHI,58,681,160,260,0.615,4,10,0.4,98,131,0.748,87,178,265,54,16,27,59,90,422,592,0.92,0.27,2018,19,7.275862068965517,0.9152542372881356,100,33,133,1.9924812030075187
2018-19,RegularSeason,1627884,261,Derrick Jones Jr.,1610612748,MIA,60,1154,160,324,0.494,28,91,0.308,74,122,0.607,96,144,240,37,46,42,43,123,422,532,0.86,1.07,2018,19,7.033333333333333,0.8604651162790697,164,48,212,1.1320754716981132
2018-19,RegularSeason,1626192,263,Pat Connaughton,1610612749,MIL,61,1261,163,350,0.466,66,200,0.33,29,40,0.725,61,197,258,122,33,25,33,81,421,628,3.7,1.0,2018,19,6.901639344262295,3.696969696969697,187,11,198,1.303030303030303
2018-19,RegularSeason,1626195,263,Willy Hernangomez,1610612766,CHA,58,812,153,295,0.519,15,39,0.385,100,144,0.694,117,194,311,60,16,20,58,98,421,584,1.03,0.28,2018,19,7.258620689655173,1.0344827586206897,142,44,186,1.6720430107526882
2018-19,RegularSeason,1627812,265,Yogi Ferrell,1610612758,SAC,71,1067,153,352,0.435,54,149,0.362,60,67,0.896,13,96,109,137,36,4,40,64,420,460,3.42,0.9,2018,19,5.915492957746479,3.425,199,7,206,0.529126213592233
2018-19,RegularSeason,1628469,266,Antonio Blakeney,1610612741,CHI,57,829,166,396,0.419,36,91,0.396,50,76,0.658,7,99,106,42,12,9,35,41,418,296,1.2,0.34,2018,19,7.333333333333333,1.2,230,26,256,0.4140625
2018-19,RegularSeason,200826,267,J.J. Barea,1610612742,DAL,38,752,161,385,0.418,38,128,0.297,55,78,0.705,13,82,95,211,22,1,72,50,415,425,2.93,0.31,2018,19,10.921052631578947,2.9305555555555554,224,23,247,0.38461538461538464
2018-19,RegularSeason,203459,268,Allen Crabbe,1610612751,BKN,43,1133,137,373,0.367,98,259,0.378,41,56,0.732,16,132,148,46,23,13,46,102,413,346,1.0,0.5,2018,19,9.604651162790697,1.0,236,15,251,0.5896414342629482
2018-19,RegularSeason,1628385,269,Harry Giles III,1610612758,SAC,58,820,175,348,0.503,0,6,0.0,58,91,0.637,66,156,222,85,31,22,73,150,408,489,1.16,0.42,2018,19,7.0344827586206895,1.1643835616438356,173,33,206,1.0776699029126213
2018-19,RegularSeason,1627823,269,Juancho Hernangomez,1610612743,DEN,70,1358,138,314,0.439,66,181,0.365,66,86,0.767,64,201,265,55,27,24,37,94,408,546,1.49,0.73,2018,19,5.828571428571428,1.4864864864864864,176,20,196,1.3520408163265305
2018-19,RegularSeason,1626163,271,Frank Kaminsky,1610612766,CHA,47,755,138,298,0.463,50,139,0.36,79,107,0.738,39,124,163,63,12,12,41,68,405,426,1.54,0.29,2018,19,8.617021276595745,1.5365853658536586,160,28,188,0.8670212765957447
2018-19,RegularSeason,203546,272,Ian Clark,1610612740,NOP,60,973,151,383,0.394,66,202,0.327,33,37,0.892,13,76,89,94,22,8,58,95,401,320,1.62,0.38,2018,19,6.683333333333334,1.6206896551724137,232,4,236,0.3771186440677966
2018-19,RegularSeason,203917,273,Nik Stauskas,1610612739,CLE,68,1015,136,338,0.402,70,188,0.372,57,64,0.891,18,109,127,81,21,7,51,50,399,375,1.59,0.41,2018,19,5.867647058823529,1.588235294117647,202,7,209,0.6076555023923444
2018-19,RegularSeason,2738,274,Andre Iguodala,1610612744,GSW,68,1578,151,302,0.5,48,144,0.333,39,67,0.582,48,204,252,216,61,51,52,95,389,738,4.15,1.17,2018,19,5.720588235294118,4.153846153846154,151,28,179,1.4078212290502794
2018-19,RegularSeason,203516,274,James Ennis III,1610612755,PHI,58,1230,138,294,0.469,55,156,0.353,58,81,0.716,60,122,182,41,41,23,34,150,389,463,1.21,1.21,2018,19,6.706896551724138,1.2058823529411764,156,23,179,1.0167597765363128
2018-19,RegularSeason,1627767,276,Cheick Diallo,1610612740,NOP,64,896,168,271,0.62,1,4,0.25,50,67,0.746,75,257,332,33,29,33,49,113,387,645,0.67,0.59,2018,19,6.046875,0.673469387755102,103,17,120,2.7666666666666666
2018-19,RegularSeason,202702,277,Kenneth Faried,1610612745,HOU,37,728,156,265,0.589,8,25,0.32,64,99,0.646,97,153,250,20,17,23,33,82,384,517,0.61,0.52,2018,19,10.378378378378379,0.6060606060606061,109,35,144,1.7361111111111112
2018-19,RegularSeason,203457,278,Nerlens Noel,1610612760,OKC,77,1056,162,276,0.587,0,0,0.0,54,79,0.684,127,198,325,45,66,96,48,166,378,723,0.94,1.38,2018,19,4.909090909090909,0.9375,114,25,139,2.338129496402878
2018-19,RegularSeason,1628464,279,Daniel Theis,1610612738,BOS,66,908,146,266,0.549,26,67,0.388,56,76,0.737,87,138,225,68,21,42,33,161,374,557,2.06,0.64,2018,19,5.666666666666667,2.0606060606060606,120,20,140,1.6071428571428572
2018-19,RegularSeason,201567,279,Kevin Love,1610612739,CLE,22,598,109,283,0.385,53,147,0.361,103,114,0.904,33,206,239,48,6,5,42,54,374,445,1.14,0.14,2018,19,17.0,1.1428571428571428,174,11,185,1.2918918918918918
2018-19,RegularSeason,1717,281,Dirk Nowitzki,1610612742,DAL,51,795,135,376,0.359,64,205,0.312,39,50,0.78,5,153,158,35,9,18,18,76,373,323,1.94,0.5,2018,19,7.313725490196078,1.9444444444444444,241,11,252,0.626984126984127
2018-19,RegularSeason,1628425,282,Sterling Brown,1610612749,MIL,58,1034,145,312,0.465,53,147,0.361,29,42,0.69,29,155,184,84,25,8,46,88,372,447,1.83,0.54,2018,19,6.413793103448276,1.826086956521739,167,13,180,1.0222222222222221
2018-19,RegularSeason,1627863,283,Danuel House Jr.,1610612745,HOU,39,979,118,252,0.468,74,178,0.416,56,71,0.789,25,115,140,40,21,11,35,80,366,394,1.14,0.6,2018,19,9.384615384615385,1.1428571428571428,134,15,149,0.9395973154362416
2018-19,RegularSeason,203613,283,Jonathon Simmons,1610612755,PHI,56,1064,133,350,0.38,28,104,0.269,72,97,0.742,27,99,126,128,29,15,68,89,366,354,1.88,0.43,2018,19,6.535714285714286,1.8823529411764706,217,25,242,0.5206611570247934
2018-19,RegularSeason,203086,285,Meyers Leonard,1610612757,POR,61,878,132,242,0.545,50,111,0.45,43,51,0.843,49,184,233,75,13,9,43,105,357,526,1.74,0.3,2018,19,5.852459016393443,1.744186046511628,110,8,118,1.9745762711864407
2018-19,RegularSeason,203937,286,Kyle Anderson,1610612763,MEM,43,1282,150,276,0.543,9,34,0.265,37,64,0.578,48,203,251,128,54,37,58,112,346,605,2.21,0.93,2018,19,8.046511627906977,2.206896551724138,126,27,153,1.6405228758169934
2018-19,RegularSeason,101139,287,CJ Miles,1610612763,MEM,53,857,112,311,0.36,67,203,0.33,48,58,0.828,13,82,95,36,26,15,30,79,339,272,1.2,0.87,2018,19,6.39622641509434,1.2,199,10,209,0.45454545454545453
2018-19,RegularSeason,1628411,287,Wes Iwundu,1610612753,ORL,68,1233,113,274,0.412,29,79,0.367,84,103,0.816,37,147,184,73,28,22,44,123,339,422,1.66,0.64,2018,19,4.985294117647059,1.6590909090909092,161,19,180,1.0222222222222221
2018-19,RegularSeason,1628035,289,Alfonzo McKinnie,1610612744,GSW,72,1003,134,275,0.487,42,118,0.356,27,48,0.563,81,166,247,31,18,15,30,134,337,456,1.03,0.6,2018,19,4.680555555555555,1.0333333333333334,141,21,162,1.5246913580246915
2018-19,RegularSeason,1628021,290,David Nwaba,1610612739,CLE,51,984,126,262,0.481,24,75,0.32,58,85,0.682,41,122,163,54,36,17,29,106,334,412,1.86,1.24,2018,19,6.549019607843137,1.8620689655172413,136,27,163,1.0
2018-19,RegularSeason,201229,291,Anthony Tolliver,1610612750,MIN,65,1079,99,259,0.382,81,215,0.377,47,60,0.783,15,162,177,46,17,21,36,91,326,378,1.28,0.47,2018,19,5.015384615384615,1.2777777777777777,160,13,173,1.023121387283237
2018-19,RegularSeason,1627748,292,Thon Maker,1610612765,DET,64,972,109,268,0.407,49,153,0.32,56,84,0.667,41,161,202,45,21,51,33,105,323,422,1.36,0.64,2018,19,5.046875,1.3636363636363635,159,28,187,1.0802139037433156
2018-19,RegularSeason,1628436,293,Luke Kornet,1610612752,NYK,46,784,107,283,0.378,70,193,0.363,38,46,0.826,28,107,135,54,27,42,25,41,322,371,2.16,1.08,2018,19,7.0,2.16,176,8,184,0.7336956521739131
2018-19,RegularSeason,1628971,294,Bruce Brown,1610612765,DET,74,1449,125,314,0.398,24,93,0.258,45,60,0.75,48,137,185,91,40,36,46,178,319,421,1.98,0.87,2018,19,4.3108108108108105,1.9782608695652173,189,15,204,0.9068627450980392
2018-19,RegularSeason,203584,295,Troy Daniels,1610612756,PHX,51,760,113,275,0.411,74,194,0.381,18,23,0.783,13,60,73,26,26,5,27,79,318,254,0.96,0.96,2018,19,6.235294117647059,0.9629629629629629,162,5,167,0.437125748502994
2018-19,RegularSeason,1628407,296,Dwayne Bacon,1610612766,CHA,43,759,122,257,0.475,38,87,0.437,34,46,0.739,8,81,89,47,12,5,18,72,316,304,2.61,0.67,2018,19,7.348837209302325,2.611111111111111,135,12,147,0.6054421768707483
2018-19,RegularSeason,204025,297,Tim Frazier,1610612749,MIL,59,1120,116,261,0.444,37,101,0.366,41,54,0.759,41,127,168,248,30,5,76,112,310,527,3.26,0.4,2018,19,5.254237288135593,3.263157894736842,145,13,158,1.0632911392405062
2018-19,RegularSeason,201163,298,Wilson Chandler,1610612746,LAC,51,1176,114,273,0.418,59,158,0.373,18,25,0.72,48,167,215,82,25,21,46,123,305,436,1.78,0.54,2018,19,5.980392156862745,1.7826086956521738,159,7,166,1.2951807228915662
2018-19,RegularSeason,1629059,299,Elie Okobo,1610612756,PHX,53,958,114,290,0.393,39,132,0.295,37,47,0.787,12,86,98,127,32,7,69,109,304,313,1.84,0.46,2018,19,5.735849056603773,1.8405797101449275,176,10,186,0.5268817204301075
2018-19,RegularSeason,201149,300,Joakim Noah,1610612763,MEM,42,693,110,213,0.516,0,1,0.0,78,109,0.716,58,180,238,89,20,31,50,96,298,492,1.78,0.4,2018,19,7.095238095238095,1.78,103,31,134,1.7761194029850746
2018-19,RegularSeason,1628416,301,Tyler Dorsey,1610612763,MEM,48,698,107,264,0.405,44,132,0.333,38,61,0.623,27,86,113,56,14,2,27,53,296,274,2.07,0.52,2018,19,6.166666666666667,2.074074074074074,157,23,180,0.6277777777777778
2018-19,RegularSeason,1628988,302,Aaron Holiday,1610612754,IND,50,646,105,262,0.401,43,127,0.339,41,50,0.82,5,62,67,87,21,13,40,71,294,276,2.17,0.53,2018,19,5.88,2.175,157,9,166,0.4036144578313253
2018-19,RegularSeason,1628964,303,Mo Bamba,1610612753,ORL,47,766,117,243,0.481,21,70,0.3,37,63,0.587,64,169,233,39,13,64,43,102,292,446,0.91,0.3,2018,19,6.212765957446808,0.9069767441860465,126,26,152,1.5328947368421053
2018-19,RegularSeason,203957,304,Dante Exum,1610612762,UTA,42,664,101,241,0.419,18,62,0.29,68,86,0.791,16,52,68,110,14,5,52,69,288,275,2.12,0.27,2018,19,6.857142857142857,2.1153846153846154,140,18,158,0.43037974683544306
2018-19,RegularSeason,201162,305,Jared Dudley,1610612751,BKN,59,1220,101,239,0.423,53,151,0.351,32,46,0.696,34,121,155,83,36,16,43,131,287,382,1.93,0.84,2018,19,4.864406779661017,1.930232558139535,138,14,152,1.019736842105263
2018-19,RegularSeason,1626155,305,Sam Dekker,1610612764,WAS,47,789,120,256,0.469,19,62,0.306,28,46,0.609,53,95,148,46,38,7,24,47,287,348,1.92,1.58,2018,19,6.1063829787234045,1.9166666666666667,136,18,154,0.961038961038961
2018-19,RegularSeason,203382,307,Aron Baynes,1610612738,BOS,51,821,105,223,0.471,21,61,0.344,53,62,0.855,88,152,240,57,12,34,40,125,284,460,1.43,0.3,2018,19,5.568627450980392,1.425,118,9,127,1.889763779527559
2018-19,RegularSeason,1628397,307,Ivan Rabb,1610612763,MEM,49,721,116,212,0.547,3,15,0.2,49,69,0.71,70,136,206,54,17,14,35,90,284,424,1.54,0.49,2018,19,5.795918367346939,1.542857142857143,96,20,116,1.7758620689655173
2018-19,RegularSeason,203998,309,Bruno Caboclo,1610612763,MEM,34,800,96,225,0.427,48,130,0.369,42,50,0.84,42,116,158,50,14,33,38,81,282,362,1.32,0.37,2018,19,8.294117647058824,1.3157894736842106,129,8,137,1.1532846715328466
2018-19,RegularSeason,203521,309,Matthew Dellavedova,1610612739,CLE,48,812,98,242,0.405,44,130,0.338,42,52,0.808,6,71,77,181,14,2,68,75,282,334,2.66,0.21,2018,19,5.875,2.661764705882353,144,10,154,0.5
2018-19,RegularSeason,1628391,311,D.J. Wilson,1610612749,MIL,48,882,104,251,0.414,46,127,0.362,26,47,0.553,45,177,222,52,18,20,32,85,280,392,1.63,0.56,2018,19,5.833333333333333,1.625,147,21,168,1.3214285714285714
2018-19,RegularSeason,1627788,312,Furkan Korkmaz,1610612755,PHI,48,679,98,245,0.4,47,144,0.326,36,44,0.818,16,91,107,52,29,2,25,62,279,289,2.08,1.16,2018,19,5.8125,2.08,147,8,155,0.6903225806451613
2018-19,RegularSeason,1629026,312,Kenrich Williams,1610612740,NOP,46,1079,107,279,0.384,52,156,0.333,13,19,0.684,55,164,219,83,45,19,36,95,279,431,2.31,1.25,2018,19,6.065217391304348,2.3055555555555554,172,6,178,1.2303370786516854
2018-19,RegularSeason,1629016,314,Omari Spellman,1610612737,ATL,46,805,98,244,0.402,44,128,0.344,32,45,0.711,72,122,194,47,26,25,31,67,272,374,1.52,0.84,2018,19,5.913043478260869,1.5161290322580645,146,13,159,1.220125786163522
2018-19,RegularSeason,1626184,315,Chasson Randle,1610612764,WAS,49,743,91,217,0.419,46,115,0.4,43,62,0.694,10,46,56,97,25,3,43,91,271,264,2.26,0.58,2018,19,5.530612244897959,2.255813953488372,126,19,145,0.38620689655172413
2018-19,RegularSeason,2585,316,Zaza Pachulia,1610612765,DET,68,878,85,193,0.44,0,4,0.0,97,124,0.782,99,166,265,91,31,17,57,151,267,479,1.6,0.54,2018,19,3.926470588235294,1.5964912280701755,108,27,135,1.962962962962963
2018-19,RegularSeason,202688,317,Brandon Knight,1610612739,CLE,39,737,99,260,0.381,41,129,0.318,27,34,0.794,10,49,59,71,21,2,30,62,266,221,2.37,0.7,2018,19,6.82051282051282,2.3666666666666667,161,7,168,0.35119047619047616
2018-19,RegularSeason,2733,318,Shaun Livingston,1610612744,GSW,64,967,109,210,0.519,0,2,0.0,40,51,0.784,42,75,117,114,31,27,38,74,258,397,3.0,0.82,2018,19,4.03125,3.0,101,11,112,1.0446428571428572
2018-19,RegularSeason,1626166,319,Cameron Payne,1610612739,CLE,40,712,96,223,0.43,25,84,0.298,33,41,0.805,13,59,72,106,28,9,45,64,250,285,2.36,0.62,2018,19,6.25,2.3555555555555556,127,8,135,0.5333333333333333
2018-19,RegularSeason,1629001,319,De'Anthony Melton,1610612756,PHX,50,984,100,256,0.391,29,95,0.305,21,28,0.75,25,109,134,159,68,23,75,113,250,396,2.12,0.91,2018,19,5.0,2.12,156,7,163,0.8220858895705522
2018-19,RegularSeason,1626170,319,Jerian Grant,1610612753,ORL,60,939,92,220,0.418,40,110,0.364,26,40,0.65,19,79,98,156,44,6,51,78,250,361,3.06,0.86,2018,19,4.166666666666667,3.0588235294117645,128,14,142,0.6901408450704225
2018-19,RegularSeason,1628972,322,Troy Brown Jr.,1610612764,WAS,52,730,97,234,0.415,22,69,0.319,32,47,0.681,35,110,145,80,21,5,30,56,248,317,2.67,0.7,2018,19,4.769230769230769,2.6666666666666665,137,15,152,0.9539473684210527
2018-19,RegularSeason,1628373,323,Frank Ntilikina,1610612752,NYK,43,904,95,282,0.337,33,115,0.287,23,30,0.767,12,75,87,121,30,14,56,104,246,248,2.16,0.54,2018,19,5.72093023255814,2.1607142857142856,187,7,194,0.4484536082474227
2018-19,RegularSeason,1627846,324,Abdel Nader,1610612760,OKC,61,694,91,215,0.423,32,100,0.32,27,36,0.75,14,102,116,20,20,12,26,68,241,250,0.77,0.77,2018,19,3.9508196721311477,0.7692307692307693,124,9,133,0.8721804511278195
2018-19,RegularSeason,1626245,325,Cristiano Felicio,1610612741,CHI,60,746,95,179,0.531,0,4,0.0,50,73,0.685,79,139,218,37,11,7,33,69,240,373,1.12,0.33,2018,19,4.0,1.121212121212121,84,23,107,2.0373831775700935
2018-19,RegularSeason,203920,325,Khem Birch,1610612753,ORL,50,643,91,151,0.603,0,1,0.0,58,83,0.699,79,111,190,38,18,29,20,72,240,410,1.9,0.9,2018,19,4.8,1.9,60,25,85,2.235294117647059
2018-19,RegularSeason,202687,327,Bismack Biyombo,1610612766,CHA,54,782,89,156,0.571,0,0,0.0,58,91,0.637,81,166,247,33,11,41,34,103,236,434,0.97,0.32,2018,19,4.37037037037037,0.9705882352941176,67,33,100,2.47
2018-19,RegularSeason,1627777,328,Georges Niang,1610612762,UTA,59,516,86,181,0.475,43,105,0.41,20,24,0.833,11,76,87,35,10,6,23,57,235,251,1.52,0.43,2018,19,3.983050847457627,1.5217391304347827,95,4,99,0.8787878787878788
2018-19,RegularSeason,101162,329,Marcin Gortat,1610612746,LAC,47,750,99,186,0.532,0,0,0.0,35,48,0.729,67,194,261,65,6,24,50,92,233,439,1.3,0.12,2018,19,4.957446808510638,1.3,87,13,100,2.61
2018-19,RegularSeason,1627789,330,Timothe Luwawu-Cabarrot,1610612741,CHI,50,669,82,218,0.376,36,116,0.31,31,41,0.756,11,86,97,26,19,8,21,73,231,214,1.24,0.91,2018,19,4.62,1.2380952380952381,136,10,146,0.6643835616438356
2018-19,RegularSeason,1627733,331,Dragan Bender,1610612756,PHX,46,826,88,197,0.447,22,101,0.218,32,54,0.593,34,149,183,56,18,22,37,90,230,341,1.51,0.49,2018,19,5.0,1.5135135135135136,109,22,131,1.3969465648854962
2018-19,RegularSeason,202328,331,Greg Monroe,1610612755,PHI,43,480,92,189,0.487,1,5,0.2,45,72,0.625,67,105,172,24,14,8,32,66,230,292,0.75,0.44,2018,19,5.348837209302325,0.75,97,27,124,1.3870967741935485
2018-19,RegularSeason,1627936,333,Alex Caruso,1610612747,LAL,25,531,77,173,0.445,24,50,0.48,51,64,0.797,20,47,67,77,24,9,42,54,229,255,1.83,0.57,2018,19,9.16,1.8333333333333333,96,13,109,0.6146788990825688
2018-19,RegularSeason,1628990,333,Chandler Hutchison,1610612741,CHI,44,895,96,209,0.459,14,50,0.28,23,38,0.605,31,154,185,34,23,6,25,59,229,324,1.36,0.92,2018,19,5.204545454545454,1.36,113,15,128,1.4453125
2018-19,RegularSeason,202335,333,Patrick Patterson,1610612760,OKC,63,861,82,219,0.374,46,137,0.336,19,30,0.633,42,105,147,31,16,13,22,46,229,266,1.41,0.73,2018,19,3.634920634920635,1.4090909090909092,137,11,148,0.9932432432432432
2018-19,RegularSeason,201956,336,Omri Casspi,1610612763,MEM,36,520,86,161,0.534,15,43,0.349,39,58,0.672,17,98,115,26,20,9,23,35,226,279,1.13,0.87,2018,19,6.277777777777778,1.1304347826086956,75,19,94,1.2234042553191489
2018-19,RegularSeason,1628388,337,T.J. Leaf,1610612754,IND,58,522,99,183,0.541,8,31,0.258,19,31,0.613,43,82,125,24,9,19,12,35,225,294,2.0,0.75,2018,19,3.8793103448275863,2.0,84,12,96,1.3020833333333333
2018-19,RegularSeason,1628395,338,Jordan Bell,1610612744,GSW,68,788,99,192,0.516,0,2,0.0,25,41,0.61,55,129,184,76,20,51,42,80,223,403,1.81,0.48,2018,19,3.2794117647058822,1.8095238095238095,93,16,109,1.688073394495413
2018-19,RegularSeason,1627820,339,Tyrone Wallace,1610612746,LAC,62,628,92,217,0.424,4,19,0.211,30,57,0.526,20,81,101,42,21,7,36,83,218,201,1.17,0.58,2018,19,3.5161290322580645,1.1666666666666667,125,27,152,0.6644736842105263
2018-19,RegularSeason,1628984,340,Devonte' Graham,1610612766,CHA,46,676,74,216,0.343,34,121,0.281,35,46,0.761,10,53,63,121,23,2,30,48,217,243,4.03,0.77,2018,19,4.717391304347826,4.033333333333333,142,11,153,0.4117647058823529
2018-19,RegularSeason,1628960,341,Grayson Allen,1610612762,UTA,38,416,67,178,0.376,32,99,0.323,45,60,0.75,3,20,23,25,6,6,33,47,211,112,0.76,0.18,2018,19,5.552631578947368,0.7575757575757576,111,15,126,0.18253968253968253
2018-19,RegularSeason,201573,342,Jerryd Bayless,1610612750,MIN,34,657,82,230,0.357,29,98,0.296,16,28,0.571,11,51,62,119,18,2,32,56,209,218,3.72,0.56,2018,19,6.147058823529412,3.71875,148,12,160,0.3875
2018-19,RegularSeason,1628413,343,Jonah Bolden,1610612755,PHI,44,639,80,162,0.494,34,96,0.354,13,27,0.481,47,118,165,40,17,39,36,99,207,336,1.11,0.47,2018,19,4.704545454545454,1.1111111111111112,82,14,96,1.71875
2018-19,RegularSeason,1629021,343,Moritz Wagner,1610612747,LAL,43,446,71,171,0.415,22,77,0.286,43,53,0.811,17,68,85,24,11,13,39,57,207,191,0.61,0.28,2018,19,4.813953488372093,0.6153846153846154,100,10,110,0.7727272727272727
2018-19,RegularSeason,202498,345,Lance Thomas,1610612752,NYK,46,783,78,197,0.396,22,79,0.278,27,36,0.75,21,96,117,27,17,7,24,83,205,221,1.13,0.71,2018,19,4.456521739130435,1.125,119,9,128,0.9140625
2018-19,RegularSeason,101161,346,Amir Johnson,1610612755,PHI,51,529,79,157,0.503,12,40,0.3,31,41,0.756,47,100,147,60,16,13,45,99,201,304,1.33,0.36,2018,19,3.9411764705882355,1.3333333333333333,78,10,88,1.6704545454545454
2018-19,RegularSeason,203922,347,Glenn Robinson III,1610612765,DET,47,610,74,176,0.42,18,62,0.29,32,40,0.8,17,54,71,21,14,8,18,45,198,184,1.17,0.78,2018,19,4.212765957446808,1.1666666666666667,102,8,110,0.6454545454545455
2018-19,RegularSeason,203526,348,Raul Neto,1610612762,UTA,37,474,74,161,0.46,20,60,0.333,28,33,0.848,6,56,62,93,14,4,35,49,196,242,2.66,0.4,2018,19,5.297297297297297,2.657142857142857,87,5,92,0.6739130434782609
2018-19,RegularSeason,1628412,349,Frank Mason III,1610612758,SAC,38,435,71,169,0.42,14,64,0.219,39,57,0.684,6,37,43,84,16,4,36,34,195,190,2.33,0.44,2018,19,5.131578947368421,2.3333333333333335,98,18,116,0.3706896551724138
2018-19,RegularSeason,201967,350,Dante Cunningham,1610612759,SAS,64,928,75,158,0.475,30,65,0.462,14,18,0.778,48,140,188,50,27,13,22,71,194,363,2.27,1.23,2018,19,3.03125,2.272727272727273,83,4,87,2.160919540229885
2018-19,RegularSeason,203524,351,Solomon Hill,1610612740,NOP,44,879,68,178,0.382,32,101,0.317,23,32,0.719,34,99,133,55,23,10,31,80,191,262,1.77,0.74,2018,19,4.340909090909091,1.7741935483870968,110,9,119,1.1176470588235294
2018-19,RegularSeason,1628977,352,Hamidou Diallo,1610612760,OKC,51,526,75,165,0.455,4,24,0.167,36,59,0.61,38,59,97,17,21,10,23,77,190,199,0.74,0.91,2018,19,3.7254901960784315,0.7391304347826086,90,23,113,0.8584070796460177
2018-19,RegularSeason,202705,352,MarShon Brooks,1610612763,MEM,29,387,76,169,0.45,15,54,0.278,23,33,0.697,12,33,45,25,9,4,21,33,190,149,1.19,0.43,2018,19,6.551724137931035,1.1904761904761905,93,10,103,0.4368932038834951
2018-19,RegularSeason,200757,352,Thabo Sefolosha,1610612762,UTA,50,609,71,149,0.477,34,78,0.436,14,22,0.636,8,115,123,27,43,5,25,41,190,277,1.08,1.72,2018,19,3.8,1.08,78,8,86,1.430232558139535
2018-19,RegularSeason,1628443,355,Kadeem Allen,1610612752,NYK,19,416,65,141,0.461,17,36,0.472,42,54,0.778,8,43,51,76,16,4,26,46,189,222,2.92,0.61,2018,19,9.947368421052632,2.923076923076923,76,12,88,0.5795454545454546
2018-19,RegularSeason,202718,356,Chandler Parsons,1610612763,MEM,25,496,68,182,0.374,29,94,0.309,22,25,0.88,4,66,70,43,19,5,32,45,187,175,1.34,0.59,2018,19,7.48,1.34375,114,3,117,0.5982905982905983
2018-19,RegularSeason,1628400,357,Semi Ojeleye,1610612738,BOS,56,594,67,158,0.424,28,89,0.315,24,39,0.615,24,62,86,23,10,4,19,43,186,184,1.21,0.53,2018,19,3.3214285714285716,1.2105263157894737,91,15,106,0.8113207547169812
2018-19,RegularSeason,1626203,358,Treveon Graham,1610612751,BKN,35,715,64,191,0.335,38,128,0.297,18,22,0.818,23,84,107,34,13,7,17,68,184,197,2.0,0.77,2018,19,5.257142857142857,2.0,127,4,131,0.816793893129771
2018-19,RegularSeason,1627737,359,Marquese Chriss,1610612739,CLE,43,499,67,180,0.372,16,72,0.222,32,45,0.711,40,102,142,22,17,11,36,81,182,212,0.61,0.47,2018,19,4.232558139534884,0.6111111111111112,113,13,126,1.126984126984127
2018-19,RegularSeason,203477,360,Isaiah Canaan,1610612749,MIL,30,628,64,164,0.39,34,96,0.354,19,24,0.792,6,52,58,84,14,2,35,52,181,199,2.4,0.4,2018,19,6.033333333333333,2.4,100,5,105,0.5523809523809524
2018-19,RegularSeason,201563,360,Michael Beasley,1610612747,LAL,26,277,75,153,0.49,3,17,0.176,28,39,0.718,13,47,60,25,9,10,27,42,181,169,0.93,0.33,2018,19,6.961538461538462,0.9259259259259259,78,11,89,0.6741573033707865
2018-19,RegularSeason,1626147,362,Justin Anderson,1610612737,ATL,48,464,64,157,0.408,24,77,0.312,26,35,0.743,24,60,84,23,22,13,23,48,178,195,1.0,0.96,2018,19,3.7083333333333335,1.0,93,9,102,0.8235294117647058
2018-19,RegularSeason,2199,363,Tyson Chandler,1610612747,LAL,55,875,61,99,0.616,0,1,0.0,51,87,0.586,92,215,307,37,21,23,42,110,173,445,0.88,0.5,2018,19,3.1454545454545455,0.8809523809523809,38,36,74,4.148648648648648
2018-19,RegularSeason,1626174,364,Christian Wood,1610612740,NOP,21,250,61,117,0.521,9,26,0.346,41,56,0.732,17,66,83,8,7,10,17,17,172,192,0.47,0.41,2018,19,8.19047619047619,0.47058823529411764,56,15,71,1.1690140845070423
2018-19,RegularSeason,1628975,364,Jevon Carter,1610612763,MEM,39,576,56,185,0.303,34,102,0.333,26,32,0.813,14,52,66,69,26,11,33,55,172,176,2.09,0.79,2018,19,4.410256410256411,2.090909090909091,129,6,135,0.4888888888888889
2018-19,RegularSeason,1629151,366,Ryan Broekhoff,1610612742,DAL,42,454,57,126,0.452,38,93,0.409,15,19,0.789,8,55,63,22,6,4,16,35,167,173,1.38,0.38,2018,19,3.9761904761904763,1.375,69,4,73,0.863013698630137
2018-19,RegularSeason,203518,367,Alex Abrines,1610612760,OKC,31,588,56,157,0.357,41,127,0.323,12,13,0.923,5,43,48,20,17,6,14,53,165,140,1.43,1.21,2018,19,5.32258064516129,1.4285714285714286,101,1,102,0.47058823529411764
2018-19,RegularSeason,203895,368,Jordan McRae,1610612764,WAS,27,333,61,130,0.469,10,35,0.286,28,35,0.8,6,34,40,30,13,7,15,26,160,159,2.0,0.87,2018,19,5.925925925925926,2.0,69,7,76,0.5263157894736842
2018-19,RegularSeason,1627814,369,Damion Lee,1610612744,GSW,32,375,56,127,0.441,27,68,0.397,19,22,0.864,8,56,64,13,13,0,11,28,158,163,1.18,1.18,2018,19,4.9375,1.1818181818181819,71,3,74,0.8648648648648649
2018-19,RegularSeason,1629140,370,Johnathan Williams,1610612747,LAL,24,372,65,110,0.591,0,2,0.0,27,48,0.563,48,51,99,13,8,7,16,62,157,202,0.81,0.5,2018,19,6.541666666666667,0.8125,45,21,66,1.5
2018-19,RegularSeason,2736,370,Luol Deng,1610612750,MIN,22,392,59,118,0.5,14,44,0.318,25,35,0.714,20,53,73,18,15,8,14,24,157,188,1.29,1.07,2018,19,7.136363636363637,1.2857142857142858,59,10,69,1.0579710144927537
2018-19,RegularSeason,202720,372,Jon Leuer,1610612765,DET,41,402,66,113,0.584,1,11,0.091,23,31,0.742,27,70,97,14,12,4,23,60,156,205,0.61,0.52,2018,19,3.8048780487804876,0.6086956521739131,47,8,55,1.7636363636363637
2018-19,RegularSeason,201585,372,Kosta Koufos,1610612758,SAC,42,502,73,153,0.477,0,0,0.0,10,24,0.417,52,125,177,36,15,18,27,68,156,281,1.33,0.56,2018,19,3.7142857142857144,1.3333333333333333,80,14,94,1.8829787234042554
2018-19,RegularSeason,203124,372,Kyle O'Quinn,1610612754,IND,45,371,69,136,0.507,1,12,0.083,17,21,0.81,29,90,119,56,9,25,31,68,156,263,1.81,0.29,2018,19,3.466666666666667,1.8064516129032258,67,4,71,1.676056338028169
2018-19,RegularSeason,1628365,375,Markelle Fultz,1610612753,ORL,19,427,65,155,0.419,4,14,0.286,21,37,0.568,26,44,70,59,17,5,25,52,155,175,2.36,0.68,2018,19,8.157894736842104,2.36,90,16,106,0.660377358490566
2018-19,RegularSeason,201147,376,Corey Brewer,1610612758,SAC,31,492,53,123,0.431,14,44,0.318,31,43,0.721,26,50,76,39,32,7,19,63,151,204,2.05,1.68,2018,19,4.870967741935484,2.0526315789473686,70,12,82,0.926829268292683
2018-19,RegularSeason,1628966,376,Keita Bates-Diop,1610612750,MIN,30,503,60,142,0.423,13,52,0.25,18,28,0.643,16,67,83,17,18,14,14,29,151,177,1.21,1.29,2018,19,5.033333333333333,1.2142857142857142,82,10,92,0.9021739130434783
2018-19,RegularSeason,2403,376,Nene,1610612745,HOU,42,546,60,116,0.517,0,3,0.0,31,47,0.66,34,89,123,26,18,15,11,87,151,250,2.36,1.64,2018,19,3.5952380952380953,2.3636363636363638,56,16,72,1.7083333333333333
2018-19,RegularSeason,1629109,379,Gary Clark,1610612745,HOU,51,641,50,151,0.331,41,138,0.297,7,7,1.0,24,92,116,18,20,26,7,47,148,220,2.57,2.86,2018,19,2.9019607843137254,2.5714285714285716,101,0,101,1.1485148514851484
2018-19,RegularSeason,101109,380,Raymond Felton,1610612760,OKC,33,379,55,135,0.407,20,61,0.328,12,13,0.923,4,30,34,52,10,6,14,29,142,149,3.71,0.71,2018,19,4.303030303030303,3.7142857142857144,80,1,81,0.41975308641975306
2018-19,RegularSeason,1626257,381,Salah Mejri,1610612742,DAL,36,399,55,112,0.491,11,34,0.324,20,32,0.625,36,95,131,35,10,26,21,55,141,253,1.67,0.48,2018,19,3.9166666666666665,1.6666666666666667,57,12,69,1.8985507246376812
2018-19,RegularSeason,202954,382,Brad Wanamaker,1610612738,BOS,36,343,50,105,0.476,16,39,0.41,24,28,0.857,3,38,41,56,12,2,19,34,140,173,2.95,0.63,2018,19,3.888888888888889,2.9473684210526314,55,4,59,0.6949152542372882
2018-19,RegularSeason,101133,383,Ian Mahinmi,1610612764,WAS,34,498,47,104,0.452,3,16,0.188,42,61,0.689,48,80,128,25,25,16,21,84,139,236,1.19,1.19,2018,19,4.088235294117647,1.1904761904761905,57,19,76,1.6842105263157894
2018-19,RegularSeason,201584,384,Courtney Lee,1610612742,DAL,34,428,53,129,0.411,16,55,0.291,14,21,0.667,9,45,54,37,21,3,14,32,136,154,2.64,1.5,2018,19,4.0,2.642857142857143,76,7,83,0.6506024096385542
2018-19,RegularSeason,1628515,384,Isaiah Briscoe,1610612753,ORL,39,559,55,138,0.399,11,34,0.324,15,26,0.577,5,69,74,87,11,2,31,66,136,185,2.81,0.35,2018,19,3.4871794871794872,2.806451612903226,83,11,94,0.7872340425531915
2018-19,RegularSeason,1628415,386,Dillon Brooks,1610612763,MEM,18,330,49,122,0.402,15,40,0.375,22,30,0.733,9,22,31,16,10,4,19,50,135,96,0.84,0.53,2018,19,7.5,0.8421052631578947,73,8,81,0.38271604938271603
2018-19,RegularSeason,2546,387,Carmelo Anthony,1610612745,HOU,10,294,49,121,0.405,21,64,0.328,15,22,0.682,9,45,54,5,4,7,8,32,134,117,0.63,0.5,2018,19,13.4,0.625,72,7,79,0.6835443037974683
2018-19,RegularSeason,203487,387,Michael Carter-Williams,1610612753,ORL,28,372,46,123,0.374,10,38,0.263,32,53,0.604,19,51,70,70,20,15,20,48,134,191,3.5,1.0,2018,19,4.785714285714286,3.5,77,21,98,0.7142857142857143
2018-19,RegularSeason,1629004,389,Svi Mykhailiuk,1610612765,DET,42,440,46,140,0.329,29,89,0.326,12,20,0.6,9,27,36,37,14,1,21,25,133,98,1.76,0.67,2018,19,3.1666666666666665,1.7619047619047619,94,8,102,0.35294117647058826
2018-19,RegularSeason,1628978,390,Donte DiVincenzo,1610612749,MIL,27,411,50,124,0.403,22,83,0.265,9,12,0.75,16,49,65,31,13,6,19,38,131,150,1.63,0.68,2018,19,4.851851851851852,1.631578947368421,74,3,77,0.8441558441558441
2018-19,RegularSeason,1627745,391,Damian Jones,1610612744,GSW,24,410,53,74,0.716,0,0,0.0,24,37,0.649,31,44,75,28,12,25,16,63,130,220,1.75,0.75,2018,19,5.416666666666667,1.75,21,13,34,2.2058823529411766
2018-19,RegularSeason,101112,392,Channing Frye,1610612739,CLE,36,341,43,117,0.368,32,79,0.405,11,14,0.786,4,48,52,20,6,5,13,44,129,122,1.54,0.46,2018,19,3.5833333333333335,1.5384615384615385,74,3,77,0.6753246753246753
2018-19,RegularSeason,202325,393,Wesley Johnson,1610612764,WAS,38,534,45,128,0.352,25,76,0.329,13,19,0.684,12,60,72,23,14,12,18,63,128,142,1.28,0.78,2018,19,3.3684210526315788,1.2777777777777777,83,6,89,0.8089887640449438
2018-19,RegularSeason,203098,394,John Jenkins,1610612752,NYK,26,333,42,105,0.4,22,58,0.379,15,18,0.833,6,31,37,22,0,2,9,10,121,107,2.44,0.0,2018,19,4.653846153846154,2.4444444444444446,63,3,66,0.5606060606060606
2018-19,RegularSeason,202327,395,Ekpe Udoh,1610612762,UTA,51,320,50,72,0.694,0,0,0.0,19,30,0.633,27,63,90,28,10,31,13,36,119,232,2.15,0.77,2018,19,2.3333333333333335,2.1538461538461537,22,11,33,2.727272727272727
2018-19,RegularSeason,2200,396,Pau Gasol,1610612749,MIL,30,361,42,94,0.447,6,13,0.462,28,40,0.7,22,115,137,52,5,15,16,29,118,247,3.25,0.31,2018,19,3.933333333333333,3.25,52,12,64,2.140625
2018-19,RegularSeason,2730,397,Dwight Howard,1610612764,WAS,9,230,43,69,0.623,0,0,0.0,29,48,0.604,24,59,83,4,7,4,16,34,115,152,0.25,0.44,2018,19,12.777777777777779,0.25,26,19,45,1.8444444444444446
2018-19,RegularSeason,1626185,397,Jarell Martin,1610612753,ORL,42,328,43,104,0.413,20,57,0.351,9,11,0.818,11,62,73,18,3,8,11,51,115,143,1.64,0.27,2018,19,2.738095238095238,1.6363636363636365,61,2,63,1.1587301587301588
2018-19,RegularSeason,1627740,399,Henry Ellenson,1610612752,NYK,19,259,39,95,0.411,17,38,0.447,19,25,0.76,5,61,66,16,7,2,9,27,114,134,1.78,0.78,2018,19,6.0,1.7777777777777777,56,6,62,1.064516129032258
2018-19,RegularSeason,1628417,399,Jaron Blossomgame,1610612739,CLE,27,439,47,106,0.443,10,39,0.256,10,13,0.769,26,72,98,13,7,8,11,20,114,167,1.18,0.64,2018,19,4.222222222222222,1.1818181818181819,59,3,62,1.5806451612903225
2018-19,RegularSeason,101181,401,Jose Calderon,1610612765,DET,49,632,45,120,0.375,14,57,0.246,9,11,0.818,11,49,60,115,16,3,35,64,113,195,3.29,0.46,2018,19,2.306122448979592,3.2857142857142856,75,2,77,0.7792207792207793
2018-19,RegularSeason,1629010,402,Jerome Robinson,1610612746,LAC,33,321,44,110,0.4,18,57,0.316,6,9,0.667,3,38,41,19,11,3,13,46,112,104,1.46,0.85,2018,19,3.393939393939394,1.4615384615384615,66,3,69,0.5942028985507246
2018-19,RegularSeason,1627786,403,Troy Williams,1610612758,SAC,21,312,44,98,0.449,14,44,0.318,9,15,0.6,12,47,59,11,10,8,9,37,111,130,1.22,1.11,2018,19,5.285714285714286,1.2222222222222223,54,6,60,0.9833333333333333
2018-19,RegularSeason,1629121,404,Jaylen Adams,1610612737,ATL,34,428,38,110,0.345,25,74,0.338,7,9,0.778,11,49,60,65,14,5,28,45,108,150,2.32,0.5,2018,19,3.176470588235294,2.3214285714285716,72,2,74,0.8108108108108109
2018-19,RegularSeason,1627816,405,Alex Poythress,1610612737,ATL,21,305,40,81,0.494,9,23,0.391,18,29,0.621,29,47,76,17,4,10,13,47,107,149,1.31,0.31,2018,19,5.095238095238095,1.3076923076923077,41,11,52,1.4615384615384615
2018-19,RegularSeason,1628405,406,Johnathan Motley,1610612746,LAC,22,156,39,73,0.534,0,3,0.0,24,40,0.6,18,33,51,11,5,3,16,27,102,106,0.69,0.31,2018,19,4.636363636363637,0.6875,34,16,50,1.02
2018-19,RegularSeason,202347,407,Quincy Pondexter,1610612759,SAS,53,292,29,58,0.5,6,18,0.333,34,42,0.81,8,38,46,24,11,1,13,24,98,130,1.85,0.85,2018,19,1.849056603773585,1.8461538461538463,29,8,37,1.2432432432432432
2018-19,RegularSeason,202738,408,Isaiah Thomas,1610612743,DEN,12,181,34,99,0.343,12,43,0.279,17,27,0.63,5,8,13,23,5,1,18,17,97,46,1.28,0.28,2018,19,8.083333333333334,1.2777777777777777,65,10,75,0.17333333333333334
2018-19,RegularSeason,1629244,409,Cam Reynolds,1610612750,MIN,19,259,33,78,0.423,21,51,0.412,8,9,0.889,4,27,31,13,6,2,5,26,95,96,2.6,1.2,2018,19,5.0,2.6,45,1,46,0.6739130434782609
2018-19,RegularSeason,1627824,410,Guerschon Yabusele,1610612738,BOS,41,251,35,77,0.455,9,28,0.321,15,22,0.682,23,30,53,15,8,7,15,32,94,113,1.0,0.53,2018,19,2.292682926829268,1.0,42,7,49,1.0816326530612246
2018-19,RegularSeason,1628449,411,Chris Boucher,1610612761,TOR,28,163,34,76,0.447,12,37,0.324,13,15,0.867,16,40,56,2,6,24,7,31,93,130,0.29,0.86,2018,19,3.3214285714285716,0.2857142857142857,42,2,44,1.2727272727272727
2018-19,RegularSeason,1629003,412,Shake Milton,1610612755,PHI,20,268,34,87,0.391,14,44,0.318,5,7,0.714,9,26,35,18,8,8,6,29,87,95,3.0,1.33,2018,19,4.35,3.0,53,2,55,0.6363636363636364
2018-19,RegularSeason,1627215,413,Walt Lemon Jr.,1610612741,CHI,6,167,38,87,0.437,2,5,0.4,8,11,0.727,4,23,27,30,11,1,10,14,86,93,3.0,1.1,2018,19,14.333333333333334,3.0,49,3,52,0.5192307692307693
2018-19,RegularSeason,1629126,414,Deonte Burton,1610612760,OKC,32,240,33,82,0.402,8,27,0.296,8,12,0.667,4,24,28,9,6,8,9,31,82,71,1.0,0.67,2018,19,2.5625,1.0,49,4,53,0.5283018867924528
2018-19,RegularSeason,1627883,415,Jalen Jones,1610612739,CLE,16,214,26,62,0.419,10,28,0.357,19,27,0.704,11,23,34,7,9,2,8,27,81,81,0.88,1.13,2018,19,5.0625,0.875,36,8,44,0.7727272727272727
2018-19,RegularSeason,1629057,415,Robert Williams III,1610612738,BOS,32,283,36,51,0.706,0,0,0.0,9,15,0.6,27,54,81,7,9,40,10,36,81,187,0.7,0.9,2018,19,2.53125,0.7,15,6,21,3.857142857142857
2018-19,RegularSeason,1629033,415,Theo Pinson,1610612751,BKN,18,211,25,73,0.342,12,46,0.261,19,22,0.864,4,32,36,21,6,0,18,15,81,75,1.17,0.33,2018,19,4.5,1.1666666666666667,48,3,51,0.7058823529411765
2018-19,RegularSeason,203960,418,JaKarr Sampson,1610612741,CHI,4,127,29,54,0.537,5,14,0.357,17,21,0.81,5,27,32,4,4,3,4,8,80,90,1.0,1.0,2018,19,20.0,1.0,25,4,29,1.103448275862069
2018-19,RegularSeason,203101,418,Miles Plumlee,1610612737,ATL,18,173,32,48,0.667,0,0,0.0,16,30,0.533,16,23,39,17,6,4,10,14,80,106,1.7,0.6,2018,19,4.444444444444445,1.7,16,14,30,1.3
2018-19,RegularSeason,203089,420,John Henson,1610612739,CLE,14,188,31,67,0.463,11,31,0.355,6,10,0.6,16,55,71,14,7,11,12,16,79,130,1.17,0.58,2018,19,5.642857142857143,1.1666666666666667,36,4,40,1.775
2018-19,RegularSeason,1629014,421,Anfernee Simons,1610612757,POR,20,141,28,63,0.444,10,29,0.345,9,16,0.563,3,10,13,13,1,0,11,9,75,49,1.18,0.09,2018,19,3.75,1.1818181818181819,35,7,42,0.30952380952380953
2018-19,RegularSeason,203463,421,Ben McLemore,1610612758,SAC,19,158,25,64,0.391,17,41,0.415,8,12,0.667,3,14,17,4,6,3,5,22,75,57,0.8,1.2,2018,19,3.9473684210526314,0.8,39,4,43,0.3953488372093023
2018-19,RegularSeason,2747,423,JR Smith,1610612739,CLE,11,222,27,79,0.342,12,39,0.308,8,10,0.8,0,18,18,21,11,3,11,19,74,62,1.91,1.0,2018,19,6.7272727272727275,1.9090909090909092,52,2,54,0.3333333333333333
2018-19,RegularSeason,1627775,423,Patrick McCaw,1610612761,TOR,29,397,26,63,0.413,9,28,0.321,13,15,0.867,7,41,48,29,23,2,17,38,74,120,1.71,1.35,2018,19,2.5517241379310347,1.7058823529411764,37,2,39,1.2307692307692308
2018-19,RegularSeason,1629102,425,Brandon Sampson,1610612741,CHI,14,214,28,60,0.467,11,29,0.379,4,6,0.667,3,13,16,10,8,3,12,19,71,62,0.83,0.67,2018,19,5.071428571428571,0.8333333333333334,32,2,34,0.47058823529411764
2018-19,RegularSeason,1627746,426,Skal Labissiere,1610612757,POR,22,176,26,49,0.531,6,13,0.462,9,17,0.529,9,34,43,11,5,6,11,29,67,90,1.0,0.46,2018,19,3.0454545454545454,1.0,23,8,31,1.3870967741935485
2018-19,RegularSeason,1628410,427,Edmond Sumner,1610612754,IND,23,210,22,64,0.344,7,27,0.259,15,24,0.625,9,15,24,10,12,5,10,26,66,56,1.0,1.2,2018,19,2.869565217391304,1.0,42,9,51,0.47058823529411764
2018-19,RegularSeason,201160,428,Jason Smith,1610612740,NOP,20,191,21,59,0.356,9,26,0.346,14,16,0.875,16,36,52,14,3,7,13,30,65,88,1.08,0.23,2018,19,3.25,1.0769230769230769,38,2,40,1.3
2018-19,RegularSeason,201583,429,Ryan Anderson,1610612748,MIA,25,321,21,69,0.304,9,40,0.225,12,16,0.75,18,36,54,19,4,1,14,25,63,75,1.36,0.29,2018,19,2.52,1.3571428571428572,48,4,52,1.0384615384615385
2018-19,RegularSeason,1628414,430,Sindarius Thornwell,1610612746,LAC,64,313,17,49,0.347,3,15,0.2,25,34,0.735,5,39,44,18,14,7,20,41,62,84,0.9,0.7,2018,19,0.96875,0.9,32,9,41,1.0731707317073171
2018-19,RegularSeason,1629017,431,Khyri Thomas,1610612765,DET,26,195,22,69,0.319,10,35,0.286,7,11,0.636,4,16,20,8,7,5,4,22,61,46,2.0,1.75,2018,19,2.3461538461538463,2.0,47,4,51,0.39215686274509803
2018-19,RegularSeason,1627772,432,Daniel Hamilton,1610612737,ATL,19,204,23,60,0.383,8,23,0.348,3,6,0.5,10,37,47,22,6,1,16,19,57,77,1.38,0.38,2018,19,3.0,1.375,37,3,40,1.175
2018-19,RegularSeason,203485,433,Lorenzo Brown,1610612761,TOR,26,212,23,71,0.324,6,28,0.214,3,3,1.0,5,26,31,28,12,5,16,22,55,67,1.75,0.75,2018,19,2.1153846153846154,1.75,48,0,48,0.6458333333333334
2018-19,RegularSeason,1626150,434,Andrew Harrison,1610612740,NOP,17,186,16,53,0.302,5,25,0.2,17,18,0.944,6,14,20,24,4,2,12,34,54,54,2.0,0.33,2018,19,3.176470588235294,2.0,37,1,38,0.5263157894736842
2018-19,RegularSeason,1629034,434,Ray Spalding,1610612756,PHX,14,148,25,47,0.532,0,3,0.0,4,12,0.333,15,33,48,5,9,8,9,23,54,85,0.56,1.0,2018,19,3.857142857142857,0.5555555555555556,22,8,30,1.6
2018-19,RegularSeason,1628392,436,Isaiah Hartenstein,1610612745,HOU,28,221,20,41,0.488,2,6,0.333,11,14,0.786,21,26,47,15,7,12,13,56,53,97,1.15,0.54,2018,19,1.8928571428571428,1.1538461538461537,21,3,24,1.9583333333333333
2018-19,RegularSeason,1629002,437,Chimezie Metu,1610612759,SAS,29,145,19,58,0.328,0,2,0.0,13,17,0.765,9,27,36,13,6,2,15,14,51,50,0.87,0.4,2018,19,1.7586206896551724,0.8666666666666667,39,4,43,0.8372093023255814
2018-19,RegularSeason,201975,437,Jodie Meeks,1610612761,TOR,8,104,21,39,0.538,8,18,0.444,1,1,1.0,1,11,12,8,1,1,2,5,51,53,4.0,0.5,2018,19,6.375,4.0,18,0,18,0.6666666666666666
2018-19,RegularSeason,1629130,439,Duncan Robinson,1610612748,MIA,15,161,18,46,0.391,10,35,0.286,4,6,0.667,2,17,19,5,5,0,4,11,50,45,1.25,1.25,2018,19,3.3333333333333335,1.25,28,2,30,0.6333333333333333
2018-19,RegularSeason,1628462,440,Milos Teodosic,1610612746,LAC,15,150,17,40,0.425,10,27,0.37,4,7,0.571,3,13,16,32,3,1,21,27,48,53,1.52,0.14,2018,19,3.2,1.5238095238095237,23,3,26,0.6153846153846154
2018-19,RegularSeason,1628421,441,Devin Robinson,1610612764,WAS,7,95,19,32,0.594,0,2,0.0,9,14,0.643,6,14,20,6,4,6,2,11,47,63,3.0,2.0,2018,19,6.714285714285714,3.0,13,5,18,1.1111111111111112
2018-19,RegularSeason,1629094,442,Marcus Derrickson,1610612744,GSW,11,67,16,33,0.485,10,20,0.5,4,5,0.8,8,5,13,1,0,1,3,9,46,40,0.33,0.0,2018,19,4.181818181818182,0.3333333333333333,17,1,18,0.7222222222222222
2018-19,RegularSeason,203092,442,Tyler Zeller,1610612763,MEM,6,93,16,30,0.533,0,1,0.0,14,18,0.778,11,13,24,4,1,3,4,20,46,56,1.0,0.25,2018,19,7.666666666666667,1.0,14,4,18,1.3333333333333333
2018-19,RegularSeason,1629022,444,Lonnie Walker IV,1610612759,SAS,17,118,16,46,0.348,5,13,0.385,8,10,0.8,0,17,17,9,7,3,4,7,45,45,2.25,1.75,2018,19,2.6470588235294117,2.25,30,2,32,0.53125
2018-19,RegularSeason,1628403,445,Caleb Swanigan,1610612758,SAC,21,178,18,53,0.34,1,7,0.143,6,9,0.667,17,47,64,11,6,1,18,28,43,69,0.61,0.33,2018,19,2.0476190476190474,0.6111111111111112,35,3,38,1.6842105263157894
2018-19,RegularSeason,1629234,446,Drew Eubanks,1610612759,SAS,23,113,15,26,0.577,0,0,0.0,11,13,0.846,6,28,34,7,2,5,8,11,41,68,0.88,0.25,2018,19,1.7826086956521738,0.875,11,2,13,2.6153846153846154
2018-19,RegularSeason,1629018,447,Gary Trent Jr.,1610612757,POR,15,111,16,50,0.32,5,21,0.238,3,7,0.429,1,10,11,5,1,2,4,4,40,17,1.25,0.25,2018,19,2.6666666666666665,1.25,34,4,38,0.2894736842105263
2018-19,RegularSeason,1628980,447,Jacob Evans,1610612744,GSW,30,204,18,53,0.34,4,15,0.267,0,1,0.0,6,19,25,23,5,3,11,28,40,49,2.09,0.46,2018,19,1.3333333333333333,2.090909090909091,35,1,36,0.6944444444444444
2018-19,RegularSeason,1627395,447,Julian Washburn,1610612763,MEM,18,254,16,48,0.333,5,24,0.208,3,4,0.75,8,33,41,14,13,2,7,16,40,70,2.0,1.86,2018,19,2.2222222222222223,2.0,32,1,33,1.2424242424242424
2018-19,RegularSeason,1629015,447,Zhaire Smith,1610612755,PHI,6,111,14,34,0.412,6,16,0.375,6,8,0.75,3,10,13,10,2,2,6,8,40,39,1.67,0.33,2018,19,6.666666666666667,1.6666666666666667,20,2,22,0.5909090909090909
2018-19,RegularSeason,101106,451,Andrew Bogut,1610612744,GSW,11,134,18,36,0.5,0,0,0.0,3,3,1.0,12,43,55,11,3,8,8,22,39,90,1.38,0.38,2018,19,3.5454545454545454,1.375,18,0,18,3.0555555555555554
2018-19,RegularSeason,1629045,451,Bonzie Colson,1610612749,MIL,8,98,13,39,0.333,5,21,0.238,8,9,0.889,8,22,30,3,5,1,3,3,39,48,1.0,1.67,2018,19,4.875,1.0,26,1,27,1.1111111111111112
2018-19,RegularSeason,203710,451,C.J. Williams,1610612750,MIN,15,128,17,35,0.486,5,16,0.313,0,1,0.0,1,7,8,12,6,0,5,16,39,41,2.4,1.2,2018,19,2.6,2.4,18,1,19,0.42105263157894735
2018-19,RegularSeason,1629139,451,Yuta Watanabe,1610612763,MEM,15,174,15,51,0.294,2,16,0.125,7,10,0.7,4,27,31,8,4,1,6,11,39,38,1.33,0.67,2018,19,2.6,1.3333333333333333,36,3,39,0.7948717948717948
2018-19,RegularSeason,1628959,455,Rawle Alkins,1610612741,CHI,10,120,13,39,0.333,3,12,0.25,8,12,0.667,11,15,26,13,1,0,8,7,37,39,1.63,0.13,2018,19,3.7,1.625,26,4,30,0.8666666666666667
2018-19,RegularSeason,1627738,456,Deyonta Davis,1610612737,ATL,9,118,15,22,0.682,0,1,0.0,6,10,0.6,10,26,36,5,3,5,3,12,36,71,1.67,1.0,2018,19,4.0,1.6666666666666667,7,4,11,3.272727272727273
2018-19,RegularSeason,203263,456,James Nunnally,1610612745,HOU,15,101,12,34,0.353,8,25,0.32,4,4,1.0,0,5,5,7,1,0,1,10,36,26,7.0,1.0,2018,19,2.4,7.0,22,0,22,0.22727272727272727
2018-19,RegularSeason,1626259,458,Malcolm Miller,1610612761,TOR,10,67,11,26,0.423,10,21,0.476,3,4,0.75,1,4,5,1,1,1,1,5,35,26,1.0,1.0,2018,19,3.5,1.0,15,1,16,0.3125
2018-19,RegularSeason,1629541,459,Dairis Bertans,1610612740,NOP,12,167,12,47,0.255,10,34,0.294,0,0,0.0,2,7,9,10,1,0,2,7,34,17,5.0,0.5,2018,19,2.8333333333333335,5.0,35,0,35,0.2571428571428571
2018-19,RegularSeason,1629061,460,Deng Adel,1610612739,CLE,19,194,11,36,0.306,6,23,0.261,4,4,1.0,3,16,19,5,1,4,6,13,32,30,0.83,0.17,2018,19,1.6842105263157894,0.8333333333333334,25,0,25,0.76
2018-19,RegularSeason,1629123,461,Jared Terrell,1610612750,MIN,14,111,12,39,0.308,4,17,0.235,3,6,0.5,1,5,6,12,3,2,10,16,31,14,1.2,0.3,2018,19,2.2142857142857144,1.2,27,3,30,0.2
2018-19,RegularSeason,1627781,462,Malachi Richardson,1610612761,TOR,22,103,9,29,0.31,8,25,0.32,4,5,0.8,2,11,13,0,1,0,8,13,30,15,0.0,0.13,2018,19,1.3636363636363635,0.0,20,1,21,0.6190476190476191
2018-19,RegularSeason,1627735,462,Wade Baldwin IV,1610612757,POR,16,94,10,33,0.303,2,9,0.222,8,11,0.727,2,13,15,12,1,2,14,11,30,20,0.86,0.07,2018,19,1.875,0.8571428571428571,23,3,26,0.5769230769230769
2018-19,RegularSeason,1629133,464,Daryl Macon,1610612742,DAL,8,90,10,27,0.37,5,11,0.455,4,7,0.571,2,10,12,7,1,0,6,8,29,23,1.17,0.17,2018,19,3.625,1.1666666666666667,17,3,20,0.6
2018-19,RegularSeason,1628070,464,Jordan Loyd,1610612761,TOR,12,55,8,18,0.444,4,8,0.5,9,11,0.818,1,8,9,6,0,0,2,5,29,30,3.0,0.0,2018,19,2.4166666666666665,3.0,10,2,12,0.75
2018-19,RegularSeason,1628518,466,Amile Jefferson,1610612753,ORL,12,68,10,16,0.625,0,0,0.0,7,8,0.875,6,15,21,3,3,3,1,8,27,49,3.0,3.0,2018,19,2.25,3.0,6,1,7,3.0
2018-19,RegularSeason,1629203,466,Jemerrio Jones,1610612747,LAL,6,143,12,33,0.364,2,10,0.2,1,2,0.5,16,33,49,13,7,5,5,10,27,74,2.6,1.4,2018,19,4.5,2.6,21,1,22,2.227272727272727
2018-19,RegularSeason,1628656,468,Billy Garrett,1610612752,NYK,4,63,11,27,0.407,0,8,0.0,4,4,1.0,0,3,3,7,1,1,2,3,26,20,3.5,0.5,2018,19,6.5,3.5,16,0,16,0.1875
2018-19,RegularSeason,2617,469,Udonis Haslem,1610612748,MIA,10,75,11,33,0.333,0,12,0.0,3,4,0.75,3,24,27,2,0,0,3,9,25,28,0.67,0.0,2018,19,2.5,0.6666666666666666,22,1,23,1.173913043478261
2018-19,RegularSeason,1629020,470,Jarred Vanderbilt,1610612743,DEN,17,69,9,19,0.474,0,1,0.0,6,10,0.6,7,16,23,3,6,1,8,8,24,35,0.38,0.75,2018,19,1.411764705882353,0.375,10,4,14,1.6428571428571428
2018-19,RegularSeason,1629168,471,BJ Johnson,1610612758,SAC,7,49,9,18,0.5,3,7,0.429,2,2,1.0,2,6,8,0,2,0,2,4,23,22,0.0,1.0,2018,19,3.2857142857142856,0.0,9,0,9,0.8888888888888888
2018-19,RegularSeason,1629164,471,Brandon Goodwin,1610612743,DEN,16,57,6,23,0.261,2,6,0.333,9,11,0.818,1,2,3,14,0,0,3,7,23,18,4.67,0.0,2018,19,1.4375,4.666666666666667,17,2,19,0.15789473684210525
2018-19,RegularSeason,1628399,471,Tyler Lydon,1610612743,DEN,25,94,9,18,0.5,4,10,0.4,1,3,0.333,7,11,18,6,2,0,4,10,23,34,1.5,0.5,2018,19,0.92,1.5,9,2,11,1.6363636363636365
2018-19,RegularSeason,1627743,474,Demetrius Jackson,1610612755,PHI,6,39,8,15,0.533,2,6,0.333,4,4,1.0,2,1,3,5,2,0,1,4,22,24,5.0,2.0,2018,19,3.6666666666666665,5.0,7,0,7,0.42857142857142855
2018-19,RegularSeason,202690,474,Jimmer Fredette,1610612756,PHX,6,65,8,29,0.276,0,13,0.0,6,6,1.0,1,6,7,8,3,0,5,5,22,14,1.6,0.6,2018,19,3.6666666666666665,1.6,21,0,21,0.3333333333333333
2018-19,RegularSeason,1628249,476,Mitchell Creek,1610612750,MIN,5,47,8,16,0.5,0,2,0.0,5,7,0.714,6,6,12,6,2,0,1,3,21,30,6.0,2.0,2018,19,4.2,6.0,8,2,10,1.2
2018-19,RegularSeason,201601,477,Luc Mbah a Moute,1610612746,LAC,4,61,8,18,0.444,2,6,0.333,2,5,0.4,2,5,7,2,1,1,2,8,20,16,1.0,0.5,2018,19,5.0,1.0,10,3,13,0.5384615384615384
2018-19,RegularSeason,1629058,478,Dzanan Musa,1610612751,BKN,9,39,9,22,0.409,1,10,0.1,0,2,0.0,1,4,5,2,2,0,4,1,19,9,0.5,0.5,2018,19,2.111111111111111,0.5,13,2,15,0.3333333333333333
2018-19,RegularSeason,1629067,478,Isaac Bonga,1610612747,LAL,22,120,5,33,0.152,0,8,0.0,9,15,0.6,9,16,25,15,9,4,6,9,19,32,2.5,1.5,2018,19,0.8636363636363636,2.5,28,6,34,0.7352941176470589
2018-19,RegularSeason,1628408,478,PJ Dozier,1610612738,BOS,6,51,8,21,0.381,2,8,0.25,1,2,0.5,6,11,17,5,2,0,0,2,19,29,0.0,0.0,2018,19,3.1666666666666665,inf,13,1,14,1.2142857142857142
2018-19,RegularSeason,1626210,481,Alan Williams,1610612751,BKN,5,26,8,13,0.615,0,1,0.0,2,4,0.5,4,15,19,3,1,0,1,2,18,33,3.0,1.0,2018,19,3.6,3.0,5,2,7,2.7142857142857144
2018-19,RegularSeason,1629118,481,Thomas Welsh,1610612743,DEN,11,36,7,13,0.538,3,7,0.429,1,2,0.5,0,4,4,5,0,0,1,3,18,19,5.0,0.0,2018,19,1.6363636363636365,5.0,6,1,7,0.5714285714285714
2018-19,RegularSeason,203112,483,Quincy Acy,1610612756,PHX,10,123,4,18,0.222,2,15,0.133,7,10,0.7,3,22,25,8,1,4,4,24,17,34,2.0,0.25,2018,19,1.7,2.0,14,3,17,1.4705882352941178
2018-19,RegularSeason,1626154,483,RJ Hunter,1610612738,BOS,1,26,6,13,0.462,4,10,0.4,1,2,0.5,1,2,3,3,1,0,0,3,17,16,0.0,0.0,2018,19,17.0,inf,7,1,8,0.375
2018-19,RegularSeason,1628396,483,Tony Bradley,1610612762,UTA,3,36,8,16,0.5,0,0,0.0,1,2,0.5,9,6,15,1,2,2,3,6,17,25,0.33,0.67,2018,19,5.666666666666667,0.3333333333333333,8,1,9,1.6666666666666667
2018-19,RegularSeason,1628513,486,Naz Mitrou-Long,1610612762,UTA,14,84,6,20,0.3,2,11,0.182,2,2,1.0,1,5,6,15,1,1,8,10,16,17,1.88,0.13,2018,19,1.1428571428571428,1.875,14,0,14,0.42857142857142855
2018-19,RegularSeason,1629353,487,Isaac Humphries,1610612737,ATL,5,56,6,21,0.286,3,11,0.273,0,0,0.0,4,7,11,0,1,0,0,7,15,12,0.0,0.0,2018,19,3.0,,15,0,15,0.7333333333333333
2018-19,RegularSeason,1628982,487,Melvin Frazier Jr.,1610612753,ORL,10,44,7,21,0.333,0,6,0.0,1,4,0.25,3,2,5,1,1,0,1,6,15,4,1.0,1.0,2018,19,1.5,1.0,14,3,17,0.29411764705882354
2018-19,RegularSeason,1627758,489,Ron Baker,1610612764,WAS,15,152,4,20,0.2,1,13,0.077,5,6,0.833,1,10,11,15,6,1,5,18,14,25,3.0,1.2,2018,19,0.9333333333333333,3.0,16,1,17,0.6470588235294118
2018-19,RegularSeason,1628993,490,Alize Johnson,1610612754,IND,14,64,4,16,0.25,1,2,0.5,4,8,0.5,4,15,19,1,1,3,0,7,13,21,0.0,0.0,2018,19,0.9285714285714286,inf,12,4,16,1.1875
2018-19,RegularSeason,1628432,491,Davon Reed,1610612754,IND,10,47,5,12,0.417,2,4,0.5,0,0,0.0,2,4,6,3,1,0,1,3,12,14,3.0,1.0,2018,19,1.2,3.0,7,0,7,0.8571428571428571
2018-19,RegularSeason,1628439,491,Isaiah Hicks,1610612752,NYK,3,32,4,8,0.5,0,0,0.0,4,5,0.8,2,5,7,2,1,3,1,5,12,19,2.0,1.0,2018,19,4.0,2.0,4,1,5,1.4
2018-19,RegularSeason,1627780,493,Gary Payton II,1610612764,WAS,3,16,5,8,0.625,1,2,0.5,0,0,0.0,1,1,2,4,3,1,1,2,11,17,4.0,3.0,2018,19,3.6666666666666665,4.0,3,0,3,0.6666666666666666
2018-19,RegularSeason,1629150,494,Emanuel Terry,1610612748,MIA,3,23,4,7,0.571,0,0,0.0,2,4,0.5,3,4,7,2,3,0,2,4,10,15,1.0,1.5,2018,19,3.3333333333333335,1.0,3,2,5,1.4
2018-19,RegularSeason,1628537,494,Jaylen Morris,1610612749,MIL,4,29,4,10,0.4,1,3,0.333,1,2,0.5,0,5,5,4,2,0,1,1,10,13,4.0,2.0,2018,19,2.5,4.0,6,1,7,0.7142857142857143
2018-19,RegularSeason,203159,494,Scott Machado,1610612747,LAL,4,19,4,6,0.667,1,1,1.0,1,1,1.0,0,0,0,3,1,0,0,2,10,12,0.0,0.0,2018,19,2.5,inf,2,0,2,0.0
2018-19,RegularSeason,1628505,494,Troy Caupain,1610612753,ORL,4,16,4,8,0.5,2,3,0.667,0,0,0.0,1,2,3,4,1,0,0,0,10,14,0.0,0.0,2018,19,2.5,inf,4,0,4,0.75
2018-19,RegularSeason,1629312,498,Haywood Highsmith,1610612755,PHI,5,40,4,10,0.4,1,5,0.2,0,2,0.0,0,5,5,2,1,0,1,1,9,8,2.0,1.0,2018,19,1.8,2.0,6,2,8,0.625
2018-19,RegularSeason,201156,498,Nick Young,1610612743,DEN,4,37,3,9,0.333,3,8,0.375,0,0,0.0,0,1,1,2,0,1,2,4,9,5,1.0,0.0,2018,19,2.25,1.0,6,0,6,0.16666666666666666
2018-19,RegularSeason,1628463,498,Tyler Cavanaugh,1610612762,UTA,11,40,3,10,0.3,1,5,0.2,2,2,1.0,3,5,8,1,0,0,1,3,9,10,1.0,0.0,2018,19,0.8181818181818182,1.0,7,0,7,1.1428571428571428
2018-19,RegularSeason,1628605,501,Dusty Hannahs,1610612763,MEM,2,26,3,12,0.25,0,5,0.0,2,2,1.0,0,1,1,5,1,0,1,1,8,5,5.0,1.0,2018,19,4.0,5.0,9,0,9,0.1111111111111111
2018-19,RegularSeason,1629152,502,DeVaughn Akoon-Purcell,1610612743,DEN,7,22,3,10,0.3,0,4,0.0,1,2,0.5,1,3,4,6,2,0,2,4,7,9,3.0,1.0,2018,19,1.0,3.0,7,1,8,0.5
2018-19,RegularSeason,203961,502,Eric Moreland,1610612761,TOR,5,43,3,7,0.429,1,1,1.0,0,0,0.0,4,16,20,4,1,1,5,9,7,24,0.8,0.2,2018,19,1.4,0.8,4,0,4,5.0
2018-19,RegularSeason,1629185,504,Chris Chiozza,1610612745,HOU,7,33,2,8,0.25,2,5,0.4,0,0,0.0,1,3,4,4,1,1,1,2,6,9,4.0,1.0,2018,19,0.8571428571428571,4.0,6,0,6,0.6666666666666666
2018-19,RegularSeason,202700,504,Donatas Motiejunas,1610612759,SAS,3,13,3,6,0.5,0,0,0.0,0,2,0.0,2,1,3,1,0,1,3,6,6,3,0.33,0.0,2018,19,2.0,0.3333333333333333,3,2,5,0.6
2018-19,RegularSeason,1629122,504,J.P. Macura,1610612766,CHA,2,17,3,9,0.333,0,4,0.0,0,0,0.0,0,3,3,2,0,0,0,0,6,5,0.0,0.0,2018,19,3.0,inf,6,0,6,0.5
2018-19,RegularSeason,1628393,504,Jawun Evans,1610612760,OKC,8,64,3,14,0.214,0,3,0.0,0,0,0.0,1,11,12,10,3,0,6,8,6,14,1.67,0.5,2018,19,0.75,1.6666666666666667,11,0,11,1.0909090909090908
2018-19,RegularSeason,1628383,508,Justin Patton,1610612755,PHI,3,21,2,7,0.286,0,2,0.0,1,2,0.5,2,4,6,3,2,0,0,5,5,10,0.0,0.0,2018,19,1.6666666666666667,inf,5,1,6,1.0
2018-19,RegularSeason,1628979,508,Trevon Duval,1610612745,HOU,3,6,2,3,0.667,1,1,1.0,0,0,0.0,0,1,1,2,0,0,0,0,5,7,0.0,0.0,2018,19,1.6666666666666667,inf,1,0,1,1.0
2018-19,RegularSeason,1628769,510,Tahjere McCall,1610612751,BKN,1,8,2,3,0.667,0,1,0.0,0,1,0.0,0,1,1,0,0,0,0,2,4,3,0.0,0.0,2018,19,4.0,,1,1,2,0.5
2018-19,RegularSeason,1629116,511,Angel Delgado,1610612746,LAC,2,15,1,5,0.2,0,0,0.0,1,2,0.5,2,2,4,0,1,0,0,2,3,3,0.0,0.0,2018,19,1.5,,4,1,5,0.8
2018-19,RegularSeason,1626296,511,Jordan Sibert,1610612737,ATL,1,4,1,1,1.0,1,1,1.0,0,0,0.0,0,0,0,0,0,0,0,0,3,3,0.0,0.0,2018,19,3.0,,0,0,0,
2018-19,RegularSeason,1629053,511,Vincent Edwards,1610612745,HOU,2,16,1,4,0.25,1,4,0.25,0,0,0.0,1,1,2,0,0,0,0,0,3,2,0.0,0.0,2018,19,1.5,,3,0,3,0.6666666666666666
2018-19,RegularSeason,203474,514,DJ Stephens,1610612763,MEM,1,7,1,2,0.5,0,0,0.0,0,0,0.0,0,0,0,0,1,0,1,0,2,1,0.0,1.0,2018,19,2.0,0.0,1,0,1,0.0
2018-19,RegularSeason,1629147,514,Joe Chealey,1610612766,CHA,1,8,1,3,0.333,0,0,0.0,0,0,0.0,0,0,0,1,0,0,0,1,2,1,0.0,0.0,2018,19,2.0,inf,2,0,2,0.0
2018-19,RegularSeason,203564,514,Kalin Lucas,1610612765,DET,1,6,0,1,0.0,0,1,0.0,2,2,1.0,0,3,3,1,0,0,0,1,2,5,0.0,0.0,2018,19,2.0,inf,1,0,1,3.0
2018-19,RegularSeason,1628961,514,Kostas Antetokounmpo,1610612742,DAL,2,11,0,3,0.0,0,0,0.0,2,4,0.5,0,1,1,0,2,0,1,0,2,-1,0.0,2.0,2018,19,1.0,0.0,3,2,5,0.2
2018-19,RegularSeason,203093,514,Terrence Jones,1610612745,HOU,2,5,1,4,0.25,0,2,0.0,0,1,0.0,0,4,4,0,0,0,1,1,2,1,0.0,0.0,2018,19,1.0,0.0,3,1,4,1.0
2018-19,RegularSeason,1628999,514,Yante Maten,1610612748,MIA,2,13,1,4,0.25,0,1,0.0,0,0,0.0,1,2,3,0,1,0,0,0,2,3,0.0,0.0,2018,19,1.0,,3,0,3,1.0
2018-19,RegularSeason,1627753,514,Zhou Qi,1610612745,HOU,1,1,1,1,1.0,0,0,0.0,0,0,0.0,0,0,0,0,0,0,0,0,2,2,0.0,0.0,2018,19,2.0,,0,0,0,
2018-19,RegularSeason,201281,521,Andre Ingram,1610612747,LAL,4,15,0,6,0.0,0,3,0.0,0,0,0.0,1,1,2,0,1,0,1,0,0,-4,0.0,1.0,2018,19,0.0,0.0,6,0,6,0.3333333333333333
2018-19,RegularSeason,1629055,521,Donte Grantham,1610612760,OKC,3,2,0,2,0.0,0,2,0.0,0,0,0.0,0,0,0,0,0,0,0,0,0,-2,0.0,0.0,2018,19,0.0,,2,0,2,0.0
2018-19,RegularSeason,1628994,521,George King,1610612756,PHX,1,6,0,0,0.0,0,0,0.0,0,0,0.0,0,1,1,0,0,0,0,0,0,1,0.0,0.0,2018,19,0.0,,0,0,0,inf
2018-19,RegularSeason,1628387,521,Ike Anigbogu,1610612754,IND,3,6,0,3,0.0,0,0,0.0,0,0,0.0,1,2,3,1,0,1,1,0,0,1,1.0,0.0,2018,19,0.0,1.0,3,0,3,1.0
2018-19,RegularSeason,204066,521,John Holland,1610612739,CLE,1,1,0,0,0.0,0,0,0.0,0,0,0.0,0,0,0,0,0,0,0,0,0,0,0.0,0.0,2018,19,0.0,,0,0,0,
2018-19,RegularSeason,1628424,521,Kobi Simmons,1610612739,CLE,1,2,0,0,0.0,0,0,0.0,0,0,0.0,0,0,0,0,0,0,0,0,0,0,0.0,0.0,2018,19,0.0,,0,0,0,
2018-19,RegularSeason,1627855,521,Okaro White,1610612764,WAS,3,6,0,2,0.0,0,2,0.0,0,0,0.0,1,1,2,0,0,0,0,0,0,0,0.0,0.0,2018,19,0.0,,2,0,2,1.0
2018-19,RegularSeason,1629093,521,Tyler Davis,1610612760,OKC,1,1,0,1,0.0,0,0,0.0,0,0,0.0,1,0,1,0,0,0,0,0,0,0,0.0,0.0,2018,19,0.0,,1,0,1,1.0
2018-19,RegularSeason,1627755,521,Tyler Ulis,1610612741,CHI,1,1,0,0,0.0,0,0,0.0,0,0,0.0,0,0,0,0,0,0,0,0,0,0,0.0,0.0,2018,19,0.0,,0,0,0,
2018-19,RegularSeason,1629155,521,Zach Lofton,1610612765,DET,1,4,0,1,0.0,0,1,0.0,0,0,0.0,0,0,0,0,1,0,1,0,0,-1,0.0,1.0,2018,19,0.0,0.0,1,0,1,0.0
2018-19,Playoffs,202695,1,Kawhi Leonard,1610612761,TOR,24,939,243,496,0.49,55,145,0.379,191,216,0.884,54,164,218,94,40,17,74,56,732,749,1.27,0.54,2018,19,30.5,1.2702702702702702,253,25,278,0.7841726618705036
2018-19,Playoffs,201939,2,Stephen Curry,1610612744,GSW,22,846,190,431,0.441,92,244,0.377,148,157,0.943,17,115,132,126,24,4,66,68,620,590,1.91,0.36,2018,19,28.181818181818183,1.9090909090909092,241,9,250,0.528
2018-19,Playoffs,1627783,3,Pascal Siakam,1610612761,TOR,24,891,180,383,0.47,29,104,0.279,66,87,0.759,40,131,171,66,24,17,33,67,455,476,2.0,0.73,2018,19,18.958333333333332,2.0,203,21,224,0.7633928571428571
2018-19,Playoffs,202691,4,Klay Thompson,1610612744,GSW,21,818,164,360,0.456,70,158,0.443,37,41,0.902,12,74,86,44,28,15,38,59,435,370,1.16,0.74,2018,19,20.714285714285715,1.1578947368421053,196,4,200,0.43
2018-19,Playoffs,203081,5,Damian Lillard,1610612757,POR,16,650,138,330,0.418,59,158,0.373,95,114,0.833,8,68,76,106,27,5,60,40,430,373,1.77,0.45,2018,19,26.875,1.7666666666666666,192,19,211,0.36018957345971564
2018-19,Playoffs,203468,6,CJ McCollum,1610612757,POR,16,635,154,350,0.44,46,117,0.393,41,56,0.732,14,66,80,59,13,10,30,34,395,316,1.97,0.43,2018,19,24.6875,1.9666666666666666,196,15,211,0.3791469194312796
2018-19,Playoffs,201142,7,Kevin Durant,1610612744,GSW,12,442,125,243,0.514,35,80,0.438,102,113,0.903,1,58,59,54,13,12,43,38,387,353,1.26,0.3,2018,19,32.25,1.255813953488372,118,11,129,0.4573643410852713
2018-19,Playoffs,203507,8,Giannis Antetokounmpo,1610612749,MIL,15,514,129,261,0.494,18,55,0.327,107,168,0.637,36,147,183,73,18,30,50,48,383,444,1.46,0.36,2018,19,25.533333333333335,1.46,132,61,193,0.9481865284974094
2018-19,Playoffs,200768,9,Kyle Lowry,1610612761,TOR,24,900,122,277,0.44,52,145,0.359,65,81,0.802,21,96,117,159,31,7,54,96,361,450,2.94,0.57,2018,19,15.041666666666666,2.9444444444444446,155,16,171,0.6842105263157895
2018-19,Playoffs,203999,10,Nikola Jokic,1610612743,DEN,14,556,132,261,0.506,22,56,0.393,66,78,0.846,54,128,182,118,16,13,36,54,352,504,3.28,0.44,2018,19,25.142857142857142,3.2777777777777777,129,12,141,1.2907801418439717
2018-19,Playoffs,201935,11,James Harden,1610612745,HOU,11,424,109,264,0.413,48,137,0.35,82,98,0.837,9,66,75,73,24,10,51,41,348,308,1.43,0.47,2018,19,31.636363636363637,1.4313725490196079,155,16,171,0.43859649122807015
2018-19,Playoffs,1627750,12,Jamal Murray,1610612743,DEN,14,508,107,252,0.425,28,83,0.337,56,62,0.903,19,42,61,66,14,2,22,24,298,268,3.0,0.64,2018,19,21.285714285714285,3.0,145,6,151,0.40397350993377484
2018-19,Playoffs,203110,13,Draymond Green,1610612744,GSW,22,850,114,229,0.498,13,57,0.228,51,71,0.718,41,182,223,187,32,33,83,85,292,549,2.25,0.39,2018,19,13.272727272727273,2.253012048192771,115,20,135,1.651851851851852
2018-19,Playoffs,203114,14,Khris Middleton,1610612749,MIL,15,515,84,201,0.418,40,92,0.435,46,52,0.885,9,86,95,66,9,0,29,44,254,272,2.28,0.31,2018,19,16.933333333333334,2.2758620689655173,117,6,123,0.7723577235772358
2018-19,Playoffs,202710,15,Jimmy Butler,1610612755,PHI,12,421,79,175,0.451,12,45,0.267,63,72,0.875,22,50,72,62,18,7,22,20,233,265,2.82,0.82,2018,19,19.416666666666668,2.8181818181818183,96,9,105,0.6857142857142857
2018-19,Playoffs,201188,16,Marc Gasol,1610612761,TOR,24,735,76,180,0.422,34,89,0.382,40,46,0.87,16,138,154,73,21,26,21,84,226,369,3.48,1.0,2018,19,9.416666666666666,3.4761904761904763,104,6,110,1.4
2018-19,Playoffs,201586,17,Serge Ibaka,1610612761,TOR,24,500,92,193,0.477,9,38,0.237,32,42,0.762,35,108,143,22,11,23,25,79,225,288,0.88,0.44,2018,19,9.375,0.88,101,10,111,1.2882882882882882
2018-19,Playoffs,203954,18,Joel Embiid,1610612755,PHI,11,334,68,159,0.428,12,39,0.308,74,90,0.822,21,94,115,37,8,25,40,34,222,260,0.93,0.2,2018,19,20.181818181818183,0.925,91,16,107,1.074766355140187
2018-19,Playoffs,2738,19,Andre Iguodala,1610612744,GSW,21,629,82,166,0.494,28,80,0.35,14,37,0.378,27,64,91,83,24,23,21,43,206,299,3.95,1.14,2018,19,9.80952380952381,3.9523809523809526,84,23,107,0.8504672897196262
2018-19,Playoffs,202339,20,Eric Bledsoe,1610612749,MIL,15,423,76,185,0.411,17,72,0.236,36,51,0.706,20,36,56,64,16,6,32,28,205,191,2.0,0.5,2018,19,13.666666666666666,2.0,109,15,124,0.45161290322580644
2018-19,Playoffs,200794,20,Paul Millsap,1610612743,DEN,14,469,73,156,0.468,12,38,0.316,47,61,0.77,24,70,94,11,12,15,18,48,205,222,0.61,0.67,2018,19,14.642857142857142,0.6111111111111112,83,14,97,0.9690721649484536
2018-19,Playoffs,203914,22,Gary Harris,1610612743,DEN,14,517,73,158,0.462,20,57,0.351,33,38,0.868,9,49,58,32,12,8,11,38,199,208,2.91,1.09,2018,19,14.214285714285714,2.909090909090909,85,5,90,0.6444444444444445
2018-19,Playoffs,201569,23,Eric Gordon,1610612745,HOU,11,410,67,150,0.447,38,95,0.4,24,28,0.857,5,23,28,14,7,11,27,22,196,142,0.52,0.26,2018,19,17.818181818181817,0.5185185185185185,83,4,87,0.3218390804597701
2018-19,Playoffs,1627832,24,Fred VanVleet,1610612761,TOR,24,592,65,166,0.392,38,98,0.388,24,31,0.774,7,33,40,62,18,6,21,49,192,189,2.95,0.86,2018,19,8.0,2.9523809523809526,101,7,108,0.37037037037037035
2018-19,Playoffs,202681,24,Kyrie Irving,1610612738,BOS,9,330,69,179,0.385,18,58,0.31,36,40,0.9,5,34,39,63,13,4,28,26,192,169,2.25,0.46,2018,19,21.333333333333332,2.25,110,4,114,0.34210526315789475
2018-19,Playoffs,101108,26,Chris Paul,1610612745,HOU,11,397,66,148,0.446,17,63,0.27,38,45,0.844,14,56,70,60,24,7,37,36,187,222,1.62,0.65,2018,19,17.0,1.6216216216216217,82,7,89,0.7865168539325843
2018-19,Playoffs,202699,27,Tobias Harris,1610612755,PHI,12,443,71,167,0.425,22,63,0.349,22,26,0.846,12,98,110,48,13,6,20,30,186,243,2.4,0.65,2018,19,15.5,2.4,96,4,100,1.1
2018-19,Playoffs,202683,28,Enes Freedom,1610612757,POR,16,461,75,146,0.514,1,4,0.25,31,41,0.756,52,102,154,19,11,9,26,36,182,268,0.73,0.42,2018,19,11.375,0.7307692307692307,71,10,81,1.9012345679012346
2018-19,Playoffs,201588,29,George Hill,1610612749,MIL,15,395,63,118,0.534,20,48,0.417,27,33,0.818,15,38,53,42,12,4,6,34,173,217,7.0,2.0,2018,19,11.533333333333333,7.0,55,6,61,0.8688524590163934
2018-19,Playoffs,201572,30,Brook Lopez,1610612749,MIL,15,438,61,134,0.455,22,75,0.293,24,29,0.828,12,70,82,21,6,28,10,46,168,217,2.1,0.6,2018,19,11.2,2.1,73,5,78,1.0512820512820513
2018-19,Playoffs,1627732,31,Ben Simmons,1610612755,PHI,12,421,72,116,0.621,0,0,0.0,23,40,0.575,23,61,84,72,15,12,32,45,167,257,2.25,0.47,2018,19,13.916666666666666,2.25,44,17,61,1.3770491803278688
2018-19,Playoffs,201980,32,Danny Green,1610612761,TOR,24,684,53,155,0.342,39,119,0.328,21,23,0.913,17,70,87,26,32,11,26,60,166,192,1.0,1.23,2018,19,6.916666666666667,1.0,102,2,104,0.8365384615384616
2018-19,Playoffs,200755,33,JJ Redick,1610612755,PHI,12,375,54,124,0.435,36,87,0.414,17,20,0.85,2,16,18,19,1,3,22,32,161,107,0.86,0.04,2018,19,13.416666666666666,0.8636363636363636,70,3,73,0.2465753424657534
2018-19,Playoffs,203918,34,Rodney Hood,1610612757,POR,16,373,52,111,0.468,18,51,0.353,36,44,0.818,9,27,36,14,6,3,7,28,158,143,2.0,0.86,2018,19,9.875,2.0,59,8,67,0.5373134328358209
2018-19,Playoffs,201942,35,DeMar DeRozan,1610612759,SAS,7,251,58,119,0.487,0,1,0.0,38,44,0.864,10,37,47,32,8,1,12,16,154,163,2.67,0.67,2018,19,22.0,2.6666666666666665,61,6,67,0.7014925373134329
2018-19,Playoffs,1626181,36,Norman Powell,1610612761,TOR,23,366,56,126,0.444,24,62,0.387,14,19,0.737,5,46,51,26,9,0,12,31,150,149,2.17,0.75,2018,19,6.521739130434782,2.1666666666666665,70,5,75,0.68
2018-19,Playoffs,1626172,37,Kevon Looney,1610612744,GSW,21,431,64,93,0.688,0,0,0.0,21,29,0.724,41,53,94,20,12,11,13,50,149,236,1.54,0.92,2018,19,7.095238095238095,1.5384615384615385,29,8,37,2.5405405405405403
2018-19,Playoffs,202331,38,Paul George,1610612760,OKC,5,204,44,101,0.436,15,47,0.319,40,49,0.816,6,37,43,18,7,1,21,21,143,125,0.86,0.33,2018,19,28.6,0.8571428571428571,57,9,66,0.6515151515151515
2018-19,Playoffs,200746,39,LaMarcus Aldridge,1610612759,SAS,7,244,55,121,0.455,3,11,0.273,27,33,0.818,19,48,67,19,5,7,7,21,140,159,2.71,0.71,2018,19,20.0,2.7142857142857144,66,6,72,0.9305555555555556
2018-19,Playoffs,1628369,40,Jayson Tatum,1610612738,BOS,9,295,49,112,0.438,10,31,0.323,29,39,0.744,7,53,60,17,10,7,18,21,137,140,0.94,0.56,2018,19,15.222222222222221,0.9444444444444444,63,10,73,0.821917808219178
2018-19,Playoffs,203090,41,Maurice Harkless,1610612757,POR,16,388,52,109,0.477,7,28,0.25,23,36,0.639,29,49,78,23,18,16,17,56,134,182,1.35,1.06,2018,19,8.375,1.3529411764705883,57,13,70,1.1142857142857143
2018-19,Playoffs,202703,42,Nikola Mirotic,1610612749,MIL,14,298,44,117,0.376,22,76,0.289,23,28,0.821,17,43,60,10,10,3,14,25,133,124,0.71,0.71,2018,19,9.5,0.7142857142857143,73,5,78,0.7692307692307693
2018-19,Playoffs,101150,43,Lou Williams,1610612746,LAC,6,176,45,104,0.433,6,18,0.333,34,41,0.829,6,11,17,46,5,1,18,14,130,115,2.56,0.28,2018,19,21.666666666666668,2.5555555555555554,59,7,66,0.25757575757575757
2018-19,Playoffs,203115,44,Will Barton,1610612743,DEN,14,328,47,135,0.348,15,55,0.273,18,26,0.692,15,52,67,24,4,9,14,19,127,121,1.71,0.29,2018,19,9.071428571428571,1.7142857142857142,88,8,96,0.6979166666666666
2018-19,Playoffs,201143,45,Al Horford,1610612738,BOS,9,310,46,110,0.418,18,44,0.409,15,18,0.833,13,68,81,40,4,7,19,21,125,171,2.1,0.21,2018,19,13.88888888888889,2.1052631578947367,64,3,67,1.208955223880597
2018-19,Playoffs,1627759,45,Jaylen Brown,1610612738,BOS,9,274,44,87,0.506,14,40,0.35,23,30,0.767,6,46,52,10,6,2,16,30,125,129,0.63,0.38,2018,19,13.88888888888889,0.625,43,7,50,1.04
2018-19,Playoffs,200782,45,P.J. Tucker,1610612745,HOU,11,426,40,88,0.455,26,57,0.456,19,23,0.826,19,63,82,19,19,8,8,35,125,193,2.38,2.38,2018,19,11.363636363636363,2.375,48,4,52,1.5769230769230769
2018-19,Playoffs,202694,48,Marcus Morris Sr.,1610612738,BOS,9,254,41,79,0.519,18,40,0.45,23,31,0.742,12,61,73,11,1,5,7,22,123,160,1.57,0.14,2018,19,13.666666666666666,1.5714285714285714,38,8,46,1.5869565217391304
2018-19,Playoffs,201568,49,Danilo Gallinari,1610612746,LAC,6,201,39,111,0.351,13,43,0.302,28,33,0.848,9,28,37,16,8,1,11,14,119,93,1.46,0.73,2018,19,19.833333333333332,1.4545454545454546,72,5,77,0.4805194805194805
2018-19,Playoffs,202329,50,Al-Farouq Aminu,1610612757,POR,16,399,38,109,0.349,15,51,0.294,27,36,0.75,29,71,100,21,9,10,16,34,118,162,1.31,0.56,2018,19,7.375,1.3125,71,9,80,1.25
2018-19,Playoffs,201566,51,Russell Westbrook,1610612760,OKC,5,197,40,111,0.36,11,34,0.324,23,26,0.885,7,38,45,53,5,3,23,19,114,123,2.3,0.22,2018,19,22.8,2.3043478260869565,71,3,74,0.6081081081081081
2018-19,Playoffs,1627736,52,Malik Beasley,1610612743,DEN,14,281,36,93,0.387,19,47,0.404,22,31,0.71,11,37,48,14,3,1,7,20,113,106,2.0,0.43,2018,19,8.071428571428571,2.0,57,9,66,0.7272727272727273
2018-19,Playoffs,1626149,53,Montrezl Harrell,1610612746,LAC,6,158,46,63,0.73,0,1,0.0,18,26,0.692,12,21,33,13,3,4,8,19,110,130,1.63,0.38,2018,19,18.333333333333332,1.625,17,8,25,1.32
2018-19,Playoffs,1628380,54,Zach Collins,1610612757,POR,16,275,41,81,0.506,7,21,0.333,20,25,0.8,17,41,58,14,7,21,20,54,109,144,0.7,0.35,2018,19,6.8125,0.7,40,5,45,1.288888888888889
2018-19,Playoffs,203991,55,Clint Capela,1610612745,HOU,11,331,46,82,0.561,0,0,0.0,15,35,0.429,41,72,113,16,3,12,16,26,107,179,1.0,0.19,2018,19,9.727272727272727,1.0,36,20,56,2.017857142857143
2018-19,Playoffs,1628378,55,Donovan Mitchell,1610612762,UTA,5,193,36,112,0.321,11,43,0.256,24,33,0.727,7,18,25,16,8,1,21,15,107,51,0.76,0.38,2018,19,21.4,0.7619047619047619,76,9,85,0.29411764705882354
2018-19,Playoffs,1628401,57,Derrick White,1610612759,SAS,7,191,41,75,0.547,5,17,0.294,19,26,0.731,1,20,21,21,5,5,15,17,106,102,1.4,0.33,2018,19,15.142857142857142,1.4,34,7,41,0.5121951219512195
2018-19,Playoffs,1627747,58,Caris LeVert,1610612751,BKN,5,144,36,73,0.493,12,26,0.462,21,29,0.724,6,17,23,15,5,2,10,8,105,95,1.5,0.5,2018,19,21.0,1.5,37,8,45,0.5111111111111111
2018-19,Playoffs,101141,59,Ersan Ilyasova,1610612749,MIL,15,272,35,81,0.432,12,40,0.3,20,25,0.8,20,51,71,21,10,6,7,40,102,152,3.0,1.43,2018,19,6.8,3.0,46,5,51,1.392156862745098
2018-19,Playoffs,1626156,60,D'Angelo Russell,1610612751,BKN,5,148,37,103,0.359,12,37,0.324,11,13,0.846,2,16,18,18,7,1,14,12,97,59,1.29,0.5,2018,19,19.4,1.2857142857142858,66,2,68,0.2647058823529412
2018-19,Playoffs,1626192,61,Pat Connaughton,1610612749,MIL,15,324,37,77,0.481,15,42,0.357,4,8,0.5,10,83,93,21,6,13,9,14,93,173,2.33,0.67,2018,19,6.2,2.3333333333333335,40,4,44,2.1136363636363638
2018-19,Playoffs,1628470,62,Torrey Craig,1610612743,DEN,14,330,33,69,0.478,17,36,0.472,9,16,0.563,21,51,72,12,7,5,6,38,92,139,2.0,1.17,2018,19,6.571428571428571,2.0,36,7,43,1.6744186046511629
2018-19,Playoffs,1627763,63,Malcolm Brogdon,1610612749,MIL,7,198,35,78,0.449,14,37,0.378,7,11,0.636,6,28,34,24,5,1,10,16,91,98,2.4,0.5,2018,19,13.0,2.4,43,4,47,0.723404255319149
2018-19,Playoffs,203552,64,Seth Curry,1610612757,POR,16,326,30,82,0.366,21,52,0.404,9,11,0.818,5,20,25,13,12,4,7,27,90,83,1.86,1.71,2018,19,5.625,1.8571428571428572,52,2,54,0.46296296296296297
2018-19,Playoffs,2733,65,Shaun Livingston,1610612744,GSW,22,322,34,75,0.453,0,2,0.0,21,25,0.84,11,20,31,31,10,4,8,35,89,112,3.88,1.25,2018,19,4.045454545454546,3.875,41,4,45,0.6888888888888889
2018-19,Playoffs,202330,66,Gordon Hayward,1610612738,BOS,9,267,29,70,0.414,9,24,0.375,19,19,1.0,3,33,36,22,6,3,14,16,86,98,1.57,0.43,2018,19,9.555555555555555,1.5714285714285714,41,0,41,0.8780487804878049
2018-19,Playoffs,203086,67,Meyers Leonard,1610612757,POR,11,170,34,65,0.523,14,33,0.424,3,9,0.333,6,34,40,12,3,1,4,27,85,100,3.0,0.75,2018,19,7.7272727272727275,3.0,31,6,37,1.0810810810810811
2018-19,Playoffs,203516,68,James Ennis III,1610612755,PHI,11,232,31,64,0.484,9,32,0.281,12,19,0.632,16,26,42,12,4,3,10,31,83,94,1.2,0.4,2018,19,7.545454545454546,1.2,33,7,40,1.05
2018-19,Playoffs,1628983,69,Shai Gilgeous-Alexander,1610612746,LAC,6,173,28,60,0.467,9,18,0.5,17,20,0.85,4,12,16,19,6,5,5,17,82,88,3.8,1.2,2018,19,13.666666666666666,3.8,32,3,35,0.45714285714285713
2018-19,Playoffs,200752,70,Rudy Gay,1610612759,SAS,7,178,28,70,0.4,8,19,0.421,14,17,0.824,13,37,50,12,3,5,10,13,78,93,1.2,0.3,2018,19,11.142857142857142,1.2,42,3,45,1.1111111111111112
2018-19,Playoffs,201937,71,Ricky Rubio,1610612762,UTA,5,168,28,66,0.424,4,20,0.2,17,20,0.85,3,13,16,43,12,1,15,14,77,93,2.87,0.8,2018,19,15.4,2.8666666666666667,38,3,41,0.3902439024390244
2018-19,Playoffs,203932,72,Aaron Gordon,1610612753,ORL,5,164,29,62,0.468,8,20,0.4,10,19,0.526,11,25,36,18,6,1,13,16,76,82,1.39,0.46,2018,19,15.2,1.3846153846153846,33,9,42,0.8571428571428571
2018-19,Playoffs,1627854,73,Bryn Forbes,1610612759,SAS,7,212,27,56,0.482,15,31,0.484,6,9,0.667,1,24,25,7,1,1,3,14,75,74,2.33,0.33,2018,19,10.714285714285714,2.3333333333333335,29,3,32,0.78125
2018-19,Playoffs,1628420,73,Monte Morris,1610612743,DEN,14,224,33,86,0.384,0,13,0.0,9,13,0.692,3,16,19,36,5,1,6,15,75,73,6.0,0.83,2018,19,5.357142857142857,6.0,53,4,57,0.3333333333333333
2018-19,Playoffs,203085,75,Austin Rivers,1610612745,HOU,10,215,27,62,0.435,16,35,0.457,4,6,0.667,2,19,21,10,5,1,8,31,74,66,1.25,0.63,2018,19,7.4,1.25,35,2,37,0.5675675675675675
2018-19,Playoffs,203915,76,Spencer Dinwiddie,1610612751,BKN,5,131,27,62,0.435,9,24,0.375,10,14,0.714,4,9,13,8,2,0,8,10,73,49,1.0,0.25,2018,19,14.6,1.0,35,4,39,0.3333333333333333
2018-19,Playoffs,202711,77,Bojan Bogdanovic,1610612754,IND,4,148,25,63,0.397,7,22,0.318,15,17,0.882,3,20,23,11,8,0,6,7,72,68,1.83,1.33,2018,19,18.0,1.8333333333333333,38,2,40,0.575
2018-19,Playoffs,1626188,78,Quinn Cook,1610612744,GSW,17,193,28,70,0.4,11,34,0.324,4,4,1.0,2,16,18,12,3,1,6,13,71,57,2.0,0.5,2018,19,4.176470588235294,2.0,42,0,42,0.42857142857142855
2018-19,Playoffs,202704,78,Reggie Jackson,1610612765,DET,4,108,28,65,0.431,9,21,0.429,6,7,0.857,5,8,13,28,3,0,5,12,71,72,5.6,0.6,2018,19,17.75,5.6,37,1,38,0.34210526315789475
2018-19,Playoffs,203471,80,Dennis Schroder,1610612760,OKC,5,151,25,55,0.455,6,20,0.3,13,18,0.722,2,14,16,17,4,0,6,11,69,65,2.83,0.67,2018,19,13.8,2.8333333333333335,30,5,35,0.45714285714285713
2018-19,Playoffs,1628035,81,Alfonzo McKinnie,1610612744,GSW,22,235,26,59,0.441,10,32,0.313,4,10,0.4,17,33,50,4,2,1,6,32,66,78,0.67,0.33,2018,19,3.0,0.6666666666666666,33,6,39,1.2820512820512822
2018-19,Playoffs,203210,81,JaMychal Green,1610612746,LAC,6,141,23,43,0.535,12,23,0.522,8,10,0.8,6,26,32,5,4,0,11,22,66,74,0.46,0.36,2018,19,11.0,0.45454545454545453,20,2,22,1.4545454545454546
2018-19,Playoffs,203082,81,Terrence Ross,1610612753,ORL,5,146,20,54,0.37,12,35,0.343,14,17,0.824,1,17,18,7,6,2,10,10,66,52,0.7,0.6,2018,19,13.2,0.7,34,3,37,0.4864864864864865
2018-19,Playoffs,1626246,84,Boban Marjanovic,1610612755,PHI,11,105,24,40,0.6,0,3,0.0,16,19,0.842,13,23,36,11,2,3,14,18,64,83,0.79,0.14,2018,19,5.818181818181818,0.7857142857142857,16,3,19,1.894736842105263
2018-19,Playoffs,201571,84,D.J. Augustin,1610612753,ORL,5,141,20,41,0.488,10,21,0.476,14,16,0.875,1,7,8,19,2,1,7,7,64,64,2.71,0.29,2018,19,12.8,2.7142857142857144,21,2,23,0.34782608695652173
2018-19,Playoffs,203486,84,Mason Plumlee,1610612743,DEN,14,218,24,47,0.511,0,1,0.0,16,28,0.571,26,36,62,21,7,10,8,39,64,121,2.63,0.88,2018,19,4.571428571428571,2.625,23,12,35,1.7714285714285714
2018-19,Playoffs,203095,87,Evan Fournier,1610612753,ORL,5,175,24,69,0.348,8,34,0.235,6,8,0.75,3,13,16,10,7,0,12,14,62,36,0.83,0.58,2018,19,12.4,0.8333333333333334,45,2,47,0.3404255319148936
2018-19,Playoffs,202326,88,DeMarcus Cousins,1610612744,GSW,8,133,21,53,0.396,3,12,0.25,16,25,0.64,9,30,39,19,5,6,19,24,61,70,1.0,0.26,2018,19,7.625,1.0,32,9,41,0.9512195121951219
2018-19,Playoffs,201936,88,Tyreke Evans,1610612754,IND,4,84,21,48,0.438,11,20,0.55,8,14,0.571,0,17,17,3,3,1,6,8,61,46,0.5,0.5,2018,19,15.25,0.5,27,6,33,0.5151515151515151
2018-19,Playoffs,1628379,90,Luke Kennard,1610612765,DET,4,133,23,47,0.489,9,15,0.6,5,6,0.833,0,16,16,7,3,1,3,6,60,59,2.33,1.0,2018,19,15.0,2.3333333333333335,24,1,25,0.64
2018-19,Playoffs,202324,91,Derrick Favors,1610612762,UTA,5,103,23,36,0.639,0,3,0.0,13,19,0.684,15,22,37,4,4,9,5,12,59,89,0.8,0.8,2018,19,11.8,0.8,13,6,19,1.9473684210526316
2018-19,Playoffs,201976,91,Patrick Beverley,1610612746,LAC,6,195,20,47,0.426,13,30,0.433,6,8,0.75,8,40,48,28,6,6,10,21,59,108,2.8,0.6,2018,19,9.833333333333334,2.8,27,2,29,1.6551724137931034
2018-19,Playoffs,203500,91,Steven Adams,1610612760,OKC,5,159,28,42,0.667,0,1,0.0,3,8,0.375,12,24,36,7,5,5,9,13,59,84,0.78,0.56,2018,19,11.8,0.7777777777777778,14,5,19,1.894736842105263
2018-19,Playoffs,203924,94,Jerami Grant,1610612760,OKC,5,176,20,40,0.5,9,20,0.45,9,13,0.692,6,21,27,4,3,10,4,13,58,74,1.0,0.75,2018,19,11.6,1.0,20,4,24,1.125
2018-19,Playoffs,1626179,94,Terry Rozier,1610612738,BOS,9,162,19,59,0.322,8,34,0.235,12,16,0.75,4,35,39,17,4,2,10,15,58,66,1.7,0.4,2018,19,6.444444444444445,1.7,40,4,44,0.8863636363636364
2018-19,Playoffs,203083,96,Andre Drummond,1610612765,DET,4,127,24,54,0.444,0,1,0.0,9,21,0.429,20,32,52,9,6,5,11,17,57,76,0.82,0.55,2018,19,14.25,0.8181818181818182,30,12,42,1.2380952380952381
2018-19,Playoffs,203109,96,Jae Crowder,1610612762,UTA,5,130,17,46,0.37,9,30,0.3,14,19,0.737,4,25,29,4,5,0,1,7,57,60,4.0,5.0,2018,19,11.4,4.0,29,5,34,0.8529411764705882
2018-19,Playoffs,203118,98,Mike Scott,1610612755,PHI,10,193,21,47,0.447,12,34,0.353,2,2,1.0,4,30,34,5,3,0,7,22,56,65,0.71,0.43,2018,19,5.6,0.7142857142857143,26,0,26,1.3076923076923077
2018-19,Playoffs,202696,98,Nikola Vucevic,1610612753,ORL,5,147,21,58,0.362,3,13,0.231,11,14,0.786,9,31,40,15,2,5,13,12,56,65,1.15,0.15,2018,19,11.2,1.1538461538461537,37,3,40,1.0
2018-19,Playoffs,203497,98,Rudy Gobert,1610612762,UTA,5,152,19,32,0.594,0,0,0.0,18,23,0.783,23,28,51,7,3,13,9,16,56,103,0.78,0.33,2018,19,11.2,0.7777777777777778,13,5,18,2.8333333333333335
2018-19,Playoffs,1628386,101,Jarrett Allen,1610612751,BKN,5,110,19,32,0.594,0,0,0.0,17,20,0.85,15,19,34,11,3,3,8,13,55,82,1.38,0.38,2018,19,11.0,1.375,13,3,16,2.125
2018-19,Playoffs,1626178,102,Rondae Hollis-Jefferson,1610612751,BKN,4,62,16,33,0.485,1,1,1.0,20,25,0.8,3,9,12,6,1,5,3,7,53,52,2.0,0.33,2018,19,13.25,2.0,17,5,22,0.5454545454545454
2018-19,Playoffs,1626220,102,Royce O'Neale,1610612762,UTA,5,137,21,45,0.467,8,23,0.348,3,4,0.75,2,21,23,8,2,2,10,15,53,53,0.8,0.2,2018,19,10.6,0.8,24,1,25,0.92
2018-19,Playoffs,101106,104,Andrew Bogut,1610612744,GSW,19,179,24,37,0.649,0,0,0.0,4,5,0.8,23,51,74,21,5,6,10,38,52,134,2.1,0.5,2018,19,2.736842105263158,2.1,13,1,14,5.285714285714286
2018-19,Playoffs,1627751,105,Jakob Poeltl,1610612759,SAS,7,177,23,36,0.639,0,1,0.0,5,9,0.556,25,29,54,12,2,5,3,26,51,104,4.0,0.67,2018,19,7.285714285714286,4.0,13,4,17,3.176470588235294
2018-19,Playoffs,201933,106,Blake Griffin,1610612765,DET,2,58,18,39,0.462,6,13,0.462,7,7,1.0,4,8,12,12,2,0,6,9,49,48,2.0,0.33,2018,19,24.5,2.0,21,0,21,0.5714285714285714
2018-19,Playoffs,201954,107,Darren Collison,1610612754,IND,4,117,19,45,0.422,4,11,0.364,6,6,1.0,4,8,12,16,2,0,10,11,48,42,1.6,0.2,2018,19,12.0,1.6,26,0,26,0.46153846153846156
2018-19,Playoffs,1629013,108,Landry Shamet,1610612746,LAC,6,174,13,38,0.342,10,31,0.323,10,10,1.0,1,11,12,10,6,0,7,15,46,42,1.43,0.86,2018,19,7.666666666666667,1.4285714285714286,25,0,25,0.48
2018-19,Playoffs,1628425,109,Sterling Brown,1610612749,MIL,11,162,15,38,0.395,7,21,0.333,8,11,0.727,4,26,30,19,6,3,8,17,45,69,2.38,0.75,2018,19,4.090909090909091,2.375,23,3,26,1.1538461538461537
2018-19,Playoffs,203925,110,Joe Harris,1610612751,BKN,5,149,16,43,0.372,4,21,0.19,8,8,1.0,6,15,21,3,3,0,9,12,44,35,0.33,0.33,2018,19,8.8,0.3333333333333333,27,0,27,0.7777777777777778
2018-19,Playoffs,202323,111,Evan Turner,1610612757,POR,16,245,15,46,0.326,1,1,1.0,12,15,0.8,13,59,72,35,3,3,13,22,43,109,2.69,0.23,2018,19,2.6875,2.6923076923076925,31,3,34,2.1176470588235294
2018-19,Playoffs,201152,112,Thaddeus Young,1610612754,IND,4,130,18,42,0.429,2,8,0.25,4,7,0.571,9,19,28,15,11,3,5,10,42,67,3.0,2.2,2018,19,10.5,3.0,24,3,27,1.037037037037037
2018-19,Playoffs,1628395,113,Jordan Bell,1610612744,GSW,15,106,17,31,0.548,0,0,0.0,7,10,0.7,7,12,19,11,4,7,2,13,41,63,5.5,2.0,2018,19,2.7333333333333334,5.5,14,3,17,1.1176470588235294
2018-19,Playoffs,201158,113,Marco Belinelli,1610612759,SAS,7,131,14,38,0.368,8,21,0.381,5,6,0.833,0,13,13,8,0,2,2,7,41,37,4.0,0.0,2018,19,5.857142857142857,4.0,24,1,25,0.52
2018-19,Playoffs,202328,115,Greg Monroe,1610612755,PHI,10,90,16,40,0.4,1,4,0.25,7,9,0.778,14,17,31,4,5,3,4,11,40,53,1.0,1.25,2018,19,4.0,1.0,24,2,26,1.1923076923076923
2018-19,Playoffs,101123,116,Gerald Green,1610612745,HOU,11,97,12,40,0.3,10,29,0.345,5,5,1.0,0,12,12,1,3,3,3,12,39,27,0.33,1.0,2018,19,3.5454545454545454,0.3333333333333333,28,0,28,0.42857142857142855
2018-19,Playoffs,1626167,116,Myles Turner,1610612754,IND,4,126,14,35,0.4,3,14,0.214,8,13,0.615,4,21,25,6,0,7,3,14,39,48,2.0,0.0,2018,19,9.75,2.0,21,5,26,0.9615384615384616
2018-19,Playoffs,201988,118,Patty Mills,1610612759,SAS,7,152,14,43,0.326,3,22,0.136,6,10,0.6,1,14,15,25,7,1,3,9,37,49,8.33,2.33,2018,19,5.285714285714286,8.333333333333334,29,4,33,0.45454545454545453
2018-19,Playoffs,1627863,119,Danuel House Jr.,1610612745,HOU,7,141,11,37,0.297,8,31,0.258,4,8,0.5,2,20,22,1,3,2,4,11,34,28,0.25,0.75,2018,19,4.857142857142857,0.25,26,4,30,0.7333333333333333
2018-19,Playoffs,1627734,119,Domantas Sabonis,1610612754,IND,4,96,12,29,0.414,1,4,0.25,9,14,0.643,7,22,29,16,3,1,5,12,34,56,3.2,0.6,2018,19,8.5,3.2,17,5,22,1.3181818181818181
2018-19,Playoffs,201973,119,Jonas Jerebko,1610612744,GSW,16,121,12,42,0.286,5,19,0.263,5,6,0.833,15,19,34,12,1,2,2,9,34,50,6.0,0.5,2018,19,2.125,6.0,30,1,31,1.096774193548387
2018-19,Playoffs,201960,122,DeMarre Carroll,1610612751,BKN,5,119,9,38,0.237,7,24,0.292,8,8,1.0,6,14,20,2,4,0,3,8,33,27,0.67,1.33,2018,19,6.6,0.6666666666666666,29,0,29,0.6896551724137931
2018-19,Playoffs,1628371,122,Jonathan Isaac,1610612753,ORL,5,137,11,40,0.275,4,20,0.2,7,8,0.875,10,21,31,2,2,5,5,9,33,38,0.4,0.4,2018,19,6.6,0.4,29,1,30,1.0333333333333334
2018-19,Playoffs,203487,122,Michael Carter-Williams,1610612753,ORL,5,92,12,31,0.387,2,8,0.25,7,8,0.875,2,18,20,12,3,0,8,12,33,40,1.5,0.38,2018,19,6.6,1.5,19,1,20,1.0
2018-19,Playoffs,204060,125,Joe Ingles,1610612762,UTA,5,151,12,37,0.324,8,29,0.276,0,0,0.0,3,21,24,25,11,0,8,14,32,59,3.13,1.38,2018,19,6.4,3.125,25,0,25,0.96
2018-19,Playoffs,204038,126,Langston Galloway,1610612765,DET,4,110,11,34,0.324,9,25,0.36,0,0,0.0,2,13,15,4,2,4,2,10,31,31,2.0,1.0,2018,19,7.75,2.0,23,0,23,0.6521739130434783
2018-19,Playoffs,201961,126,Wayne Ellington,1610612765,DET,4,131,11,35,0.314,7,22,0.318,2,2,1.0,3,12,15,5,3,0,2,4,31,28,2.5,1.5,2018,19,7.75,2.5,24,0,24,0.625
2018-19,Playoffs,202709,128,Cory Joseph,1610612754,IND,4,85,12,24,0.5,4,9,0.444,2,2,1.0,1,6,7,4,3,0,0,7,30,32,0.0,0.0,2018,19,7.5,inf,12,0,12,0.5833333333333334
2018-19,Playoffs,202697,129,Iman Shumpert,1610612745,HOU,8,109,10,26,0.385,8,22,0.364,1,4,0.25,1,11,12,2,1,0,3,10,29,22,0.67,0.33,2018,19,3.625,0.6666666666666666,16,3,19,0.631578947368421
2018-19,Playoffs,202083,130,Wesley Matthews,1610612754,IND,4,119,9,30,0.3,7,21,0.333,3,3,1.0,0,10,10,8,3,1,8,6,28,21,1.0,0.38,2018,19,7.0,1.0,21,0,21,0.47619047619047616
2018-19,Playoffs,2403,131,Nene,1610612745,HOU,7,53,10,10,1.0,0,0,0.0,7,9,0.778,9,5,14,3,3,2,3,7,27,44,1.0,1.0,2018,19,3.857142857142857,1.0,0,2,2,7.0
2018-19,Playoffs,203920,132,Khem Birch,1610612753,ORL,5,92,10,18,0.556,0,0,0.0,6,7,0.857,9,22,31,4,1,5,6,8,26,52,0.67,0.17,2018,19,5.2,0.6666666666666666,8,1,9,3.4444444444444446
2018-19,Playoffs,203613,133,Jonathon Simmons,1610612755,PHI,7,52,10,30,0.333,2,10,0.2,3,4,0.75,2,7,9,2,1,0,6,2,25,10,0.33,0.17,2018,19,3.5714285714285716,0.3333333333333333,20,1,21,0.42857142857142855
2018-19,Playoffs,1629066,133,Rodions Kurucs,1610612751,BKN,4,68,8,20,0.4,2,8,0.25,7,9,0.778,6,14,20,3,2,0,2,10,25,34,1.5,1.0,2018,19,6.25,1.5,12,2,14,1.4285714285714286
2018-19,Playoffs,1628390,133,Terrance Ferguson,1610612760,OKC,5,128,9,25,0.36,7,18,0.389,0,0,0.0,2,10,12,6,2,0,5,19,25,24,1.2,0.4,2018,19,5.0,1.2,16,0,16,0.75
2018-19,Playoffs,202397,136,Ish Smith,1610612765,DET,4,81,10,38,0.263,1,7,0.143,3,4,0.75,1,10,11,14,3,1,4,8,24,20,3.5,0.75,2018,19,6.0,3.5,28,1,29,0.3793103448275862
2018-19,Playoffs,202702,136,Kenneth Faried,1610612745,HOU,6,56,9,13,0.692,1,1,1.0,5,6,0.833,3,18,21,2,2,0,0,6,24,44,0.0,0.0,2018,19,4.0,inf,4,1,5,4.2
2018-19,Playoffs,203457,136,Nerlens Noel,1610612760,OKC,5,60,12,20,0.6,0,0,0.0,0,2,0.0,11,8,19,0,2,3,4,9,24,34,0.0,0.5,2018,19,4.8,0.0,8,2,10,1.9
2018-19,Playoffs,203894,136,Shabazz Napier,1610612751,BKN,3,28,7,11,0.636,3,5,0.6,7,8,0.875,2,5,7,11,1,0,0,1,24,38,0.0,0.0,2018,19,8.0,inf,4,1,5,1.4
2018-19,Playoffs,204456,136,T.J. McConnell,1610612755,PHI,9,75,12,27,0.444,0,0,0.0,0,0,0.0,1,5,6,11,2,1,1,4,24,28,11.0,2.0,2018,19,2.6666666666666665,11.0,15,0,15,0.4
2018-19,Playoffs,1628411,136,Wes Iwundu,1610612753,ORL,5,60,6,18,0.333,3,9,0.333,9,9,1.0,0,7,7,4,3,0,2,4,24,24,2.0,1.5,2018,19,4.8,2.0,12,0,12,0.5833333333333334
2018-19,Playoffs,1627777,142,Georges Niang,1610612762,UTA,5,55,9,22,0.409,4,13,0.308,0,0,0.0,0,14,14,5,1,1,2,5,22,28,2.5,0.5,2018,19,4.4,2.5,13,0,13,1.0769230769230769
2018-19,Playoffs,201975,142,Jodie Meeks,1610612761,TOR,14,67,9,29,0.31,2,13,0.154,2,3,0.667,0,9,9,1,4,1,3,7,22,13,0.33,1.33,2018,19,1.5714285714285714,0.3333333333333333,20,1,21,0.42857142857142855
2018-19,Playoffs,1627748,142,Thon Maker,1610612765,DET,4,69,7,26,0.269,0,12,0.0,8,9,0.889,4,5,9,4,0,4,3,14,22,16,1.33,0.0,2018,19,5.5,1.3333333333333333,19,1,20,0.45
2018-19,Playoffs,204025,145,Tim Frazier,1610612749,MIL,11,40,8,13,0.615,3,6,0.5,2,2,1.0,0,9,9,10,1,0,3,5,21,33,3.33,0.33,2018,19,1.9090909090909092,3.3333333333333335,5,0,5,1.8
2018-19,Playoffs,1627826,146,Ivica Zubac,1610612746,LAC,4,39,9,18,0.5,0,0,0.0,2,3,0.667,11,11,22,1,2,2,4,5,20,33,0.25,0.5,2018,19,5.0,0.25,9,1,10,2.2
2018-19,Playoffs,203382,147,Aron Baynes,1610612738,BOS,9,115,8,14,0.571,2,6,0.333,1,2,0.5,6,19,25,3,3,2,5,20,19,40,0.6,0.6,2018,19,2.111111111111111,0.6,6,1,7,3.5714285714285716
2018-19,Playoffs,1628391,147,D.J. Wilson,1610612749,MIL,8,43,8,16,0.5,1,5,0.2,2,2,1.0,1,9,10,4,0,1,7,7,19,19,0.57,0.0,2018,19,2.375,0.5714285714285714,8,0,8,1.25
2018-19,Playoffs,1627788,147,Furkan Korkmaz,1610612755,PHI,4,36,6,18,0.333,3,8,0.375,4,5,0.8,0,6,6,5,0,1,1,5,19,17,5.0,0.0,2018,19,4.75,5.0,12,1,13,0.46153846153846156
2018-19,Playoffs,202693,147,Markieff Morris,1610612760,OKC,5,59,5,16,0.313,2,7,0.286,7,9,0.778,4,9,13,5,1,3,2,9,19,26,2.5,0.5,2018,19,3.8,2.5,11,2,13,1.0
2018-19,Playoffs,1629010,151,Jerome Robinson,1610612746,LAC,5,46,5,14,0.357,3,6,0.5,5,5,1.0,2,4,6,7,2,0,1,4,18,23,7.0,2.0,2018,19,3.6,7.0,9,0,9,0.6666666666666666
2018-19,Playoffs,202722,152,Dāvis Bertāns,1610612759,SAS,5,79,5,15,0.333,3,11,0.273,3,5,0.6,0,8,8,5,0,1,1,10,16,17,5.0,0.0,2018,19,3.2,5.0,10,2,12,0.6666666666666666
2018-19,Playoffs,202334,152,Ed Davis,1610612751,BKN,3,41,7,10,0.7,0,0,0.0,2,2,1.0,4,15,19,2,0,1,0,9,16,35,0.0,0.0,2018,19,5.333333333333333,inf,3,0,3,6.333333333333333
2018-19,Playoffs,1628413,152,Jonah Bolden,1610612755,PHI,10,79,5,19,0.263,4,16,0.25,2,4,0.5,4,10,14,3,2,1,9,12,16,11,0.33,0.22,2018,19,1.6,0.3333333333333333,14,2,16,0.875
2018-19,Playoffs,201163,155,Wilson Chandler,1610612746,LAC,4,52,5,16,0.313,1,10,0.1,4,4,1.0,0,6,6,2,2,0,3,7,15,11,0.67,0.67,2018,19,3.75,0.6666666666666666,11,0,11,0.5454545454545454
2018-19,Playoffs,202066,156,Garrett Temple,1610612746,LAC,6,63,3,11,0.273,1,7,0.143,7,10,0.7,1,6,7,2,3,1,2,8,14,14,1.0,1.5,2018,19,2.3333333333333335,1.0,8,3,11,0.6363636363636364
2018-19,Playoffs,1629017,156,Khyri Thomas,1610612765,DET,3,15,6,12,0.5,1,4,0.25,1,1,1.0,0,2,2,0,2,0,0,0,14,12,0.0,0.0,2018,19,4.666666666666667,,6,0,6,0.3333333333333333
2018-19,Playoffs,1628971,158,Bruce Brown,1610612765,DET,4,57,5,14,0.357,1,5,0.2,2,2,1.0,1,7,8,2,2,1,2,8,13,15,1.0,1.0,2018,19,3.25,1.0,9,0,9,0.8888888888888888
2018-19,Playoffs,202700,158,Donatas Motiejunas,1610612759,SAS,5,19,6,10,0.6,0,1,0.0,1,2,0.5,3,4,7,2,0,0,0,1,13,17,0.0,0.0,2018,19,2.6,inf,4,1,5,1.4
2018-19,Playoffs,203922,158,Glenn Robinson III,1610612765,DET,3,36,4,15,0.267,1,8,0.125,4,4,1.0,2,5,7,2,2,0,1,5,13,12,2.0,2.0,2018,19,4.333333333333333,2.0,11,0,11,0.6363636363636364
2018-19,Playoffs,1628400,158,Semi Ojeleye,1610612738,BOS,6,35,4,9,0.444,3,5,0.6,2,2,1.0,1,1,2,2,0,0,1,5,13,11,2.0,0.0,2018,19,2.1666666666666665,2.0,5,0,5,0.4
2018-19,Playoffs,1628464,162,Daniel Theis,1610612738,BOS,7,42,5,14,0.357,0,2,0.0,2,2,1.0,4,6,10,0,1,1,1,4,12,14,0.0,1.0,2018,19,1.7142857142857142,0.0,9,0,9,1.1111111111111112
2018-19,Playoffs,201162,162,Jared Dudley,1610612751,BKN,4,82,3,11,0.273,2,9,0.222,4,4,1.0,0,2,2,11,3,1,4,10,12,17,2.75,0.75,2018,19,3.0,2.75,8,0,8,0.25
2018-19,Playoffs,101109,164,Raymond Felton,1610612760,OKC,5,57,4,13,0.308,2,8,0.25,1,2,0.5,0,3,3,3,4,1,2,7,11,10,1.5,2.0,2018,19,2.2,1.5,9,1,10,0.3
2018-19,Playoffs,202954,165,Brad Wanamaker,1610612738,BOS,4,17,3,7,0.429,1,1,1.0,3,4,0.75,0,0,0,3,2,0,2,0,10,8,1.5,1.0,2018,19,2.5,1.5,4,1,5,0.0
2018-19,Playoffs,1626185,165,Jarell Martin,1610612753,ORL,3,18,4,9,0.444,2,7,0.286,0,2,0.0,1,1,2,1,0,1,0,1,10,7,0.0,0.0,2018,19,3.3333333333333335,inf,5,2,7,0.2857142857142857
2018-19,Playoffs,2594,165,Kyle Korver,1610612762,UTA,4,30,3,8,0.375,2,6,0.333,2,3,0.667,1,4,5,0,0,0,1,6,10,8,0.0,0.0,2018,19,2.5,0.0,5,1,6,0.8333333333333334
2018-19,Playoffs,1628960,168,Grayson Allen,1610612762,UTA,2,14,2,7,0.286,0,3,0.0,5,7,0.714,0,1,1,0,0,0,0,0,9,3,0.0,0.0,2018,19,4.5,,5,2,7,0.14285714285714285
2018-19,Playoffs,202391,168,Jeremy Lin,1610612761,TOR,8,27,2,9,0.222,1,2,0.5,4,4,1.0,0,3,3,4,1,0,5,2,9,5,0.8,0.2,2018,19,1.125,0.8,7,0,7,0.42857142857142855
2018-19,Playoffs,1629033,168,Theo Pinson,1610612751,BKN,3,22,3,8,0.375,3,7,0.429,0,0,0.0,0,3,3,3,2,0,1,0,9,11,3.0,2.0,2018,19,3.0,3.0,5,0,5,0.6
2018-19,Playoffs,101161,171,Amir Johnson,1610612755,PHI,4,20,4,4,1.0,0,0,0.0,0,0,0.0,3,2,5,2,1,0,1,3,8,15,2.0,1.0,2018,19,2.0,2.0,0,0,0,inf
2018-19,Playoffs,1627824,171,Guerschon Yabusele,1610612738,BOS,4,14,2,4,0.5,0,1,0.0,4,7,0.571,1,1,2,1,0,1,1,3,8,6,1.0,0.0,2018,19,2.0,1.0,2,3,5,0.4
2018-19,Playoffs,1626259,171,Malcolm Miller,1610612761,TOR,10,28,2,8,0.25,1,6,0.167,3,4,0.75,0,5,5,1,0,1,1,3,8,7,1.0,0.0,2018,19,0.8,1.0,6,1,7,0.7142857142857143
2018-19,Playoffs,203935,174,Marcus Smart,1610612738,BOS,2,32,1,11,0.091,1,11,0.091,4,6,0.667,4,0,4,4,3,0,3,3,7,3,1.33,1.0,2018,19,3.5,1.3333333333333333,10,2,12,0.3333333333333333
2018-19,Playoffs,1626203,174,Treveon Graham,1610612751,BKN,5,79,2,10,0.2,0,7,0.0,3,6,0.5,2,8,10,3,3,1,3,10,7,10,1.0,1.0,2018,19,1.4,1.0,8,3,11,0.9090909090909091
2018-19,Playoffs,201967,176,Dante Cunningham,1610612759,SAS,5,13,2,3,0.667,2,2,1.0,0,0,0.0,2,4,6,0,0,0,0,0,6,11,0.0,0.0,2018,19,1.2,,1,0,1,6.0
2018-19,Playoffs,203926,176,Doug McDermott,1610612754,IND,3,29,2,10,0.2,0,7,0.0,2,4,0.5,3,2,5,4,0,1,0,2,6,6,0.0,0.0,2018,19,2.0,inf,8,2,10,0.5
2018-19,Playoffs,1629022,176,Lonnie Walker IV,1610612759,SAS,6,21,3,8,0.375,0,1,0.0,0,0,0.0,0,2,2,3,0,0,0,0,6,6,0.0,0.0,2018,19,1.0,inf,5,0,5,0.4
2018-19,Playoffs,1628988,179,Aaron Holiday,1610612754,IND,3,13,2,5,0.4,1,2,0.5,0,0,0.0,0,0,0,0,0,0,1,3,5,1,0.0,0.0,2018,19,1.6666666666666667,0.0,3,0,3,0.0
2018-19,Playoffs,1628449,179,Chris Boucher,1610612761,TOR,2,4,2,5,0.4,1,3,0.333,0,1,0.0,0,1,1,0,0,1,0,0,5,3,0.0,0.0,2018,19,2.5,,3,1,4,0.25
2018-19,Playoffs,1628980,179,Jacob Evans,1610612744,GSW,7,18,2,5,0.4,1,2,0.5,0,0,0.0,0,1,1,1,0,0,2,1,5,2,0.5,0.0,2018,19,0.7142857142857143,0.5,3,0,3,0.3333333333333333
2018-19,Playoffs,1627774,179,Jake Layman,1610612757,POR,6,20,1,7,0.143,0,5,0.0,3,4,0.75,1,3,4,0,0,0,0,3,5,2,0.0,0.0,2018,19,0.8333333333333334,,6,1,7,0.5714285714285714
2018-19,Playoffs,1626170,179,Jerian Grant,1610612753,ORL,3,14,2,10,0.2,0,7,0.0,1,1,1.0,0,4,4,3,0,0,1,1,5,3,3.0,0.0,2018,19,1.6666666666666667,3.0,8,0,8,0.5
2018-19,Playoffs,1628982,179,Melvin Frazier Jr.,1610612753,ORL,3,15,2,5,0.4,0,0,0.0,1,2,0.5,1,3,4,0,1,0,0,0,5,6,0.0,0.0,2018,19,1.6666666666666667,,3,1,4,1.0
2018-19,Playoffs,1627775,179,Patrick McCaw,1610612761,TOR,11,49,1,5,0.2,1,3,0.333,2,2,1.0,2,1,3,4,2,0,1,4,5,9,4.0,2.0,2018,19,0.45454545454545453,4.0,4,0,4,0.75
2018-19,Playoffs,1628414,179,Sindarius Thornwell,1610612746,LAC,4,12,2,6,0.333,1,3,0.333,0,0,0.0,0,4,4,0,1,0,0,2,5,6,0.0,0.0,2018,19,1.25,,4,0,4,1.0
2018-19,Playoffs,200757,179,Thabo Sefolosha,1610612762,UTA,4,42,2,14,0.143,1,8,0.125,0,0,0.0,1,7,8,2,0,0,1,3,5,2,2.0,0.0,2018,19,1.25,2.0,12,0,12,0.6666666666666666
2018-19,Playoffs,203503,179,Tony Snell,1610612749,MIL,9,28,2,6,0.333,1,2,0.5,0,0,0.0,2,1,3,0,1,1,1,3,5,5,0.0,1.0,2018,19,0.5555555555555556,0.0,4,0,4,0.75
2018-19,Playoffs,2585,179,Zaza Pachulia,1610612765,DET,2,22,2,6,0.333,0,0,0.0,1,2,0.5,1,8,9,0,0,0,1,3,5,8,0.0,0.0,2018,19,2.5,0.0,4,1,5,1.8
2018-19,Playoffs,1629014,190,Anfernee Simons,1610612757,POR,5,12,0,7,0.0,0,2,0.0,4,5,0.8,0,0,0,0,1,0,0,2,4,-3,0.0,0.0,2018,19,0.8,,7,1,8,0.0
2018-19,Playoffs,1629058,190,Dzanan Musa,1610612751,BKN,2,15,2,3,0.667,0,1,0.0,0,0,0.0,0,0,0,0,2,0,3,4,4,2,0.0,0.67,2018,19,2.0,0.0,1,0,1,0.0
2018-19,Playoffs,1628392,190,Isaiah Hartenstein,1610612745,HOU,2,2,2,2,1.0,0,0,0.0,0,0,0.0,1,0,1,0,0,0,0,1,4,5,0.0,0.0,2018,19,2.0,,0,0,0,inf
2018-19,Playoffs,1629057,190,Robert Williams III,1610612738,BOS,3,13,1,2,0.5,0,0,0.0,2,2,1.0,1,6,7,0,0,0,0,1,4,10,0.0,0.0,2018,19,1.3333333333333333,,1,0,1,7.0
2018-19,Playoffs,1627820,190,Tyrone Wallace,1610612746,LAC,2,11,1,4,0.25,0,0,0.0,2,3,0.667,0,1,1,3,0,0,1,2,4,3,3.0,0.0,2018,19,2.0,3.0,3,1,4,0.25
2018-19,Playoffs,1627745,195,Damian Jones,1610612744,GSW,4,8,1,1,1.0,0,0,0.0,1,2,0.5,0,2,2,0,0,0,1,3,3,3,0.0,0.0,2018,19,0.75,0.0,0,1,1,2.0
2018-19,Playoffs,1627823,195,Juancho Hernangomez,1610612743,DEN,5,15,1,3,0.333,1,2,0.5,0,0,0.0,0,3,3,0,0,0,1,2,3,3,0.0,0.0,2018,19,0.6,0.0,2,0,2,1.5
2018-19,Playoffs,1627846,197,Abdel Nader,1610612760,OKC,3,5,1,2,0.5,0,0,0.0,0,0,0.0,0,0,0,0,0,1,0,0,2,2,0.0,0.0,2018,19,0.6666666666666666,,1,0,1,0.0
2018-19,Playoffs,1629126,197,Deonte Burton,1610612760,OKC,3,4,1,5,0.2,0,2,0.0,0,0,0.0,1,1,2,0,0,0,0,0,2,0,0.0,0.0,2018,19,0.6666666666666666,,4,0,4,0.5
2018-19,Playoffs,203961,197,Eric Moreland,1610612761,TOR,8,28,1,2,0.5,0,0,0.0,0,0,0.0,2,12,14,3,0,0,0,5,2,18,0.0,0.0,2018,19,0.25,inf,1,0,1,14.0
2018-19,Playoffs,202720,197,Jon Leuer,1610612765,DET,1,5,1,2,0.5,0,0,0.0,0,1,0.0,0,0,0,0,0,0,0,1,2,0,0.0,0.0,2018,19,2.0,,1,1,2,0.0
2018-19,Playoffs,203526,197,Raul Neto,1610612762,UTA,3,20,1,6,0.167,0,1,0.0,0,0,0.0,0,3,3,1,0,0,0,2,2,1,0.0,0.0,2018,19,0.6666666666666666,inf,5,0,5,0.6
2018-19,Playoffs,1627746,197,Skal Labissiere,1610612757,POR,3,11,1,4,0.25,0,2,0.0,0,1,0.0,0,0,0,0,0,0,0,1,2,-2,0.0,0.0,2018,19,0.6666666666666666,,3,1,4,0.0
2018-19,Playoffs,1628388,197,T.J. Leaf,1610612754,IND,1,10,0,3,0.0,0,1,0.0,2,2,1.0,1,2,3,0,0,0,0,0,2,2,0.0,0.0,2018,19,2.0,,3,0,3,1.0
2018-19,Playoffs,1628410,204,Edmond Sumner,1610612754,IND,1,2,0,0,0.0,0,0,0.0,0,0,0.0,0,2,2,0,0,0,0,0,0,2,0.0,0.0,2018,19,0.0,,0,0,0,inf
2018-19,Playoffs,202327,204,Ekpe Udoh,1610612762,UTA,2,6,0,1,0.0,0,0,0.0,0,0,0.0,0,0,0,0,0,0,0,0,0,-1,0.0,0.0,2018,19,0.0,,1,0,1,0.0
2018-19,Playoffs,1629109,204,Gary Clark,1610612745,HOU,2,4,0,0,0.0,0,0,0.0,0,0,0.0,0,1,1,0,0,0,0,0,0,1,0.0,0.0,2018,19,0.0,,0,0,0,inf
2018-19,Playoffs,1629020,204,Jarred Vanderbilt,1610612743,DEN,3,5,0,0,0.0,0,0,0.0,0,0,0.0,0,1,1,0,0,1,0,0,0,2,0.0,0.0,2018,19,0.0,,0,0,0,inf
2018-19,Playoffs,101181,204,Jose Calderon,1610612765,DET,3,10,0,0,0.0,0,0,0.0,0,0,0.0,0,0,0,5,1,0,0,0,0,6,0.0,0.0,2018,19,0.0,inf,0,0,0,
2018-19,Playoffs,203124,204,Kyle O'Quinn,1610612754,IND,1,2,0,0,0.0,0,0,0.0,0,0,0.0,0,0,0,0,0,0,1,0,0,-1,0.0,0.0,2018,19,0.0,0.0,0,0,0,
2018-19,Playoffs,202347,204,Quincy Pondexter,1610612759,SAS,5,12,0,2,0.0,0,1,0.0,0,0,0.0,0,1,1,2,1,0,0,2,0,2,0.0,0.0,2018,19,0.0,inf,2,0,2,0.5
2018-19,Playoffs,1626168,204,Trey Lyles,1610612743,DEN,3,8,0,3,0.0,0,1,0.0,0,0,0.0,1,0,1,2,0,0,0,1,0,0,0.0,0.0,2018,19,0.0,inf,3,0,3,0.3333333333333333
2018-19,Playoffs,1629015,204,Zhaire Smith,1610612755,PHI,2,6,0,0,0.0,0,0,0.0,0,0,0.0,0,0,0,0,1,0,0,0,0,1,0.0,0.0,2018,19,0.0,,0,0,0,
2019-20,RegularSeason,201935,1,James Harden,1610612745,HOU,68,2483,672,1514,0.444,299,843,0.355,692,800,0.865,70,376,446,512,125,60,308,227,2335,2220,1.66,0.41,2019,20,34.338235294117645,1.6623376623376624,842,108,950,0.4694736842105263
2019-20,RegularSeason,203081,2,Damian Lillard,1610612757,POR,66,2474,624,1349,0.463,270,674,0.401,460,518,0.888,33,251,284,530,70,22,194,114,1978,1907,2.73,0.36,2019,20,29.96969696969697,2.731958762886598,725,58,783,0.36270753512132825
2019-20,RegularSeason,1626164,3,Devin Booker,1610612756,PHX,70,2512,627,1283,0.489,141,398,0.354,468,509,0.919,29,268,297,456,49,18,264,213,1863,1722,1.73,0.19,2019,20,26.614285714285714,1.7272727272727273,656,41,697,0.4261119081779053
2019-20,RegularSeason,203507,4,Giannis Antetokounmpo,1610612749,MIL,63,1917,685,1238,0.553,89,293,0.304,398,629,0.633,140,716,856,354,61,66,230,195,1857,2180,1.54,0.27,2019,20,29.476190476190474,1.5391304347826087,553,231,784,1.0918367346938775
2019-20,RegularSeason,1629027,5,Trae Young,1610612737,ATL,60,2120,546,1249,0.437,205,568,0.361,481,559,0.86,32,223,255,560,65,8,289,104,1778,1596,1.94,0.23,2019,20,29.633333333333333,1.9377162629757785,703,78,781,0.3265044814340589
2019-20,RegularSeason,1629029,6,Luka Doncic,1610612742,DAL,61,2047,581,1255,0.463,171,541,0.316,426,562,0.758,78,495,573,538,62,14,260,153,1759,1876,2.07,0.24,2019,20,28.83606557377049,2.0692307692307694,674,136,810,0.7074074074074074
2019-20,RegularSeason,203078,7,Bradley Beal,1610612764,WAS,57,2053,593,1303,0.455,170,481,0.353,385,457,0.842,52,190,242,347,71,23,194,126,1741,1448,1.79,0.37,2019,20,30.54385964912281,1.788659793814433,710,72,782,0.309462915601023
2019-20,RegularSeason,2544,8,LeBron James,1610612747,LAL,67,2316,643,1303,0.493,148,425,0.348,264,381,0.693,66,459,525,684,78,36,261,118,1698,1983,2.62,0.3,2019,20,25.34328358208955,2.6206896551724137,660,117,777,0.6756756756756757
2019-20,RegularSeason,1628378,9,Donovan Mitchell,1610612762,UTA,69,2364,602,1342,0.449,173,473,0.366,278,322,0.863,53,251,304,294,70,14,184,172,1655,1369,1.6,0.38,2019,20,23.985507246376812,1.5978260869565217,740,44,784,0.3877551020408163
2019-20,RegularSeason,203076,10,Anthony Davis,1610612747,LAL,62,2131,551,1096,0.503,72,218,0.33,444,525,0.846,142,435,577,200,91,143,154,156,1618,1849,1.3,0.59,2019,20,26.096774193548388,1.2987012987012987,545,81,626,0.9217252396166135
2019-20,RegularSeason,203468,11,CJ McCollum,1610612757,POR,70,2557,611,1356,0.451,194,512,0.379,140,185,0.757,46,251,297,310,54,42,127,183,1556,1342,2.44,0.42,2019,20,22.228571428571428,2.440944881889764,745,45,790,0.3759493670886076
2019-20,RegularSeason,201566,12,Russell Westbrook,1610612745,HOU,57,2049,604,1281,0.472,55,213,0.258,290,380,0.763,100,351,451,401,93,20,255,200,1553,1496,1.57,0.36,2019,20,27.24561403508772,1.572549019607843,677,90,767,0.5880052151238592
2019-20,RegularSeason,1628369,13,Jayson Tatum,1610612738,BOS,66,2265,552,1226,0.45,189,469,0.403,254,313,0.812,64,396,460,200,93,57,155,136,1547,1469,1.29,0.6,2019,20,23.439393939393938,1.2903225806451613,674,59,733,0.6275579809004093
2019-20,RegularSeason,202695,14,Kawhi Leonard,1610612746,LAC,57,1848,532,1133,0.47,123,325,0.378,356,402,0.886,54,348,402,280,103,33,149,113,1543,1565,1.88,0.69,2019,20,27.07017543859649,1.8791946308724832,601,46,647,0.6213292117465224
2019-20,RegularSeason,203897,15,Zach LaVine,1610612741,CHI,60,2085,539,1199,0.45,184,484,0.38,268,334,0.802,41,248,289,254,88,28,206,131,1530,1257,1.23,0.43,2019,20,25.5,1.233009708737864,660,66,726,0.39807162534435264
2019-20,RegularSeason,201942,16,DeMar DeRozan,1610612759,SAS,68,2316,557,1049,0.531,9,35,0.257,381,451,0.845,44,331,375,380,70,20,164,180,1504,1623,2.32,0.43,2019,20,22.11764705882353,2.317073170731707,492,70,562,0.6672597864768683
2019-20,RegularSeason,1627742,17,Brandon Ingram,1610612740,NOP,62,2103,507,1096,0.463,150,384,0.391,313,368,0.851,51,329,380,259,61,38,189,179,1477,1382,1.37,0.32,2019,20,23.822580645161292,1.3703703703703705,589,55,644,0.5900621118012422
2019-20,RegularSeason,203999,18,Nikola Jokic,1610612743,DEN,73,2335,565,1071,0.528,80,255,0.314,246,301,0.817,166,545,711,512,85,44,226,222,1456,2021,2.27,0.38,2019,20,19.945205479452056,2.265486725663717,506,55,561,1.267379679144385
2019-20,RegularSeason,202699,19,Tobias Harris,1610612755,PHI,72,2469,553,1173,0.471,131,357,0.367,174,216,0.806,69,426,495,227,53,40,104,165,1411,1460,2.18,0.51,2019,20,19.59722222222222,2.1826923076923075,620,42,662,0.7477341389728097
2019-20,RegularSeason,1627741,20,Buddy Hield,1610612758,SAC,72,2216,498,1162,0.429,271,688,0.394,115,136,0.846,57,271,328,213,66,17,168,165,1382,1153,1.27,0.39,2019,20,19.194444444444443,1.2678571428571428,664,21,685,0.47883211678832116
2019-20,RegularSeason,1627783,21,Pascal Siakam,1610612761,TOR,60,2110,500,1104,0.453,131,365,0.359,240,303,0.792,64,375,439,207,61,53,148,170,1371,1316,1.4,0.41,2019,20,22.85,1.3986486486486487,604,63,667,0.6581709145427287
2019-20,RegularSeason,1629012,22,Collin Sexton,1610612739,CLE,65,2143,513,1086,0.472,97,255,0.38,226,267,0.846,61,143,204,192,65,7,158,142,1349,1045,1.22,0.41,2019,20,20.753846153846155,1.2151898734177216,573,41,614,0.3322475570032573
2019-20,RegularSeason,1628983,23,Shai Gilgeous-Alexander,1610612760,OKC,70,2428,478,1015,0.471,87,251,0.347,288,357,0.807,47,365,412,232,79,47,134,117,1331,1361,1.73,0.59,2019,20,19.014285714285716,1.7313432835820894,537,69,606,0.6798679867986799
2019-20,RegularSeason,203933,24,T.J. Warren,1610612754,IND,67,2202,534,997,0.536,91,226,0.403,167,204,0.819,68,212,280,99,78,34,84,187,1326,1233,1.18,0.93,2019,20,19.791044776119403,1.1785714285714286,463,37,500,0.56
2019-20,RegularSeason,203915,25,Spencer Dinwiddie,1610612751,BKN,64,1994,424,1021,0.415,123,400,0.308,347,446,0.778,32,189,221,432,40,21,174,180,1318,1162,2.48,0.23,2019,20,20.59375,2.4827586206896552,597,99,696,0.3175287356321839
2019-20,RegularSeason,203114,26,Khris Middleton,1610612749,MIL,62,1853,471,947,0.497,147,354,0.415,208,227,0.916,44,338,382,265,53,7,137,142,1297,1372,1.93,0.39,2019,20,20.919354838709676,1.9343065693430657,476,19,495,0.7717171717171717
2019-20,RegularSeason,202711,27,Bojan Bogdanovic,1610612762,UTA,63,2083,418,935,0.447,189,457,0.414,250,277,0.903,39,220,259,131,34,7,159,110,1275,1003,0.82,0.21,2019,20,20.238095238095237,0.8238993710691824,517,27,544,0.47610294117647056
2019-20,RegularSeason,203944,28,Julius Randle,1610612752,NYK,64,2080,463,1006,0.46,64,231,0.277,258,352,0.733,151,471,622,198,51,22,193,178,1248,1311,1.03,0.26,2019,20,19.5,1.0259067357512954,543,94,637,0.9764521193092621
2019-20,RegularSeason,101108,29,Chris Paul,1610612760,OKC,70,2208,434,887,0.489,111,304,0.365,253,279,0.907,26,323,349,472,111,11,161,158,1232,1535,2.93,0.69,2019,20,17.6,2.9316770186335406,453,26,479,0.7286012526096033
2019-20,RegularSeason,203471,30,Dennis Schroder,1610612760,OKC,65,1999,453,965,0.469,125,325,0.385,198,236,0.839,19,217,236,262,45,14,166,146,1229,1070,1.58,0.27,2019,20,18.907692307692308,1.5783132530120483,512,38,550,0.4290909090909091
2019-20,RegularSeason,203095,31,Evan Fournier,1610612753,ORL,66,2076,434,929,0.467,173,434,0.399,180,220,0.818,18,153,171,209,71,15,125,161,1221,1027,1.67,0.57,2019,20,18.5,1.672,495,40,535,0.31962616822429907
2019-20,RegularSeason,202696,32,Nikola Vucevic,1610612753,ORL,62,1998,493,1033,0.477,98,289,0.339,131,167,0.784,140,533,673,222,54,47,88,135,1215,1547,2.52,0.61,2019,20,19.596774193548388,2.522727272727273,540,36,576,1.1684027777777777
2019-20,RegularSeason,1629630,33,Ja Morant,1610612763,MEM,67,2074,447,937,0.477,60,179,0.335,239,308,0.776,51,208,259,488,58,18,220,110,1193,1237,2.22,0.26,2019,20,17.80597014925373,2.2181818181818183,490,69,559,0.46332737030411447
2019-20,RegularSeason,101150,34,Lou Williams,1610612746,LAC,65,1864,391,936,0.418,111,315,0.352,292,339,0.861,31,170,201,365,43,12,182,80,1185,1032,2.0,0.24,2019,20,18.23076923076923,2.0054945054945055,545,47,592,0.33952702702702703
2019-20,RegularSeason,1628415,35,Dillon Brooks,1610612763,MEM,73,2112,435,1068,0.407,147,411,0.358,164,203,0.808,68,175,243,150,63,27,124,278,1181,868,1.21,0.51,2019,20,16.17808219178082,1.2096774193548387,633,39,672,0.36160714285714285
2019-20,RegularSeason,203952,36,Andrew Wiggins,1610612744,GSW,54,1859,437,978,0.447,111,334,0.332,190,268,0.709,66,208,274,198,45,53,132,127,1175,994,1.5,0.34,2019,20,21.75925925925926,1.5,541,78,619,0.44264943457189015
2019-20,RegularSeason,1626149,37,Montrezl Harrell,1610612746,LAC,63,1749,471,812,0.58,0,18,0.0,231,351,0.658,163,282,445,107,39,72,108,146,1173,1267,0.99,0.36,2019,20,18.61904761904762,0.9907407407407407,341,120,461,0.96529284164859
2019-20,RegularSeason,203954,38,Joel Embiid,1610612755,PHI,51,1506,382,801,0.477,57,172,0.331,351,435,0.807,141,452,593,152,45,65,159,174,1172,1365,0.96,0.28,2019,20,22.980392156862745,0.9559748427672956,419,84,503,1.1789264413518887
2019-20,RegularSeason,201950,39,Jrue Holiday,1610612740,NOP,61,2117,458,1006,0.455,122,346,0.353,129,182,0.709,77,216,293,408,99,48,184,145,1167,1230,2.22,0.54,2019,20,19.131147540983605,2.217391304347826,548,53,601,0.4875207986688852
2019-20,RegularSeason,204001,40,Kristaps Porzingis,1610612742,DAL,57,1814,398,932,0.427,142,403,0.352,226,283,0.799,100,440,540,102,41,115,92,185,1164,1279,1.11,0.45,2019,20,20.42105263157895,1.108695652173913,534,57,591,0.9137055837563451
2019-20,RegularSeason,201568,41,Danilo Gallinari,1610612760,OKC,62,1834,358,817,0.438,178,439,0.405,266,298,0.893,34,288,322,119,42,5,76,75,1160,1081,1.57,0.55,2019,20,18.70967741935484,1.5657894736842106,459,32,491,0.6558044806517311
2019-20,RegularSeason,1627759,42,Jaylen Brown,1610612738,BOS,57,1934,427,887,0.481,129,338,0.382,176,243,0.724,62,302,364,118,65,20,125,167,1159,1074,0.94,0.52,2019,20,20.333333333333332,0.944,460,67,527,0.6907020872865275
2019-20,RegularSeason,202710,43,Jimmy Butler,1610612748,MIA,58,1959,345,758,0.455,29,119,0.244,438,525,0.834,106,280,386,350,103,32,127,81,1157,1401,2.76,0.81,2019,20,19.948275862068964,2.7559055118110236,413,87,500,0.772
2019-20,RegularSeason,1627734,44,Domantas Sabonis,1610612754,IND,62,2159,458,848,0.54,17,67,0.254,214,296,0.723,189,582,771,310,47,30,170,195,1147,1663,1.82,0.28,2019,20,18.5,1.8235294117647058,390,82,472,1.6334745762711864
2019-20,RegularSeason,1628389,45,Bam Adebayo,1610612748,MIA,72,2417,440,790,0.557,2,14,0.143,264,382,0.691,176,559,735,368,82,93,204,182,1146,1752,1.8,0.4,2019,20,15.916666666666666,1.803921568627451,350,118,468,1.5705128205128205
2019-20,RegularSeason,1628984,46,Devonte' Graham,1610612766,CHA,63,2211,368,963,0.382,218,585,0.373,191,233,0.82,42,170,212,471,62,15,181,115,1145,1087,2.6,0.34,2019,20,18.174603174603174,2.6022099447513813,595,42,637,0.3328100470957614
2019-20,RegularSeason,202689,46,Kemba Walker,1610612738,BOS,56,1742,378,889,0.425,180,473,0.381,209,242,0.864,36,181,217,268,48,28,117,91,1145,1045,2.29,0.41,2019,20,20.446428571428573,2.2905982905982905,511,33,544,0.39889705882352944
2019-20,RegularSeason,1626179,48,Terry Rozier,1610612766,CHA,63,2165,398,941,0.423,172,423,0.407,166,190,0.874,50,226,276,259,61,10,141,126,1134,1032,1.84,0.43,2019,20,18.0,1.8368794326241136,543,24,567,0.48677248677248675
2019-20,RegularSeason,200768,49,Kyle Lowry,1610612761,TOR,58,2098,334,803,0.416,164,466,0.352,294,343,0.857,32,260,292,433,82,26,178,190,1126,1263,2.43,0.46,2019,20,19.413793103448278,2.432584269662921,469,49,518,0.5637065637065637
2019-20,RegularSeason,203501,50,Tim Hardaway Jr.,1610612742,DAL,71,2091,384,884,0.434,204,513,0.398,149,182,0.819,25,207,232,137,41,5,69,125,1121,934,1.99,0.59,2019,20,15.788732394366198,1.9855072463768115,500,33,533,0.4352720450281426
2019-20,RegularSeason,1627750,51,Jamal Murray,1610612743,DEN,59,1904,408,894,0.456,112,324,0.346,163,185,0.881,45,191,236,284,67,17,127,102,1091,1060,2.24,0.53,2019,20,18.491525423728813,2.236220472440945,486,22,508,0.4645669291338583
2019-20,RegularSeason,203903,52,Jordan Clarkson,1610612762,UTA,71,1705,394,867,0.454,152,413,0.368,138,165,0.836,50,137,187,136,46,16,97,108,1078,866,1.4,0.47,2019,20,15.183098591549296,1.402061855670103,473,27,500,0.374
2019-20,RegularSeason,1628368,53,De'Aaron Fox,1610612758,SAC,51,1634,391,815,0.48,54,185,0.292,241,342,0.705,35,161,196,348,74,25,158,145,1077,1037,2.2,0.47,2019,20,21.11764705882353,2.2025316455696204,424,101,525,0.37333333333333335
2019-20,RegularSeason,203084,54,Harrison Barnes,1610612758,SAC,72,2482,365,793,0.46,102,268,0.381,214,267,0.801,77,278,355,159,43,12,88,93,1046,1046,1.81,0.49,2019,20,14.527777777777779,1.8068181818181819,428,53,481,0.738045738045738
2019-20,RegularSeason,1626162,54,Kelly Oubre Jr.,1610612756,PHX,56,1933,373,826,0.452,108,307,0.352,192,246,0.78,67,294,361,85,71,40,83,192,1046,1013,1.02,0.85,2019,20,18.678571428571427,1.0240963855421688,453,54,507,0.7120315581854043
2019-20,RegularSeason,202685,56,Jonas Valanciunas,1610612763,MEM,70,1845,432,739,0.585,32,91,0.352,148,200,0.74,213,575,788,131,30,76,127,185,1044,1583,1.03,0.24,2019,20,14.914285714285715,1.031496062992126,307,52,359,2.1949860724233985
2019-20,RegularSeason,202355,57,Hassan Whiteside,1610612757,POR,67,2008,436,702,0.621,4,7,0.571,164,239,0.686,258,647,905,78,26,196,120,196,1040,1784,0.65,0.22,2019,20,15.522388059701493,0.65,266,75,341,2.653958944281525
2019-20,RegularSeason,1626156,58,D'Angelo Russell,1610612750,MIN,45,1452,360,846,0.426,158,431,0.367,161,199,0.809,17,160,177,285,48,13,147,86,1039,891,1.94,0.33,2019,20,23.08888888888889,1.9387755102040816,486,38,524,0.3377862595419847
2019-20,RegularSeason,202694,59,Marcus Morris Sr.,1610612746,LAC,62,1936,355,810,0.438,142,348,0.408,181,220,0.823,59,252,311,86,47,30,97,180,1033,916,0.89,0.48,2019,20,16.661290322580644,0.8865979381443299,455,39,494,0.6295546558704453
2019-20,RegularSeason,202331,59,Paul George,1610612746,LAC,48,1419,343,782,0.439,157,381,0.412,190,217,0.876,24,248,272,185,68,20,125,113,1033,987,1.48,0.54,2019,20,21.520833333333332,1.48,439,27,466,0.5836909871244635
2019-20,RegularSeason,203497,61,Rudy Gobert,1610612762,UTA,68,2333,386,557,0.693,0,0,0.0,254,403,0.63,230,686,916,101,51,135,130,215,1026,1779,0.78,0.39,2019,20,15.088235294117647,0.7769230769230769,171,149,320,2.8625
2019-20,RegularSeason,1629134,62,Kendrick Nunn,1610612748,MIA,67,1962,401,914,0.439,137,391,0.35,85,100,0.85,21,159,180,220,56,15,114,152,1024,853,1.93,0.49,2019,20,15.283582089552239,1.9298245614035088,513,15,528,0.3409090909090909
2019-20,RegularSeason,203082,63,Terrence Ross,1610612753,ORL,69,1889,341,846,0.403,177,504,0.351,157,184,0.853,13,209,222,82,77,24,70,109,1016,819,1.17,1.1,2019,20,14.72463768115942,1.1714285714285715,505,27,532,0.41729323308270677
2019-20,RegularSeason,203083,64,Andre Drummond,1610612739,CLE,57,1878,418,784,0.533,5,35,0.143,169,294,0.575,250,614,864,152,109,93,203,201,1010,1534,0.75,0.54,2019,20,17.719298245614034,0.7487684729064039,366,125,491,1.759674134419552
2019-20,RegularSeason,200746,65,LaMarcus Aldridge,1610612759,SAS,53,1754,391,793,0.493,61,157,0.389,158,191,0.827,103,289,392,129,36,87,74,128,1001,1136,1.74,0.49,2019,20,18.88679245283019,1.7432432432432432,402,33,435,0.9011494252873563
2019-20,RegularSeason,203925,66,Joe Harris,1610612751,BKN,69,2123,381,784,0.486,172,406,0.424,64,89,0.719,64,234,298,144,41,17,104,159,998,966,1.39,0.39,2019,20,14.46376811594203,1.3846153846153846,403,25,428,0.6962616822429907
2019-20,RegularSeason,202692,67,Alec Burks,1610612755,PHI,66,1754,321,768,0.418,116,301,0.385,235,265,0.887,48,234,282,189,62,17,91,128,993,975,2.08,0.68,2019,20,15.045454545454545,2.076923076923077,447,30,477,0.5911949685534591
2019-20,RegularSeason,1628991,68,Jaren Jackson Jr.,1610612763,MEM,57,1622,353,753,0.469,145,368,0.394,139,186,0.747,55,207,262,78,40,92,99,232,990,916,0.79,0.4,2019,20,17.36842105263158,0.7878787878787878,400,47,447,0.5861297539149888
2019-20,RegularSeason,201567,69,Kevin Love,1610612739,CLE,56,1780,327,727,0.45,146,390,0.374,187,219,0.854,54,493,547,178,33,19,140,90,987,1192,1.27,0.24,2019,20,17.625,1.2714285714285714,400,32,432,1.2662037037037037
2019-20,RegularSeason,1629130,70,Duncan Robinson,1610612748,MIA,73,2166,323,687,0.47,270,606,0.446,67,72,0.931,10,222,232,102,35,19,70,193,983,932,1.46,0.5,2019,20,13.465753424657533,1.457142857142857,364,5,369,0.6287262872628726
2019-20,RegularSeason,201609,71,Goran Dragic,1610612748,MIA,59,1663,319,724,0.441,124,338,0.367,191,246,0.776,29,158,187,301,40,10,144,124,953,887,2.09,0.28,2019,20,16.152542372881356,2.0902777777777777,405,55,460,0.40652173913043477
2019-20,RegularSeason,1627832,72,Fred VanVleet,1610612761,TOR,54,1928,319,773,0.413,146,374,0.39,168,198,0.848,18,185,203,357,100,17,121,132,952,1024,2.95,0.83,2019,20,17.62962962962963,2.950413223140496,454,30,484,0.4194214876033058
2019-20,RegularSeason,1627732,73,Ben Simmons,1610612755,PHI,57,2017,375,647,0.58,2,7,0.286,185,298,0.621,113,331,444,455,119,33,200,186,937,1403,2.27,0.59,2019,20,16.43859649122807,2.275,272,113,385,1.1532467532467532
2019-20,RegularSeason,1626157,74,Karl-Anthony Towns,1610612750,MIN,35,1187,316,622,0.508,114,277,0.412,180,226,0.796,95,283,378,153,33,42,110,117,926,1070,1.39,0.3,2019,20,26.457142857142856,1.3909090909090909,306,46,352,1.0738636363636365
2019-20,RegularSeason,203992,75,Bogdan Bogdanovic,1610612758,SAC,61,1766,337,766,0.44,164,441,0.372,86,116,0.741,26,181,207,207,64,15,102,133,924,856,2.03,0.63,2019,20,15.147540983606557,2.0294117647058822,429,30,459,0.45098039215686275
2019-20,RegularSeason,200755,76,JJ Redick,1610612740,NOP,60,1581,286,631,0.453,180,397,0.453,165,185,0.892,10,141,151,119,20,10,75,96,917,777,1.59,0.27,2019,20,15.283333333333333,1.5866666666666667,345,20,365,0.4136986301369863
2019-20,RegularSeason,202339,77,Eric Bledsoe,1610612749,MIL,61,1646,334,703,0.475,74,215,0.344,169,214,0.79,43,239,282,328,57,26,148,128,911,1042,2.22,0.39,2019,20,14.934426229508198,2.2162162162162162,369,45,414,0.6811594202898551
2019-20,RegularSeason,202330,78,Gordon Hayward,1610612738,BOS,52,1740,350,700,0.5,85,222,0.383,124,145,0.855,55,293,348,212,38,22,96,96,909,1062,2.21,0.4,2019,20,17.48076923076923,2.2083333333333335,350,21,371,0.9380053908355795
2019-20,RegularSeason,201565,79,Derrick Rose,1610612765,DET,50,1298,369,753,0.49,45,147,0.306,121,139,0.871,27,94,121,278,40,16,126,49,904,831,2.21,0.32,2019,20,18.08,2.2063492063492065,384,18,402,0.3009950248756219
2019-20,RegularSeason,2546,80,Carmelo Anthony,1610612757,POR,58,1902,336,782,0.43,87,226,0.385,136,161,0.845,71,297,368,85,49,27,100,171,895,853,0.85,0.49,2019,20,15.431034482758621,0.85,446,25,471,0.7813163481953291
2019-20,RegularSeason,203932,81,Aaron Gordon,1610612753,ORL,62,2017,335,767,0.437,73,237,0.308,151,224,0.674,107,368,475,228,51,39,100,125,894,1082,2.28,0.51,2019,20,14.419354838709678,2.28,432,73,505,0.9405940594059405
2019-20,RegularSeason,1627763,82,Malcolm Brogdon,1610612754,IND,54,1666,326,744,0.438,75,230,0.326,166,186,0.892,46,216,262,381,35,10,131,98,893,1012,2.91,0.27,2019,20,16.537037037037038,2.9083969465648853,418,20,438,0.5981735159817352
2019-20,RegularSeason,1628381,83,John Collins,1610612737,ATL,41,1363,353,605,0.583,59,147,0.401,120,150,0.8,116,300,416,60,31,66,75,138,885,1101,0.8,0.41,2019,20,21.585365853658537,0.8,252,30,282,1.475177304964539
2019-20,RegularSeason,203115,84,Will Barton,1610612743,DEN,58,1916,332,738,0.45,108,288,0.375,102,133,0.767,76,289,365,212,61,29,88,121,874,1016,2.41,0.69,2019,20,15.068965517241379,2.409090909090909,406,31,437,0.8352402745995423
2019-20,RegularSeason,1628365,85,Markelle Fultz,1610612753,ORL,72,1996,359,772,0.465,36,135,0.267,116,159,0.73,41,197,238,369,90,11,147,142,870,975,2.51,0.61,2019,20,12.083333333333334,2.510204081632653,413,43,456,0.5219298245614035
2019-20,RegularSeason,203496,85,Robert Covington,1610612745,HOU,70,2137,305,723,0.422,161,480,0.335,99,124,0.798,63,400,463,88,115,93,103,220,870,1083,0.85,1.12,2019,20,12.428571428571429,0.8543689320388349,418,25,443,1.0451467268623025
2019-20,RegularSeason,1629632,87,Coby White,1610612741,CHI,65,1674,312,792,0.394,133,376,0.354,102,129,0.791,28,202,230,175,49,6,109,117,859,703,1.61,0.45,2019,20,13.215384615384615,1.6055045871559632,480,27,507,0.4536489151873767
2019-20,RegularSeason,203924,88,Jerami Grant,1610612743,DEN,71,1892,303,634,0.478,98,252,0.389,147,196,0.75,58,190,248,88,50,57,63,154,851,851,1.4,0.79,2019,20,11.985915492957746,1.3968253968253967,331,49,380,0.6526315789473685
2019-20,RegularSeason,201937,89,Ricky Rubio,1610612756,PHX,65,2016,287,692,0.415,78,216,0.361,195,226,0.863,46,258,304,570,94,11,173,167,847,1217,3.29,0.54,2019,20,13.03076923076923,3.2947976878612715,405,31,436,0.6972477064220184
2019-20,RegularSeason,201586,90,Serge Ibaka,1610612761,TOR,55,1485,343,670,0.512,70,182,0.385,89,124,0.718,114,338,452,77,28,46,109,153,845,977,0.71,0.26,2019,20,15.363636363636363,0.7064220183486238,327,35,362,1.2486187845303867
2019-20,RegularSeason,1628970,91,Miles Bridges,1610612766,CHA,65,1996,319,753,0.424,99,300,0.33,106,131,0.809,88,274,362,114,40,48,95,132,843,853,1.2,0.42,2019,20,12.96923076923077,1.2,434,25,459,0.7886710239651417
2019-20,RegularSeason,1627747,92,Caris LeVert,1610612751,BKN,45,1330,311,732,0.425,80,220,0.364,140,197,0.711,49,140,189,199,53,10,118,81,842,697,1.69,0.45,2019,20,18.711111111111112,1.6864406779661016,421,57,478,0.39539748953974896
2019-20,RegularSeason,1629672,93,Eric Paschall,1610612744,GSW,60,1654,318,640,0.497,37,129,0.287,164,212,0.774,82,193,275,127,32,13,94,125,837,820,1.35,0.34,2019,20,13.95,1.351063829787234,322,48,370,0.7432432432432432
2019-20,RegularSeason,202722,94,Dāvis Bertāns,1610612764,WAS,54,1583,265,610,0.434,200,472,0.424,104,122,0.852,35,210,245,92,37,33,59,139,834,819,1.56,0.63,2019,20,15.444444444444445,1.5593220338983051,345,18,363,0.6749311294765841
2019-20,RegularSeason,202357,95,Nemanja Bjelica,1610612758,SAC,72,2011,314,653,0.481,134,320,0.419,69,84,0.821,111,347,458,203,62,40,99,216,831,1141,2.05,0.63,2019,20,11.541666666666666,2.0505050505050506,339,15,354,1.2937853107344632
2019-20,RegularSeason,1626181,96,Norman Powell,1610612761,TOR,52,1479,296,598,0.495,109,273,0.399,129,153,0.843,26,164,190,91,60,21,77,108,830,789,1.18,0.78,2019,20,15.961538461538462,1.1818181818181819,302,24,326,0.5828220858895705
2019-20,RegularSeason,201572,97,Brook Lopez,1610612749,MIL,68,1817,292,671,0.435,102,325,0.314,127,152,0.836,58,254,312,99,46,163,70,163,813,959,1.41,0.66,2019,20,11.955882352941176,1.4142857142857144,379,25,404,0.7722772277227723
2019-20,RegularSeason,1626174,98,Christian Wood,1610612765,DET,62,1325,288,508,0.567,54,140,0.386,180,242,0.744,104,286,390,60,34,54,84,98,810,982,0.71,0.41,2019,20,13.064516129032258,0.7142857142857143,220,62,282,1.3829787234042554
2019-20,RegularSeason,1629628,99,RJ Barrett,1610612752,NYK,56,1704,292,727,0.402,63,197,0.32,156,254,0.614,50,229,279,143,55,17,124,122,803,640,1.15,0.44,2019,20,14.339285714285714,1.153225806451613,435,98,533,0.5234521575984991
2019-20,RegularSeason,201143,100,Al Horford,1610612755,PHI,67,2026,319,709,0.45,99,283,0.35,61,80,0.763,103,353,456,270,52,61,80,142,798,1148,3.38,0.65,2019,20,11.91044776119403,3.375,390,19,409,1.114914425427873
2019-20,RegularSeason,203552,101,Seth Curry,1610612742,DAL,64,1576,284,574,0.495,145,321,0.452,80,97,0.825,27,118,145,124,38,9,62,113,793,740,2.0,0.61,2019,20,12.390625,2.0,290,17,307,0.4723127035830619
2019-20,RegularSeason,1628398,102,Kyle Kuzma,1610612747,LAL,61,1526,291,668,0.436,86,272,0.316,114,155,0.735,52,221,273,80,28,26,91,126,782,680,0.88,0.31,2019,20,12.819672131147541,0.8791208791208791,377,41,418,0.65311004784689
2019-20,RegularSeason,1629631,103,De'Andre Hunter,1610612737,ATL,63,2018,280,683,0.41,108,304,0.355,110,144,0.764,44,242,286,112,44,18,103,182,778,698,1.09,0.43,2019,20,12.34920634920635,1.087378640776699,403,34,437,0.6544622425629291
2019-20,RegularSeason,203935,104,Marcus Smart,1610612738,BOS,60,1919,256,682,0.375,137,395,0.347,127,152,0.836,42,183,225,291,101,29,103,162,776,868,2.83,0.98,2019,20,12.933333333333334,2.825242718446602,426,25,451,0.49889135254988914
2019-20,RegularSeason,1628386,105,Jarrett Allen,1610612751,BKN,70,1852,302,465,0.649,0,6,0.0,171,270,0.633,216,455,671,110,40,92,77,162,775,1349,1.43,0.52,2019,20,11.071428571428571,1.4285714285714286,163,99,262,2.5610687022900764
2019-20,RegularSeason,1627752,106,Taurean Prince,1610612751,BKN,64,1857,278,739,0.376,146,431,0.339,71,89,0.798,50,331,381,116,57,25,127,159,773,746,0.91,0.45,2019,20,12.078125,0.9133858267716536,461,18,479,0.7954070981210856
2019-20,RegularSeason,201988,107,Patty Mills,1610612759,SAS,66,1485,258,598,0.431,154,403,0.382,97,112,0.866,22,86,108,118,53,6,54,105,767,643,2.19,0.98,2019,20,11.621212121212121,2.185185185185185,340,15,355,0.30422535211267604
2019-20,RegularSeason,1628401,108,Derrick White,1610612759,SAS,68,1677,253,552,0.458,79,216,0.366,180,211,0.853,35,188,223,241,44,59,89,152,765,913,2.71,0.49,2019,20,11.25,2.707865168539326,299,31,330,0.6757575757575758
2019-20,RegularSeason,1626196,109,Josh Richardson,1610612755,PHI,55,1693,278,646,0.43,85,249,0.341,114,141,0.809,41,133,174,162,52,36,104,136,755,680,1.56,0.5,2019,20,13.727272727272727,1.5576923076923077,368,27,395,0.44050632911392407
2019-20,RegularSeason,1626167,110,Myles Turner,1610612754,IND,62,1826,268,587,0.457,86,250,0.344,127,169,0.751,86,321,407,72,46,132,85,166,749,960,0.85,0.54,2019,20,12.080645161290322,0.8470588235294118,319,42,361,1.1274238227146813
2019-20,RegularSeason,1628366,111,Lonzo Ball,1610612740,NOP,63,2025,277,687,0.403,148,395,0.375,43,76,0.566,71,312,383,438,88,38,193,128,745,1056,2.27,0.46,2019,20,11.825396825396826,2.2694300518134716,410,33,443,0.8645598194130926
2019-20,RegularSeason,1629639,112,Tyler Herro,1610612748,MIA,55,1508,270,631,0.428,116,298,0.389,87,100,0.87,16,208,224,121,34,9,87,76,743,670,1.39,0.39,2019,20,13.50909090909091,1.3908045977011494,361,13,374,0.5989304812834224
2019-20,RegularSeason,202397,113,Ish Smith,1610612764,WAS,68,1787,308,689,0.447,62,169,0.367,62,86,0.721,30,189,219,334,59,30,95,106,740,882,3.52,0.62,2019,20,10.882352941176471,3.5157894736842104,381,24,405,0.5407407407407407
2019-20,RegularSeason,1628374,114,Lauri Markkanen,1610612741,CHI,50,1492,251,591,0.425,109,317,0.344,126,153,0.824,60,253,313,74,42,23,81,96,737,741,0.91,0.52,2019,20,14.74,0.9135802469135802,340,27,367,0.8528610354223434
2019-20,RegularSeason,1628384,115,OG Anunoby,1610612761,TOR,69,2066,286,566,0.505,89,228,0.39,72,102,0.706,80,284,364,108,96,45,79,167,733,957,1.37,1.22,2019,20,10.623188405797102,1.3670886075949367,280,30,310,1.1741935483870967
2019-20,RegularSeason,1629636,116,Darius Garland,1610612739,CLE,59,1824,280,699,0.401,105,296,0.355,63,72,0.875,27,84,111,229,42,4,151,92,728,535,1.52,0.28,2019,20,12.338983050847459,1.5165562913907285,419,9,428,0.25934579439252337
2019-20,RegularSeason,203922,117,Glenn Robinson III,1610612755,PHI,62,1786,288,592,0.486,77,197,0.391,74,86,0.86,81,189,270,96,54,16,55,100,727,792,1.75,0.98,2019,20,11.725806451612904,1.7454545454545454,304,12,316,0.8544303797468354
2019-20,RegularSeason,200752,118,Rudy Gay,1610612759,SAS,67,1461,266,596,0.446,74,220,0.336,120,136,0.882,61,301,362,114,35,33,88,103,726,836,1.29,0.4,2019,20,10.835820895522389,1.2954545454545454,330,16,346,1.046242774566474
2019-20,RegularSeason,1627749,119,Dejounte Murray,1610612759,SAS,66,1687,294,637,0.462,41,111,0.369,91,114,0.798,69,314,383,271,111,17,125,143,720,1011,2.17,0.89,2019,20,10.909090909090908,2.168,343,23,366,1.046448087431694
2019-20,RegularSeason,1626224,120,Cedi Osman,1610612739,CLE,65,1910,266,609,0.437,123,321,0.383,63,94,0.67,39,192,231,154,54,16,91,160,718,708,1.69,0.59,2019,20,11.046153846153846,1.6923076923076923,343,31,374,0.6176470588235294
2019-20,RegularSeason,1628972,121,Troy Brown Jr.,1610612764,WAS,69,1782,273,622,0.439,61,179,0.341,109,139,0.784,76,307,383,178,85,7,79,132,716,911,2.25,1.08,2019,20,10.376811594202898,2.2531645569620253,349,30,379,1.0105540897097625
2019-20,RegularSeason,203463,122,Ben McLemore,1610612745,HOU,71,1619,242,545,0.444,181,452,0.4,50,67,0.746,21,136,157,58,45,16,50,155,715,621,1.16,0.9,2019,20,10.070422535211268,1.16,303,17,320,0.490625
2019-20,RegularSeason,203926,123,Doug McDermott,1610612754,IND,69,1372,267,547,0.488,128,294,0.435,48,58,0.828,26,148,174,78,12,5,42,117,710,647,1.86,0.29,2019,20,10.289855072463768,1.8571428571428572,280,10,290,0.6
2019-20,RegularSeason,1629023,123,P.J. Washington,1610612766,CHA,58,1759,268,589,0.455,86,230,0.374,88,136,0.647,58,258,316,123,51,44,93,158,710,782,1.32,0.55,2019,20,12.241379310344827,1.3225806451612903,321,48,369,0.8563685636856369
2019-20,RegularSeason,1627854,125,Bryn Forbes,1610612759,SAS,63,1579,242,581,0.417,148,381,0.388,75,90,0.833,12,114,126,108,33,0,57,113,707,563,1.9,0.58,2019,20,11.222222222222221,1.894736842105263,339,15,354,0.3559322033898305
2019-20,RegularSeason,204060,125,Joe Ingles,1610612762,UTA,72,2137,246,553,0.445,141,353,0.399,74,94,0.787,27,251,278,373,65,11,142,154,707,965,2.63,0.46,2019,20,9.819444444444445,2.6267605633802815,307,20,327,0.8501529051987767
2019-20,RegularSeason,203967,127,Dario Saric,1610612756,PHX,66,1632,256,538,0.476,84,235,0.357,108,128,0.844,100,306,406,123,37,16,88,156,704,896,1.4,0.42,2019,20,10.666666666666666,1.3977272727272727,282,20,302,1.3443708609271523
2019-20,RegularSeason,1627788,127,Furkan Korkmaz,1610612755,PHI,72,1559,242,563,0.43,143,356,0.402,77,102,0.755,18,150,168,79,41,16,59,98,704,603,1.34,0.69,2019,20,9.777777777777779,1.3389830508474576,321,25,346,0.48554913294797686
2019-20,RegularSeason,1629634,129,Brandon Clarke,1610612763,MEM,58,1300,296,479,0.618,23,64,0.359,85,112,0.759,92,253,345,81,32,48,55,100,700,941,1.47,0.58,2019,20,12.068965517241379,1.4727272727272727,183,27,210,1.6428571428571428
2019-20,RegularSeason,1629028,130,Deandre Ayton,1610612756,PHX,38,1236,310,568,0.546,3,13,0.231,67,89,0.753,147,289,436,72,26,58,80,117,690,922,0.9,0.33,2019,20,18.157894736842106,0.9,258,22,280,1.5571428571428572
2019-20,RegularSeason,203109,131,Jae Crowder,1610612748,MIA,65,1875,226,563,0.401,135,394,0.343,97,125,0.776,52,332,384,161,72,24,69,143,684,891,2.33,1.04,2019,20,10.523076923076923,2.3333333333333335,337,28,365,1.0520547945205478
2019-20,RegularSeason,1628989,131,Kevin Huerter,1610612737,ATL,56,1760,252,610,0.413,127,334,0.38,53,64,0.828,35,193,228,213,51,27,87,139,684,747,2.45,0.59,2019,20,12.214285714285714,2.4482758620689653,358,11,369,0.6178861788617886
2019-20,RegularSeason,203500,131,Steven Adams,1610612760,OKC,63,1681,283,478,0.592,1,3,0.333,117,201,0.582,207,376,583,146,51,67,94,122,684,1158,1.55,0.54,2019,20,10.857142857142858,1.553191489361702,195,84,279,2.089605734767025
2019-20,RegularSeason,202684,131,Tristan Thompson,1610612739,CLE,57,1722,288,562,0.512,9,23,0.391,99,161,0.615,226,351,577,120,33,50,103,124,684,1025,1.17,0.32,2019,20,12.0,1.1650485436893203,274,62,336,1.7172619047619047
2019-20,RegularSeason,1627827,135,Dorian Finney-Smith,1610612742,DAL,71,2120,243,522,0.466,114,303,0.376,78,108,0.722,145,260,405,114,45,39,69,178,678,903,1.65,0.65,2019,20,9.549295774647888,1.6521739130434783,279,30,309,1.3106796116504855
2019-20,RegularSeason,204038,136,Langston Galloway,1610612765,DET,66,1702,236,542,0.435,132,331,0.399,73,85,0.859,33,116,149,101,48,11,40,96,677,628,2.52,1.2,2019,20,10.257575757575758,2.525,306,12,318,0.46855345911949686
2019-20,RegularSeason,201144,137,Mike Conley,1610612762,UTA,47,1363,232,567,0.409,96,256,0.375,115,139,0.827,33,118,151,208,36,5,92,104,675,624,2.26,0.39,2019,20,14.361702127659575,2.260869565217391,335,24,359,0.4206128133704735
2019-20,RegularSeason,1628467,138,Maxi Kleber,1610612742,DAL,74,1890,237,514,0.461,119,319,0.373,79,93,0.849,112,276,388,88,25,83,58,176,672,907,1.52,0.43,2019,20,9.08108108108108,1.5172413793103448,277,14,291,1.3333333333333333
2019-20,RegularSeason,1626171,139,Bobby Portis,1610612752,NYK,66,1394,265,589,0.45,67,187,0.358,71,93,0.763,80,258,338,98,32,18,73,110,668,735,1.34,0.44,2019,20,10.121212121212121,1.3424657534246576,324,22,346,0.976878612716763
2019-20,RegularSeason,1628969,140,Mikal Bridges,1610612756,PHX,73,2042,247,484,0.51,70,194,0.361,103,122,0.844,66,226,292,129,102,46,73,163,667,907,1.77,1.4,2019,20,9.136986301369863,1.7671232876712328,237,19,256,1.140625
2019-20,RegularSeason,1627863,141,Danuel House Jr.,1610612745,HOU,63,1913,230,539,0.427,129,355,0.363,73,90,0.811,57,210,267,85,67,34,54,132,662,735,1.57,1.24,2019,20,10.507936507936508,1.5740740740740742,309,17,326,0.8190184049079755
2019-20,RegularSeason,1628420,142,Monte Morris,1610612743,DEN,73,1637,260,566,0.459,65,172,0.378,75,89,0.843,24,113,137,255,55,17,53,73,660,751,4.81,1.04,2019,20,9.04109589041096,4.811320754716981,306,14,320,0.428125
2019-20,RegularSeason,201152,143,Thaddeus Young,1610612741,CHI,64,1591,269,601,0.448,79,222,0.356,42,72,0.583,94,221,315,117,92,23,102,134,659,742,1.15,0.9,2019,20,10.296875,1.1470588235294117,332,30,362,0.8701657458563536
2019-20,RegularSeason,1628404,144,Josh Hart,1610612740,NOP,65,1755,225,532,0.423,121,354,0.342,85,115,0.739,61,364,425,108,63,23,75,160,656,863,1.44,0.84,2019,20,10.092307692307692,1.44,307,30,337,1.261127596439169
2019-20,RegularSeason,1629060,145,Rui Hachimura,1610612764,WAS,48,1444,254,545,0.466,25,87,0.287,116,140,0.829,78,216,294,87,37,8,53,105,649,707,1.64,0.7,2019,20,13.520833333333334,1.6415094339622642,291,24,315,0.9333333333333333
2019-20,RegularSeason,203484,146,Kentavious Caldwell-Pope,1610612747,LAL,69,1762,237,507,0.467,92,239,0.385,79,102,0.775,38,104,142,111,57,14,62,128,645,614,1.79,0.92,2019,20,9.347826086956522,1.7903225806451613,270,23,293,0.48464163822525597
2019-20,RegularSeason,203107,147,Tomas Satoransky,1610612741,CHI,65,1878,237,551,0.43,64,199,0.322,106,121,0.876,76,178,254,354,80,7,130,135,644,880,2.72,0.61,2019,20,9.907692307692308,2.723076923076923,314,15,329,0.7720364741641338
2019-20,RegularSeason,203469,148,Cody Zeller,1610612766,CHA,58,1341,251,479,0.524,18,75,0.24,122,179,0.682,160,251,411,88,40,25,75,140,642,846,1.17,0.53,2019,20,11.068965517241379,1.1733333333333333,228,57,285,1.4421052631578948
2019-20,RegularSeason,202066,149,Garrett Temple,1610612751,BKN,62,1730,222,587,0.378,127,386,0.329,70,87,0.805,29,189,218,156,49,29,62,108,641,649,2.52,0.79,2019,20,10.338709677419354,2.5161290322580645,365,17,382,0.5706806282722513
2019-20,RegularSeason,201952,149,Jeff Teague,1610612737,ATL,59,1464,213,489,0.436,43,117,0.368,172,197,0.873,27,115,142,308,44,19,116,106,641,737,2.65,0.38,2019,20,10.864406779661017,2.6551724137931036,276,25,301,0.4717607973421927
2019-20,RegularSeason,1628988,151,Aaron Holiday,1610612754,IND,66,1617,233,563,0.414,87,221,0.394,74,87,0.851,22,134,156,225,55,16,88,120,627,648,2.56,0.63,2019,20,9.5,2.5568181818181817,330,13,343,0.45481049562682213
2019-20,RegularSeason,1627814,152,Damion Lee,1610612744,GSW,49,1423,213,511,0.417,85,239,0.356,110,126,0.873,32,207,239,133,50,6,67,116,621,668,1.99,0.75,2019,20,12.673469387755102,1.9850746268656716,298,16,314,0.7611464968152867
2019-20,RegularSeason,1627736,153,Malik Beasley,1610612750,MIN,55,1209,227,534,0.425,107,276,0.388,54,66,0.818,18,130,148,75,40,8,57,77,615,510,1.32,0.7,2019,20,11.181818181818182,1.3157894736842106,307,12,319,0.46394984326018807
2019-20,RegularSeason,1629629,154,Cam Reddish,1610612737,ATL,58,1551,213,554,0.384,83,250,0.332,101,126,0.802,35,181,216,87,62,28,96,132,610,541,0.91,0.65,2019,20,10.517241379310345,0.90625,341,25,366,0.5901639344262295
2019-20,RegularSeason,1628978,154,Donte DiVincenzo,1610612749,MIL,66,1520,232,510,0.455,83,247,0.336,63,86,0.733,66,252,318,154,85,20,90,113,610,796,1.71,0.94,2019,20,9.242424242424242,1.711111111111111,278,23,301,1.0564784053156147
2019-20,RegularSeason,1628418,156,Thomas Bryant,1610612764,WAS,46,1147,243,418,0.581,37,91,0.407,86,116,0.741,98,233,331,83,25,49,53,103,609,839,1.57,0.47,2019,20,13.23913043478261,1.5660377358490567,175,30,205,1.6146341463414635
2019-20,RegularSeason,203200,157,Justin Holiday,1610612754,IND,73,1826,208,486,0.428,134,331,0.405,53,67,0.791,32,206,238,93,87,46,44,137,603,731,2.11,1.98,2019,20,8.26027397260274,2.1136363636363638,278,14,292,0.815068493150685
2019-20,RegularSeason,1628464,158,Daniel Theis,1610612738,BOS,65,1566,241,426,0.566,32,96,0.333,87,114,0.763,140,286,426,111,37,84,54,219,601,993,2.06,0.69,2019,20,9.246153846153845,2.0555555555555554,185,27,212,2.009433962264151
2019-20,RegularSeason,201571,159,D.J. Augustin,1610612753,ORL,57,1420,184,461,0.399,70,201,0.348,161,181,0.89,22,100,122,262,34,1,86,72,599,635,3.05,0.4,2019,20,10.508771929824562,3.046511627906977,277,20,297,0.4107744107744108
2019-20,RegularSeason,203145,160,Kent Bazemore,1610612758,SAC,68,1688,200,534,0.375,84,244,0.344,113,147,0.769,27,267,294,93,74,40,91,196,597,639,1.02,0.81,2019,20,8.779411764705882,1.021978021978022,334,34,368,0.7989130434782609
2019-20,RegularSeason,203085,161,Austin Rivers,1610612745,HOU,68,1594,211,501,0.421,96,270,0.356,78,111,0.703,27,148,175,113,49,10,50,129,596,570,2.26,0.98,2019,20,8.764705882352942,2.26,290,33,323,0.541795665634675
2019-20,RegularSeason,1627826,161,Ivica Zubac,1610612746,LAC,72,1326,236,385,0.613,0,2,0.0,124,166,0.747,197,346,543,82,16,66,61,168,596,1051,1.34,0.26,2019,20,8.277777777777779,1.3442622950819672,149,42,191,2.842931937172775
2019-20,RegularSeason,200794,163,Paul Millsap,1610612743,DEN,51,1240,211,438,0.482,54,124,0.435,115,141,0.816,98,195,293,83,44,30,70,150,591,718,1.19,0.63,2019,20,11.588235294117647,1.1857142857142857,227,26,253,1.158102766798419
2019-20,RegularSeason,1629011,164,Mitchell Robinson,1610612752,NYK,61,1412,253,341,0.742,0,0,0.0,84,148,0.568,186,242,428,36,52,119,37,194,590,1036,0.97,1.41,2019,20,9.672131147540984,0.972972972972973,88,64,152,2.8157894736842106
2019-20,RegularSeason,203914,165,Gary Harris,1610612743,DEN,56,1780,218,519,0.42,70,210,0.333,75,92,0.815,26,137,163,118,76,14,60,116,581,574,1.97,1.27,2019,20,10.375,1.9666666666666666,301,17,318,0.5125786163522013
2019-20,RegularSeason,1629633,166,Jarrett Culver,1610612750,MIN,63,1506,230,569,0.404,66,221,0.299,54,117,0.462,70,142,212,110,57,38,81,125,580,514,1.36,0.7,2019,20,9.206349206349206,1.3580246913580247,339,63,402,0.527363184079602
2019-20,RegularSeason,1629014,167,Anfernee Simons,1610612757,POR,70,1449,214,536,0.399,75,226,0.332,76,92,0.826,25,127,152,97,26,10,61,135,579,465,1.59,0.43,2019,20,8.271428571428572,1.5901639344262295,322,16,338,0.44970414201183434
2019-20,RegularSeason,203894,168,Shabazz Napier,1610612764,WAS,56,1345,188,456,0.412,76,240,0.317,126,153,0.824,26,132,158,262,69,11,128,101,578,655,2.05,0.54,2019,20,10.321428571428571,2.046875,268,27,295,0.535593220338983
2019-20,RegularSeason,203087,169,Jeremy Lamb,1610612754,IND,46,1291,216,479,0.451,53,158,0.335,92,110,0.836,24,176,200,96,55,22,50,104,577,619,1.92,1.1,2019,20,12.543478260869565,1.92,263,18,281,0.7117437722419929
2019-20,RegularSeason,1626204,170,Larry Nance Jr.,1610612739,CLE,56,1472,229,431,0.531,56,159,0.352,50,74,0.676,106,303,409,123,56,22,60,91,564,888,2.05,0.93,2019,20,10.071428571428571,2.05,202,24,226,1.8097345132743363
2019-20,RegularSeason,1628370,170,Malik Monk,1610612766,CHA,55,1169,212,488,0.434,58,204,0.284,82,100,0.82,27,130,157,114,25,16,77,74,564,505,1.48,0.33,2019,20,10.254545454545454,1.4805194805194806,276,18,294,0.5340136054421769
2019-20,RegularSeason,202693,172,Markieff Morris,1610612747,LAL,58,1188,203,458,0.443,88,228,0.386,66,85,0.776,40,178,218,77,31,17,76,133,560,553,1.01,0.41,2019,20,9.655172413793103,1.013157894736842,255,19,274,0.7956204379562044
2019-20,RegularSeason,201588,173,George Hill,1610612749,MIL,59,1271,194,376,0.516,81,176,0.46,85,101,0.842,50,127,177,180,47,5,57,84,554,708,3.16,0.82,2019,20,9.389830508474576,3.1578947368421053,182,16,198,0.8939393939393939
2019-20,RegularSeason,203482,174,Kelly Olynyk,1610612748,MIA,67,1300,184,398,0.462,95,234,0.406,86,100,0.86,44,261,305,116,45,23,71,173,549,739,1.63,0.63,2019,20,8.194029850746269,1.6338028169014085,214,14,228,1.337719298245614
2019-20,RegularSeason,202681,175,Kyrie Irving,1610612751,BKN,20,658,199,416,0.478,56,142,0.394,94,102,0.922,22,81,103,128,27,10,52,53,548,539,2.46,0.52,2019,20,27.4,2.4615384615384617,217,8,225,0.4577777777777778
2019-20,RegularSeason,1627737,175,Marquese Chriss,1610612744,GSW,59,1196,210,385,0.545,8,39,0.205,120,156,0.769,114,251,365,114,39,62,78,122,548,839,1.46,0.5,2019,20,9.288135593220339,1.4615384615384615,175,36,211,1.7298578199052133
2019-20,RegularSeason,201980,177,Danny Green,1610612747,LAL,68,1687,197,474,0.416,120,327,0.367,33,48,0.688,51,174,225,91,85,32,63,136,547,625,1.44,1.35,2019,20,8.044117647058824,1.4444444444444444,277,15,292,0.7705479452054794
2019-20,RegularSeason,203991,178,Clint Capela,1610612737,ATL,39,1279,244,388,0.629,0,0,0.0,55,104,0.529,168,369,537,48,33,72,63,102,543,977,0.76,0.52,2019,20,13.923076923076923,0.7619047619047619,144,49,193,2.7823834196891193
2019-20,RegularSeason,1629056,178,Terence Davis,1610612761,TOR,72,1209,199,436,0.456,94,242,0.388,51,59,0.864,50,187,237,115,39,14,76,124,543,627,1.51,0.51,2019,20,7.541666666666667,1.513157894736842,237,8,245,0.9673469387755103
2019-20,RegularSeason,1629018,180,Gary Trent Jr.,1610612757,POR,61,1332,196,441,0.444,112,268,0.418,37,45,0.822,25,75,100,61,48,16,21,90,541,492,2.9,2.29,2019,20,8.868852459016393,2.9047619047619047,245,8,253,0.3952569169960474
2019-20,RegularSeason,1629627,181,Zion Williamson,1610612740,NOP,24,668,210,360,0.583,6,14,0.429,114,178,0.64,64,86,150,50,16,9,59,42,540,492,0.85,0.27,2019,20,22.5,0.847457627118644,150,64,214,0.7009345794392523
2019-20,RegularSeason,1626158,182,Richaun Holmes,1610612758,SAC,44,1242,223,344,0.648,0,0,0.0,93,118,0.788,127,231,358,42,41,56,52,169,539,838,0.81,0.79,2019,20,12.25,0.8076923076923077,121,25,146,2.452054794520548
2019-20,RegularSeason,1629006,183,Josh Okogie,1610612750,MIN,62,1547,170,398,0.427,41,154,0.266,152,191,0.796,87,181,268,99,68,26,87,139,533,640,1.14,0.78,2019,20,8.596774193548388,1.1379310344827587,228,39,267,1.00374531835206
2019-20,RegularSeason,203953,184,Jabari Parker,1610612758,SAC,38,918,219,429,0.51,32,119,0.269,61,81,0.753,61,153,214,68,45,16,64,99,531,580,1.06,0.7,2019,20,13.973684210526315,1.0625,210,20,230,0.9304347826086956
2019-20,RegularSeason,201569,185,Eric Gordon,1610612745,HOU,36,1016,171,463,0.369,96,303,0.317,82,107,0.766,9,62,71,54,23,13,43,70,520,321,1.26,0.54,2019,20,14.444444444444445,1.255813953488372,292,25,317,0.22397476340694006
2019-20,RegularSeason,1628971,186,Bruce Brown,1610612765,DET,58,1634,198,447,0.443,33,96,0.344,88,119,0.739,61,213,274,230,63,29,100,162,517,733,2.3,0.63,2019,20,8.913793103448276,2.3,249,31,280,0.9785714285714285
2019-20,RegularSeason,2730,186,Dwight Howard,1610612747,LAL,69,1306,202,277,0.729,3,5,0.6,110,214,0.514,172,335,507,45,31,79,84,222,517,916,0.54,0.37,2019,20,7.492753623188406,0.5357142857142857,75,104,179,2.8324022346368714
2019-20,RegularSeason,1629008,188,Michael Porter Jr.,1610612743,DEN,55,903,195,383,0.509,62,147,0.422,60,72,0.833,66,193,259,46,27,25,49,100,512,620,0.94,0.55,2019,20,9.309090909090909,0.9387755102040817,188,12,200,1.295
2019-20,RegularSeason,1629661,189,Cameron Johnson,1610612756,PHX,57,1255,176,405,0.435,106,272,0.39,46,57,0.807,49,138,187,69,36,20,32,88,504,544,2.16,1.13,2019,20,8.842105263157896,2.15625,229,11,240,0.7791666666666667
2019-20,RegularSeason,1626153,189,Delon Wright,1610612742,DAL,73,1570,190,411,0.462,47,127,0.37,77,100,0.77,70,210,280,244,85,22,73,93,504,818,3.34,1.16,2019,20,6.904109589041096,3.3424657534246576,221,23,244,1.1475409836065573
2019-20,RegularSeason,1629004,189,Svi Mykhailiuk,1610612765,DET,56,1265,166,405,0.41,115,285,0.404,57,70,0.814,17,87,104,106,41,4,61,87,504,446,1.74,0.67,2019,20,9.0,1.7377049180327868,239,13,252,0.4126984126984127
2019-20,RegularSeason,1629673,192,Jordan Poole,1610612744,GSW,57,1274,167,502,0.333,74,265,0.279,95,119,0.798,9,109,118,134,35,10,74,94,503,367,1.81,0.47,2019,20,8.824561403508772,1.8108108108108107,335,24,359,0.3286908077994429
2019-20,RegularSeason,1627884,193,Derrick Jones Jr.,1610612748,MIA,59,1375,184,349,0.527,37,132,0.28,95,123,0.772,66,167,233,62,58,38,30,130,500,668,2.07,1.93,2019,20,8.474576271186441,2.066666666666667,165,28,193,1.2072538860103628
2019-20,RegularSeason,200782,193,P.J. Tucker,1610612745,HOU,72,2467,177,426,0.415,107,299,0.358,39,48,0.813,112,364,476,115,77,36,72,229,500,874,1.6,1.07,2019,20,6.944444444444445,1.5972222222222223,249,9,258,1.8449612403100775
2019-20,RegularSeason,1629645,195,Kevin Porter Jr.,1610612739,CLE,50,1162,186,421,0.442,53,158,0.335,73,101,0.723,22,140,162,109,46,14,93,135,498,473,1.17,0.49,2019,20,9.96,1.1720430107526882,235,28,263,0.6159695817490495
2019-20,RegularSeason,202083,196,Wesley Matthews,1610612749,MIL,67,1635,167,422,0.396,108,297,0.364,52,68,0.765,22,144,166,92,38,9,43,103,494,485,2.14,0.88,2019,20,7.373134328358209,2.13953488372093,255,16,271,0.6125461254612546
2019-20,RegularSeason,1629013,197,Landry Shamet,1610612746,LAC,53,1452,158,391,0.404,111,296,0.375,65,76,0.855,6,94,100,99,20,10,42,142,492,435,2.36,0.48,2019,20,9.283018867924529,2.357142857142857,233,11,244,0.4098360655737705
2019-20,RegularSeason,202738,198,Isaiah Thomas,1610612764,WAS,40,925,174,426,0.408,78,189,0.413,62,76,0.816,11,57,68,146,13,6,77,77,488,378,1.9,0.17,2019,20,12.2,1.896103896103896,252,14,266,0.2556390977443609
2019-20,RegularSeason,202954,199,Brad Wanamaker,1610612738,BOS,71,1369,162,362,0.448,37,102,0.363,126,136,0.926,22,122,144,179,61,14,76,133,487,599,2.35,0.8,2019,20,6.859154929577465,2.3552631578947367,200,10,210,0.6857142857142857
2019-20,RegularSeason,1626145,200,Tyus Jones,1610612763,MEM,65,1232,197,429,0.459,47,124,0.379,43,58,0.741,9,94,103,285,59,6,55,44,484,635,5.18,1.07,2019,20,7.446153846153846,5.181818181818182,232,15,247,0.41700404858299595
2019-20,RegularSeason,1628976,200,Wendell Carter Jr.,1610612741,CHI,43,1256,183,343,0.534,6,29,0.207,112,152,0.737,139,266,405,51,33,36,72,162,484,737,0.71,0.46,2019,20,11.255813953488373,0.7083333333333334,160,40,200,2.025
2019-20,RegularSeason,203382,202,Aron Baynes,1610612756,PHX,42,934,183,381,0.48,59,168,0.351,56,75,0.747,71,166,237,67,10,23,50,141,481,551,1.34,0.2,2019,20,11.452380952380953,1.34,198,19,217,1.0921658986175116
2019-20,RegularSeason,203503,203,Tony Snell,1610612765,DET,59,1641,170,382,0.445,102,254,0.402,32,32,1.0,9,102,111,127,32,15,31,101,474,516,4.1,1.03,2019,20,8.033898305084746,4.096774193548387,212,0,212,0.5235849056603774
2019-20,RegularSeason,1629637,204,Jaxson Hayes,1610612740,NOP,64,1080,174,259,0.672,1,4,0.25,123,190,0.647,97,162,259,56,26,55,53,161,472,663,1.06,0.49,2019,20,7.375,1.0566037735849056,85,67,152,1.7039473684210527
2019-20,RegularSeason,202683,205,Enes Freedom,1610612738,BOS,58,983,199,348,0.572,1,7,0.143,70,99,0.707,163,268,431,56,22,41,56,100,469,785,1.0,0.39,2019,20,8.086206896551724,1.0,149,29,178,2.4213483146067416
2019-20,RegularSeason,202734,206,E'Twaun Moore,1610612740,NOP,56,1020,186,437,0.426,63,167,0.377,31,45,0.689,31,100,131,78,32,11,40,80,466,413,1.95,0.8,2019,20,8.321428571428571,1.95,251,14,265,0.49433962264150944
2019-20,RegularSeason,1628973,206,Jalen Brunson,1610612742,DAL,57,1022,181,388,0.466,43,120,0.358,61,75,0.813,22,112,134,188,22,4,66,74,466,527,2.85,0.33,2019,20,8.175438596491228,2.8484848484848486,207,14,221,0.6063348416289592
2019-20,RegularSeason,201599,208,DeAndre Jordan,1610612751,BKN,56,1234,191,287,0.666,0,0,0.0,83,122,0.68,141,420,561,105,18,52,74,114,465,992,1.42,0.24,2019,20,8.303571428571429,1.4189189189189189,96,39,135,4.155555555555556
2019-20,RegularSeason,203476,209,Gorgui Dieng,1610612763,MEM,63,1097,166,364,0.456,54,152,0.355,78,101,0.772,91,263,354,73,51,59,60,124,464,720,1.22,0.85,2019,20,7.365079365079365,1.2166666666666666,198,23,221,1.6018099547511313
2019-20,RegularSeason,204456,209,T.J. McConnell,1610612754,IND,71,1326,212,411,0.516,5,17,0.294,35,42,0.833,38,151,189,355,56,11,100,73,464,769,3.55,0.56,2019,20,6.535211267605634,3.55,199,7,206,0.9174757281553398
2019-20,RegularSeason,202324,211,Derrick Favors,1610612740,NOP,51,1242,209,339,0.617,1,7,0.143,40,71,0.563,163,338,501,81,30,46,55,107,459,901,1.47,0.55,2019,20,9.0,1.4727272727272727,130,31,161,3.111801242236025
2019-20,RegularSeason,202709,212,Cory Joseph,1610612758,SAC,72,1759,171,412,0.415,56,159,0.352,60,70,0.857,44,144,188,251,53,21,80,133,458,640,3.14,0.66,2019,20,6.361111111111111,3.1375,241,10,251,0.749003984063745
2019-20,RegularSeason,1629001,213,De'Anthony Melton,1610612763,MEM,60,1167,161,401,0.401,40,140,0.286,93,121,0.769,43,177,220,175,77,20,84,109,455,595,2.08,0.92,2019,20,7.583333333333333,2.0833333333333335,240,28,268,0.8208955223880597
2019-20,RegularSeason,203516,214,James Ennis III,1610612753,ORL,69,1266,160,359,0.446,55,169,0.325,79,98,0.806,71,174,245,63,35,22,58,137,454,543,1.09,0.6,2019,20,6.579710144927536,1.0862068965517242,199,19,218,1.1238532110091743
2019-20,RegularSeason,201145,215,Jeff Green,1610612745,HOU,48,960,159,344,0.462,62,183,0.339,73,91,0.802,24,109,133,50,26,19,42,89,453,436,1.19,0.62,2019,20,9.4375,1.1904761904761905,185,18,203,0.6551724137931034
2019-20,RegularSeason,1626220,216,Royce O'Neale,1610612762,UTA,71,2049,158,365,0.433,92,244,0.377,42,55,0.764,27,362,389,180,59,32,61,202,450,829,2.95,0.97,2019,20,6.338028169014085,2.9508196721311477,207,13,220,1.768181818181818
2019-20,RegularSeason,203901,217,Elfrid Payton,1610612752,NYK,45,1246,193,440,0.439,14,69,0.203,49,86,0.57,52,160,212,323,70,17,96,89,449,691,3.37,0.73,2019,20,9.977777777777778,3.3645833333333335,247,37,284,0.7464788732394366
2019-20,RegularSeason,203457,217,Nerlens Noel,1610612760,OKC,61,1127,184,269,0.684,1,3,0.333,80,106,0.755,91,209,300,57,59,91,66,166,449,779,0.86,0.89,2019,20,7.360655737704918,0.8636363636363636,85,26,111,2.7027027027027026
2019-20,RegularSeason,201580,219,JaVale McGee,1610612747,LAL,68,1130,195,306,0.637,3,6,0.5,53,82,0.646,125,265,390,37,36,94,55,159,446,808,0.67,0.66,2019,20,6.5588235294117645,0.6727272727272727,111,29,140,2.7857142857142856
2019-20,RegularSeason,1628379,220,Luke Kennard,1610612765,DET,28,922,151,342,0.442,73,183,0.399,67,75,0.893,9,89,98,115,12,6,43,65,442,431,2.67,0.28,2019,20,15.785714285714286,2.6744186046511627,191,8,199,0.49246231155778897
2019-20,RegularSeason,203458,221,Alex Len,1610612758,SAC,55,971,177,319,0.555,16,59,0.271,68,105,0.648,100,221,321,50,23,48,55,127,438,646,0.91,0.42,2019,20,7.963636363636364,0.9090909090909091,142,37,179,1.7932960893854748
2019-20,RegularSeason,203486,222,Mason Plumlee,1610612743,DEN,61,1057,177,288,0.615,0,5,0.0,83,155,0.535,98,219,317,154,33,38,82,143,437,714,1.88,0.4,2019,20,7.163934426229508,1.8780487804878048,111,72,183,1.7322404371584699
2019-20,RegularSeason,203210,223,JaMychal Green,1610612746,LAC,63,1307,151,352,0.429,92,238,0.387,36,48,0.75,77,311,388,49,29,24,54,174,430,653,0.91,0.54,2019,20,6.825396825396825,0.9074074074074074,201,12,213,1.8215962441314555
2019-20,RegularSeason,203895,224,Jordan McRae,1610612765,DET,37,785,149,366,0.407,45,126,0.357,83,109,0.761,18,106,124,93,21,16,43,73,426,394,2.16,0.49,2019,20,11.513513513513514,2.1627906976744184,217,26,243,0.5102880658436214
2019-20,RegularSeason,202340,225,Avery Bradley,1610612747,LAL,49,1186,170,383,0.444,63,173,0.364,20,24,0.833,18,97,115,63,43,5,47,110,423,385,1.34,0.92,2019,20,8.63265306122449,1.3404255319148937,213,4,217,0.5299539170506913
2019-20,RegularSeason,2772,225,Trevor Ariza,1610612757,POR,53,1492,142,324,0.438,77,207,0.372,62,74,0.838,34,212,246,91,69,15,56,111,423,594,1.63,1.23,2019,20,7.981132075471698,1.625,182,12,194,1.268041237113402
2019-20,RegularSeason,1628995,227,Kevin Knox II,1610612752,NYK,65,1166,144,401,0.359,65,199,0.327,66,101,0.653,28,156,184,61,23,28,45,106,419,378,1.36,0.51,2019,20,6.446153846153846,1.3555555555555556,257,35,292,0.6301369863013698
2019-20,RegularSeason,1626178,228,Rondae Hollis-Jefferson,1610612761,TOR,60,1122,155,329,0.471,3,23,0.13,105,143,0.734,110,173,283,106,46,23,59,115,418,605,1.8,0.78,2019,20,6.966666666666667,1.7966101694915255,174,38,212,1.3349056603773586
2019-20,RegularSeason,101141,229,Ersan Ilyasova,1610612749,MIL,63,986,146,313,0.466,50,137,0.365,72,87,0.828,62,240,302,49,24,17,34,95,414,590,1.44,0.71,2019,20,6.571428571428571,1.4411764705882353,167,15,182,1.6593406593406594
2019-20,RegularSeason,1628449,230,Chris Boucher,1610612761,TOR,62,819,141,299,0.472,38,118,0.322,91,116,0.784,107,170,277,26,22,61,28,114,411,586,0.93,0.79,2019,20,6.629032258064516,0.9285714285714286,158,25,183,1.5136612021857923
2019-20,RegularSeason,203118,231,Mike Scott,1610612755,PHI,68,1207,149,350,0.426,80,217,0.369,30,37,0.811,65,183,248,56,22,5,26,96,408,505,2.15,0.85,2019,20,6.0,2.1538461538461537,201,7,208,1.1923076923076923
2019-20,RegularSeason,201976,232,Patrick Beverley,1610612746,LAC,51,1342,147,341,0.431,80,206,0.388,31,47,0.66,57,209,266,183,54,25,66,156,405,657,2.77,0.82,2019,20,7.9411764705882355,2.772727272727273,194,16,210,1.2666666666666666
2019-20,RegularSeason,1628371,233,Jonathan Isaac,1610612753,ORL,34,980,156,332,0.47,32,94,0.34,60,77,0.779,58,173,231,48,53,78,49,83,404,572,0.98,1.08,2019,20,11.882352941176471,0.9795918367346939,176,17,193,1.1968911917098446
2019-20,RegularSeason,1626168,233,Trey Lyles,1610612759,SAS,63,1271,153,343,0.446,65,168,0.387,33,45,0.733,71,290,361,69,28,28,39,98,404,649,1.77,0.72,2019,20,6.412698412698413,1.7692307692307692,190,12,202,1.7871287128712872
2019-20,RegularSeason,1626144,235,Emmanuel Mudiay,1610612762,UTA,54,850,151,327,0.462,30,87,0.345,63,83,0.759,18,108,126,116,24,10,76,72,395,399,1.53,0.32,2019,20,7.314814814814815,1.5263157894736843,176,20,196,0.6428571428571429
2019-20,RegularSeason,1629740,235,Nicolo Melli,1610612740,NOP,60,1042,136,323,0.421,69,206,0.335,54,73,0.74,38,142,180,82,34,23,46,124,395,462,1.78,0.74,2019,20,6.583333333333333,1.7826086956521738,187,19,206,0.8737864077669902
2019-20,RegularSeason,202687,237,Bismack Biyombo,1610612766,CHA,53,1029,151,278,0.543,0,0,0.0,91,151,0.603,120,188,308,50,10,49,48,116,393,575,1.04,0.21,2019,20,7.415094339622642,1.0416666666666667,127,60,187,1.6470588235294117
2019-20,RegularSeason,1629021,237,Moritz Wagner,1610612764,WAS,45,835,145,266,0.545,25,80,0.313,78,95,0.821,56,163,219,56,28,19,66,152,393,511,0.85,0.42,2019,20,8.733333333333333,0.8484848484848485,121,17,138,1.5869565217391304
2019-20,RegularSeason,1627777,239,Georges Niang,1610612762,UTA,66,923,141,322,0.438,90,225,0.4,20,24,0.833,15,112,127,44,18,5,30,75,392,371,1.47,0.6,2019,20,5.9393939393939394,1.4666666666666666,181,4,185,0.6864864864864865
2019-20,RegularSeason,203937,240,Kyle Anderson,1610612763,MEM,67,1330,157,331,0.474,24,85,0.282,52,78,0.667,58,227,285,162,54,37,66,111,390,662,2.46,0.82,2019,20,5.82089552238806,2.4545454545454546,174,26,200,1.425
2019-20,RegularSeason,1626161,240,Willie Cauley-Stein,1610612742,DAL,54,1097,175,302,0.579,0,1,0.0,40,66,0.606,84,231,315,70,49,61,40,121,390,692,1.75,1.23,2019,20,7.222222222222222,1.75,127,26,153,2.0588235294117645
2019-20,RegularSeason,1629022,242,Lonnie Walker IV,1610612759,SAS,61,988,152,357,0.426,41,101,0.406,44,61,0.721,23,116,139,68,32,14,44,78,389,376,1.54,0.73,2019,20,6.377049180327869,1.5454545454545454,205,17,222,0.6261261261261262
2019-20,RegularSeason,2594,243,Kyle Korver,1610612749,MIL,58,960,126,293,0.43,99,237,0.418,35,41,0.854,15,107,122,68,26,12,48,78,386,393,1.42,0.54,2019,20,6.655172413793103,1.4166666666666667,167,6,173,0.7052023121387283
2019-20,RegularSeason,201959,244,Taj Gibson,1610612752,NYK,62,1025,167,286,0.584,4,14,0.286,41,56,0.732,111,156,267,52,27,30,47,122,379,574,1.11,0.57,2019,20,6.112903225806452,1.1063829787234043,119,15,134,1.992537313432836
2019-20,RegularSeason,1626163,245,Frank Kaminsky,1610612756,PHX,39,777,138,307,0.45,41,124,0.331,61,90,0.678,35,141,176,75,14,10,37,75,378,418,2.03,0.38,2019,20,9.692307692307692,2.027027027027027,169,29,198,0.8888888888888888
2019-20,RegularSeason,1629003,246,Shake Milton,1610612755,PHI,40,805,134,277,0.484,58,135,0.43,51,65,0.785,15,73,88,104,20,7,47,92,377,392,2.21,0.43,2019,20,9.425,2.2127659574468086,143,14,157,0.5605095541401274
2019-20,RegularSeason,203939,247,Dwight Powell,1610612742,DAL,40,1061,146,229,0.638,10,39,0.256,74,111,0.667,75,152,227,59,34,22,36,102,376,562,1.64,0.94,2019,20,9.4,1.6388888888888888,83,37,120,1.8916666666666666
2019-20,RegularSeason,1627739,248,Kris Dunn,1610612741,CHI,51,1269,152,342,0.444,29,112,0.259,40,54,0.741,23,163,186,173,101,17,68,158,373,578,2.54,1.49,2019,20,7.313725490196078,2.5441176470588234,190,14,204,0.9117647058823529
2019-20,RegularSeason,1627751,249,Jakob Poeltl,1610612759,SAS,66,1171,166,266,0.624,0,0,0.0,40,86,0.465,131,244,375,116,37,95,54,126,372,795,2.15,0.69,2019,20,5.636363636363637,2.1481481481481484,100,46,146,2.5684931506849313
2019-20,RegularSeason,1628402,250,Frank Jackson,1610612740,NOP,59,797,134,331,0.405,47,144,0.326,56,75,0.747,22,61,83,61,17,4,49,77,371,271,1.25,0.35,2019,20,6.288135593220339,1.2448979591836735,197,19,216,0.38425925925925924
2019-20,RegularSeason,1629016,251,Omari Spellman,1610612750,MIN,49,886,127,295,0.431,43,110,0.391,73,92,0.793,77,142,219,47,33,24,54,63,370,452,0.87,0.61,2019,20,7.551020408163265,0.8703703703703703,168,19,187,1.1711229946524064
2019-20,RegularSeason,202704,251,Reggie Jackson,1610612746,LAC,31,743,134,326,0.411,57,145,0.393,45,54,0.833,17,75,92,126,13,5,51,59,370,354,2.47,0.26,2019,20,11.935483870967742,2.4705882352941178,192,9,201,0.4577114427860697
2019-20,RegularSeason,1627789,253,Timothe Luwawu-Cabarrot,1610612751,BKN,47,853,117,269,0.435,62,160,0.388,69,81,0.852,29,98,127,29,18,7,37,106,365,345,0.78,0.49,2019,20,7.76595744680851,0.7837837837837838,152,12,164,0.774390243902439
2019-20,RegularSeason,201158,254,Marco Belinelli,1610612759,SAS,57,883,123,314,0.392,67,178,0.376,48,58,0.828,7,92,99,69,12,1,19,45,361,322,3.63,0.63,2019,20,6.333333333333333,3.6315789473684212,191,10,201,0.4925373134328358
2019-20,RegularSeason,1628382,255,Justin Jackson,1610612742,DAL,65,1045,135,341,0.396,48,163,0.294,42,50,0.84,27,127,154,52,15,10,14,69,360,363,3.71,1.07,2019,20,5.538461538461538,3.7142857142857144,206,8,214,0.719626168224299
2019-20,RegularSeason,1626192,255,Pat Connaughton,1610612749,MIL,67,1243,137,301,0.455,55,166,0.331,31,40,0.775,60,224,284,107,25,31,52,70,360,582,2.06,0.48,2019,20,5.373134328358209,2.0576923076923075,164,9,173,1.6416184971098267
2019-20,RegularSeason,1628373,257,Frank Ntilikina,1610612752,NYK,57,1187,131,333,0.393,44,137,0.321,51,59,0.864,23,98,121,172,54,16,71,142,357,439,2.42,0.76,2019,20,6.2631578947368425,2.4225352112676055,202,8,210,0.5761904761904761
2019-20,RegularSeason,203090,257,Maurice Harkless,1610612752,NYK,62,1427,142,283,0.502,34,98,0.347,39,66,0.591,55,185,240,68,58,33,53,148,357,535,1.28,1.09,2019,20,5.758064516129032,1.2830188679245282,141,27,168,1.4285714285714286
2019-20,RegularSeason,201577,257,Robin Lopez,1610612749,MIL,66,958,147,299,0.492,35,105,0.333,28,53,0.528,56,105,161,45,10,45,63,96,357,378,0.71,0.16,2019,20,5.409090909090909,0.7142857142857143,152,25,177,0.9096045197740112
2019-20,RegularSeason,1627936,260,Alex Caruso,1610612747,LAL,64,1175,120,291,0.412,40,120,0.333,69,94,0.734,17,106,123,124,70,18,53,98,349,435,2.34,1.32,2019,20,5.453125,2.339622641509434,171,25,196,0.6275510204081632
2019-20,RegularSeason,1627846,261,Abdel Nader,1610612760,OKC,55,867,123,263,0.468,48,128,0.375,51,66,0.773,14,86,100,38,23,20,43,78,345,328,0.88,0.54,2019,20,6.2727272727272725,0.8837209302325582,140,15,155,0.6451612903225806
2019-20,RegularSeason,203110,261,Draymond Green,1610612744,GSW,43,1222,123,316,0.389,36,129,0.279,63,83,0.759,23,243,266,266,59,33,98,110,345,658,2.71,0.6,2019,20,8.023255813953488,2.7142857142857144,193,20,213,1.2488262910798122
2019-20,RegularSeason,101107,263,Marvin Williams,1610612749,MIL,58,1129,119,267,0.446,56,156,0.359,49,57,0.86,30,153,183,60,36,30,33,103,343,463,1.82,1.09,2019,20,5.913793103448276,1.8181818181818181,148,8,156,1.1730769230769231
2019-20,RegularSeason,1629647,264,Darius Bazley,1610612760,OKC,61,1129,125,317,0.394,49,141,0.348,43,62,0.694,30,216,246,41,23,41,45,55,342,437,0.91,0.51,2019,20,5.60655737704918,0.9111111111111111,192,19,211,1.1658767772511849
2019-20,RegularSeason,200765,264,Rajon Rondo,1610612747,LAL,48,984,137,328,0.418,41,125,0.328,27,41,0.659,23,119,142,240,40,2,91,58,342,470,2.64,0.44,2019,20,7.125,2.6373626373626373,191,14,205,0.6926829268292682
2019-20,RegularSeason,1629065,266,Ky Bowman,1610612744,GSW,45,1015,134,321,0.417,33,107,0.308,34,41,0.829,24,97,121,131,44,10,70,102,335,377,1.87,0.63,2019,20,7.444444444444445,1.8714285714285714,187,7,194,0.6237113402061856
2019-20,RegularSeason,1628964,267,Mo Bamba,1610612753,ORL,62,878,132,286,0.462,37,107,0.346,31,46,0.674,100,202,302,42,23,86,42,116,332,574,1.0,0.55,2019,20,5.354838709677419,1.0,154,15,169,1.78698224852071
2019-20,RegularSeason,201188,268,Marc Gasol,1610612761,TOR,44,1161,119,279,0.427,57,148,0.385,36,49,0.735,31,244,275,147,34,38,59,124,331,593,2.49,0.58,2019,20,7.5227272727272725,2.4915254237288136,160,13,173,1.5895953757225434
2019-20,RegularSeason,1628960,269,Grayson Allen,1610612763,MEM,38,718,117,251,0.466,57,141,0.404,39,45,0.867,8,77,85,52,10,2,33,53,330,306,1.58,0.3,2019,20,8.68421052631579,1.5757575757575757,134,6,140,0.6071428571428571
2019-20,RegularSeason,1629067,269,Isaac Bonga,1610612764,WAS,66,1250,118,234,0.504,25,71,0.352,69,85,0.812,71,151,222,76,45,22,58,156,330,505,1.31,0.78,2019,20,5.0,1.3103448275862069,116,16,132,1.6818181818181819
2019-20,RegularSeason,203487,271,Michael Carter-Williams,1610612753,ORL,45,833,111,260,0.427,22,75,0.293,79,95,0.832,46,101,147,109,49,22,52,87,323,433,2.1,0.94,2019,20,7.177777777777778,2.0961538461538463,149,16,165,0.8909090909090909
2019-20,RegularSeason,203524,271,Solomon Hill,1610612748,MIA,59,1088,110,278,0.396,63,171,0.368,40,54,0.741,29,136,165,104,43,12,51,85,323,414,2.04,0.84,2019,20,5.47457627118644,2.0392156862745097,168,14,182,0.9065934065934066
2019-20,RegularSeason,1628422,273,Damyean Dotson,1610612752,NYK,48,836,120,290,0.414,59,163,0.362,22,33,0.667,10,81,91,57,23,4,21,44,321,294,2.71,1.09,2019,20,6.6875,2.7142857142857144,170,11,181,0.5027624309392266
2019-20,RegularSeason,1629010,274,Jerome Robinson,1610612764,WAS,63,979,115,310,0.371,49,153,0.32,40,57,0.702,13,116,129,87,28,17,49,112,319,319,1.78,0.57,2019,20,5.063492063492063,1.7755102040816326,195,17,212,0.6084905660377359
2019-20,RegularSeason,1628977,275,Hamidou Diallo,1610612760,OKC,46,896,132,296,0.446,16,57,0.281,38,63,0.603,44,123,167,36,37,9,51,101,318,327,0.71,0.72,2019,20,6.913043478260869,0.7058823529411765,164,25,189,0.8835978835978836
2019-20,RegularSeason,1628385,276,Harry Giles III,1610612758,SAC,46,667,139,251,0.554,0,2,0.0,38,49,0.776,43,145,188,60,22,18,44,119,316,437,1.36,0.5,2019,20,6.869565217391305,1.3636363636363635,112,11,123,1.5284552845528456
2019-20,RegularSeason,1628470,277,Torrey Craig,1610612743,DEN,58,1072,124,269,0.461,45,138,0.326,22,36,0.611,63,126,189,47,23,36,25,135,315,426,1.88,0.92,2019,20,5.431034482758621,1.88,145,14,159,1.1886792452830188
2019-20,RegularSeason,203086,278,Meyers Leonard,1610612748,MIA,51,1034,119,234,0.509,53,128,0.414,18,28,0.643,30,230,260,55,14,15,39,107,309,489,1.41,0.36,2019,20,6.0588235294117645,1.4102564102564104,115,10,125,2.08
2019-20,RegularSeason,1627745,279,Damian Jones,1610612737,ATL,55,887,121,178,0.68,2,9,0.222,62,84,0.738,74,132,206,35,26,40,28,149,306,506,1.25,0.93,2019,20,5.5636363636363635,1.25,57,22,79,2.607594936708861
2019-20,RegularSeason,1629680,280,Matisse Thybulle,1610612755,PHI,65,1287,112,265,0.423,56,157,0.357,25,41,0.61,44,63,107,79,93,47,51,141,305,411,1.55,1.82,2019,20,4.6923076923076925,1.5490196078431373,153,16,169,0.6331360946745562
2019-20,RegularSeason,1628411,281,Wes Iwundu,1610612753,ORL,52,953,97,233,0.416,28,82,0.341,78,97,0.804,24,107,131,60,25,13,26,80,300,348,2.31,0.96,2019,20,5.769230769230769,2.3076923076923075,136,19,155,0.8451612903225807
2019-20,RegularSeason,1713,282,Vince Carter,1610612737,ATL,60,876,107,304,0.352,61,202,0.302,23,29,0.793,18,106,124,48,23,25,33,90,298,282,1.46,0.7,2019,20,4.966666666666667,1.4545454545454546,197,6,203,0.6108374384236454
2019-20,RegularSeason,202335,283,Patrick Patterson,1610612746,LAC,59,776,95,233,0.408,67,172,0.39,35,43,0.814,35,116,151,41,7,3,21,54,292,327,1.95,0.33,2019,20,4.9491525423728815,1.9523809523809523,138,8,146,1.0342465753424657
2019-20,RegularSeason,1626246,284,Boban Marjanovic,1610612742,DAL,44,422,121,211,0.573,4,17,0.235,43,57,0.754,66,131,197,20,8,10,30,56,289,390,0.67,0.27,2019,20,6.568181818181818,0.6666666666666666,90,14,104,1.8942307692307692
2019-20,RegularSeason,1627823,285,Juancho Hernangomez,1610612750,MIN,48,834,100,247,0.405,44,129,0.341,44,71,0.62,43,154,197,40,19,9,32,64,288,347,1.25,0.59,2019,20,6.0,1.25,147,27,174,1.132183908045977
2019-20,RegularSeason,1628966,285,Keita Bates-Diop,1610612743,DEN,44,744,100,234,0.427,34,103,0.33,54,75,0.72,25,102,127,30,19,24,17,43,288,316,1.76,1.12,2019,20,6.545454545454546,1.7647058823529411,134,21,155,0.8193548387096774
2019-20,RegularSeason,1628975,287,Jevon Carter,1610612756,PHX,58,945,101,243,0.416,62,146,0.425,23,27,0.852,30,88,118,84,47,17,32,86,287,375,2.63,1.47,2019,20,4.948275862068965,2.625,142,4,146,0.8082191780821918
2019-20,RegularSeason,1628396,288,Tony Bradley,1610612762,UTA,58,663,126,189,0.667,3,3,1.0,30,46,0.652,111,156,267,23,14,33,30,115,285,513,0.77,0.47,2019,20,4.913793103448276,0.7666666666666667,63,16,79,3.3797468354430378
2019-20,RegularSeason,101133,289,Ian Mahinmi,1610612764,WAS,38,808,104,210,0.495,5,26,0.192,70,113,0.619,78,140,218,49,31,44,45,114,283,431,1.09,0.69,2019,20,7.447368421052632,1.0888888888888888,106,43,149,1.4630872483221478
2019-20,RegularSeason,1627748,290,Thon Maker,1610612765,DET,60,776,93,193,0.482,22,64,0.344,73,110,0.664,54,113,167,43,25,39,45,102,281,373,0.96,0.56,2019,20,4.683333333333334,0.9555555555555556,100,37,137,1.218978102189781
2019-20,RegularSeason,201933,291,Blake Griffin,1610612765,DET,18,512,88,250,0.352,27,111,0.243,76,98,0.776,17,67,84,59,7,7,40,27,279,212,1.48,0.17,2019,20,15.5,1.475,162,22,184,0.45652173913043476
2019-20,RegularSeason,203526,292,Raul Neto,1610612755,PHI,54,668,101,222,0.455,34,88,0.386,39,47,0.83,11,50,61,95,24,6,47,50,275,285,2.02,0.51,2019,20,5.092592592592593,2.021276595744681,121,8,129,0.4728682170542636
2019-20,RegularSeason,203506,292,Victor Oladipo,1610612754,IND,19,528,97,246,0.394,33,104,0.317,48,59,0.814,9,66,75,56,17,4,47,36,275,220,1.19,0.36,2019,20,14.473684210526315,1.1914893617021276,149,11,160,0.46875
2019-20,RegularSeason,204020,294,Tyler Johnson,1610612751,BKN,39,709,97,250,0.388,38,119,0.319,42,50,0.84,18,58,76,74,16,9,29,58,274,259,2.55,0.55,2019,20,7.0256410256410255,2.5517241379310347,153,8,161,0.4720496894409938
2019-20,RegularSeason,201949,295,James Johnson,1610612750,MIN,32,620,103,215,0.479,33,91,0.363,31,48,0.646,25,93,118,74,25,32,48,80,270,342,1.54,0.52,2019,20,8.4375,1.5416666666666667,112,17,129,0.9147286821705426
2019-20,RegularSeason,1629675,296,Naz Reid,1610612750,MIN,30,495,100,243,0.412,32,97,0.33,37,53,0.698,34,90,124,35,19,22,22,83,269,288,1.59,0.86,2019,20,8.966666666666667,1.5909090909090908,143,16,159,0.779874213836478
2019-20,RegularSeason,1629638,297,Nickeil Alexander-Walker,1610612740,NOP,47,591,98,266,0.368,46,133,0.346,25,37,0.676,9,75,84,89,17,8,54,57,267,231,1.65,0.32,2019,20,5.680851063829787,1.6481481481481481,168,12,180,0.4666666666666667
2019-20,RegularSeason,1628425,298,Sterling Brown,1610612749,MIL,52,767,95,256,0.371,44,136,0.324,32,40,0.8,31,152,183,51,29,7,42,54,266,325,1.21,0.69,2019,20,5.115384615384615,1.2142857142857142,161,8,169,1.0828402366863905
2019-20,RegularSeason,1627853,299,Ryan Arcidiacono,1610612741,CHI,58,930,90,220,0.409,54,138,0.391,27,38,0.711,20,90,110,96,27,3,37,96,261,319,2.6,0.73,2019,20,4.5,2.5945945945945947,130,11,141,0.7801418439716312
2019-20,RegularSeason,203473,300,Dewayne Dedmon,1610612737,ATL,44,774,102,255,0.4,22,107,0.206,30,36,0.833,60,189,249,22,25,41,57,133,256,377,0.39,0.44,2019,20,5.818181818181818,0.38596491228070173,153,6,159,1.5660377358490567
2019-20,RegularSeason,1626209,300,Mario Hezonja,1610612757,POR,53,871,92,218,0.422,24,78,0.308,48,59,0.814,30,154,184,50,36,9,42,107,256,356,1.19,0.86,2019,20,4.830188679245283,1.1904761904761905,126,11,137,1.3430656934306568
2019-20,RegularSeason,1627761,302,DeAndre' Bembry,1610612737,ATL,43,915,104,228,0.456,15,65,0.231,26,48,0.542,34,118,152,81,55,19,60,84,249,350,1.35,0.92,2019,20,5.790697674418604,1.35,124,22,146,1.0410958904109588
2019-20,RegularSeason,1627756,303,Denzel Valentine,1610612741,CHI,36,488,97,237,0.409,46,137,0.336,6,8,0.75,9,65,74,43,26,6,26,51,246,227,1.65,1.0,2019,20,6.833333333333333,1.6538461538461537,140,2,142,0.5211267605633803
2019-20,RegularSeason,1629652,304,Luguentz Dort,1610612760,OKC,36,820,86,218,0.394,30,101,0.297,42,53,0.792,24,57,81,27,31,4,22,97,244,222,1.23,1.41,2019,20,6.777777777777778,1.2272727272727273,132,11,143,0.5664335664335665
2019-20,RegularSeason,1626143,305,Jahlil Okafor,1610612740,NOP,30,467,101,162,0.623,1,3,0.333,40,62,0.645,48,79,127,37,7,22,38,67,243,315,0.97,0.18,2019,20,8.1,0.9736842105263158,61,22,83,1.5301204819277108
2019-20,RegularSeason,1629635,305,Sekou Doumbouya,1610612765,DET,38,754,92,236,0.39,28,98,0.286,31,46,0.674,20,98,118,19,20,8,35,80,243,214,0.54,0.57,2019,20,6.394736842105263,0.5428571428571428,144,15,159,0.7421383647798742
2019-20,RegularSeason,1626203,305,Treveon Graham,1610612737,ATL,55,929,87,242,0.36,33,120,0.275,36,56,0.643,51,99,150,45,24,6,29,102,243,264,1.55,0.83,2019,20,4.418181818181818,1.5517241379310345,155,20,175,0.8571428571428571
2019-20,RegularSeason,203504,305,Trey Burke,1610612742,DAL,33,520,94,209,0.45,32,75,0.427,23,29,0.793,16,34,50,83,16,2,21,33,243,252,3.95,0.76,2019,20,7.363636363636363,3.9523809523809526,115,6,121,0.4132231404958678
2019-20,RegularSeason,1628981,309,Bruno Fernando,1610612737,ATL,56,713,103,199,0.518,5,37,0.135,29,51,0.569,67,131,198,49,18,17,42,107,240,362,1.17,0.43,2019,20,4.285714285714286,1.1666666666666667,96,22,118,1.6779661016949152
2019-20,RegularSeason,1628998,310,Cody Martin,1610612766,CHA,48,903,89,207,0.43,18,77,0.234,42,65,0.646,38,120,158,95,39,9,44,78,238,354,2.16,0.89,2019,20,4.958333333333333,2.159090909090909,118,23,141,1.1205673758865249
2019-20,RegularSeason,1629684,311,Grant Williams,1610612738,BOS,69,1043,87,211,0.412,24,96,0.25,39,54,0.722,59,119,178,68,30,36,50,163,237,360,1.36,0.6,2019,20,3.4347826086956523,1.36,124,15,139,1.2805755395683454
2019-20,RegularSeason,1628400,312,Semi Ojeleye,1610612738,BOS,69,1011,80,196,0.408,48,127,0.378,28,32,0.875,26,119,145,37,21,5,19,80,236,305,1.95,1.1,2019,20,3.420289855072464,1.9473684210526316,116,4,120,1.2083333333333333
2019-20,RegularSeason,203493,313,Reggie Bullock Jr.,1610612752,NYK,29,684,90,224,0.402,37,111,0.333,17,21,0.81,13,55,68,42,25,3,19,56,234,215,2.21,1.32,2019,20,8.068965517241379,2.210526315789474,134,4,138,0.4927536231884058
2019-20,RegularSeason,203918,314,Rodney Hood,1610612757,POR,21,619,87,172,0.506,35,71,0.493,21,27,0.778,10,62,72,32,17,4,19,46,230,245,1.68,0.9,2019,20,10.952380952380953,1.6842105263157894,85,6,91,0.7912087912087912
2019-20,RegularSeason,1629162,315,Jordan McLaughlin,1610612750,MIN,30,590,87,178,0.489,29,76,0.382,26,39,0.667,7,42,49,125,34,4,31,31,229,306,4.03,1.1,2019,20,7.633333333333334,4.032258064516129,91,13,104,0.47115384615384615
2019-20,RegularSeason,203488,316,Mike Muscala,1610612760,OKC,47,572,77,189,0.407,54,143,0.378,18,22,0.818,16,92,108,40,9,12,17,58,226,262,2.35,0.53,2019,20,4.808510638297872,2.3529411764705883,112,4,116,0.9310344827586207
2019-20,RegularSeason,1628407,317,Dwayne Bacon,1610612766,CHA,39,687,85,244,0.348,19,67,0.284,35,53,0.66,15,85,100,52,23,2,37,52,224,187,1.41,0.62,2019,20,5.743589743589744,1.4054054054054055,159,18,177,0.5649717514124294
2019-20,RegularSeason,1626188,317,Quinn Cook,1610612747,LAL,44,508,91,214,0.425,31,85,0.365,11,14,0.786,11,40,51,49,12,2,33,27,224,179,1.49,0.36,2019,20,5.090909090909091,1.4848484848484849,123,3,126,0.40476190476190477
2019-20,RegularSeason,200826,319,J.J. Barea,1610612742,DAL,29,450,85,207,0.411,32,85,0.376,20,22,0.909,10,43,53,112,5,2,38,27,222,232,2.95,0.13,2019,20,7.655172413793103,2.9473684210526314,122,2,124,0.4274193548387097
2019-20,RegularSeason,203089,320,John Henson,1610612765,DET,40,600,95,171,0.556,8,36,0.222,23,46,0.5,46,116,162,54,24,42,36,78,221,368,1.5,0.67,2019,20,5.525,1.5,76,23,99,1.6363636363636365
2019-20,RegularSeason,1629655,321,Daniel Gafford,1610612741,CHI,43,609,94,134,0.701,0,0,0.0,32,60,0.533,52,54,106,21,13,56,29,98,220,319,0.72,0.45,2019,20,5.116279069767442,0.7241379310344828,40,28,68,1.5588235294117647
2019-20,RegularSeason,1628390,321,Terrance Ferguson,1610612760,OKC,56,1257,78,220,0.355,49,168,0.292,15,20,0.75,23,51,74,51,27,17,31,155,220,211,1.65,0.87,2019,20,3.9285714285714284,1.6451612903225807,142,5,147,0.5034013605442177
2019-20,RegularSeason,1627767,323,Cheick Diallo,1610612756,PHX,47,479,92,142,0.648,1,3,0.333,34,39,0.872,30,101,131,22,11,12,32,55,219,308,0.69,0.34,2019,20,4.659574468085107,0.6875,50,5,55,2.381818181818182
2019-20,RegularSeason,1629059,323,Elie Okobo,1610612756,PHX,55,719,72,181,0.398,25,71,0.352,50,71,0.704,16,74,90,115,24,4,38,54,219,284,3.03,0.63,2019,20,3.981818181818182,3.026315789473684,109,21,130,0.6923076923076923
2019-20,RegularSeason,1628990,325,Chandler Hutchison,1610612741,CHI,28,527,80,175,0.457,12,38,0.316,46,78,0.59,18,90,108,26,27,7,27,47,218,232,0.96,1.0,2019,20,7.785714285714286,0.9629629629629629,95,32,127,0.8503937007874016
2019-20,RegularSeason,1627812,325,Yogi Ferrell,1610612758,SAC,50,530,79,188,0.42,24,79,0.304,36,42,0.857,6,43,49,69,18,4,28,38,218,215,2.46,0.64,2019,20,4.36,2.4642857142857144,109,6,115,0.4260869565217391
2019-20,RegularSeason,1628436,327,Luke Kornet,1610612741,CHI,36,559,82,187,0.439,31,108,0.287,20,28,0.714,22,62,84,32,11,26,14,54,215,241,2.29,0.79,2019,20,5.972222222222222,2.2857142857142856,105,8,113,0.7433628318584071
2019-20,RegularSeason,1629066,327,Rodions Kurucs,1610612751,BKN,47,684,79,177,0.446,33,90,0.367,24,38,0.632,25,112,137,51,25,5,46,90,215,275,1.11,0.54,2019,20,4.574468085106383,1.108695652173913,98,14,112,1.2232142857142858
2019-20,RegularSeason,203920,329,Khem Birch,1610612753,ORL,48,922,73,143,0.51,0,1,0.0,66,101,0.653,91,129,220,50,20,23,31,91,212,389,1.61,0.65,2019,20,4.416666666666667,1.6129032258064515,70,35,105,2.0952380952380953
2019-20,RegularSeason,1627774,330,Jake Layman,1610612750,MIN,23,505,81,179,0.453,24,72,0.333,24,32,0.75,17,40,57,15,17,10,24,47,210,179,0.63,0.71,2019,20,9.130434782608695,0.625,98,8,106,0.5377358490566038
2019-20,RegularSeason,1627885,331,Shaquille Harrison,1610612741,CHI,43,484,77,165,0.467,16,42,0.381,39,50,0.78,22,64,86,49,34,19,19,55,209,279,2.58,1.79,2019,20,4.8604651162790695,2.5789473684210527,88,11,99,0.8686868686868687
2019-20,RegularSeason,1629164,332,Brandon Goodwin,1610612737,ATL,34,430,76,190,0.4,26,87,0.299,28,30,0.933,11,61,72,51,12,4,29,43,206,200,1.76,0.41,2019,20,6.0588235294117645,1.7586206896551724,114,2,116,0.6206896551724138
2019-20,RegularSeason,201163,333,Wilson Chandler,1610612751,BKN,35,734,74,183,0.404,37,121,0.306,20,23,0.87,11,134,145,39,16,12,34,79,205,271,1.15,0.47,2019,20,5.857142857142857,1.1470588235294117,109,3,112,1.2946428571428572
2019-20,RegularSeason,1629744,334,Matt Thomas,1610612761,TOR,41,440,73,150,0.487,47,99,0.475,9,12,0.75,9,52,61,22,10,1,16,38,202,200,1.38,0.63,2019,20,4.926829268292683,1.375,77,3,80,0.7625
2019-20,RegularSeason,201229,335,Anthony Tolliver,1610612763,MEM,55,872,65,182,0.357,49,145,0.338,21,29,0.724,34,120,154,42,19,11,34,74,200,267,1.24,0.56,2019,20,3.6363636363636362,1.2352941176470589,117,8,125,1.232
2019-20,RegularSeason,203584,335,Troy Daniels,1610612743,DEN,47,532,72,186,0.387,46,132,0.348,10,16,0.625,12,40,52,17,11,3,12,37,200,151,1.42,0.92,2019,20,4.25531914893617,1.4166666666666667,114,6,120,0.43333333333333335
2019-20,RegularSeason,1628367,337,Josh Jackson,1610612763,MEM,22,381,70,159,0.44,23,72,0.319,35,50,0.7,11,55,66,35,18,9,28,40,198,194,1.25,0.64,2019,20,9.0,1.25,89,15,104,0.6346153846153846
2019-20,RegularSeason,1629103,338,Kelan Martin,1610612750,MIN,31,495,71,181,0.392,25,96,0.26,30,31,0.968,12,84,96,23,7,9,20,51,197,201,1.15,0.35,2019,20,6.354838709677419,1.15,110,1,111,0.8648648648648649
2019-20,RegularSeason,1629058,339,Dzanan Musa,1610612751,BKN,40,487,64,172,0.372,19,78,0.244,45,60,0.75,21,65,86,43,15,1,36,30,192,178,1.19,0.42,2019,20,4.8,1.1944444444444444,108,15,123,0.6991869918699187
2019-20,RegularSeason,1627746,340,Skal Labissiere,1610612737,ATL,33,567,81,147,0.551,3,13,0.231,25,33,0.758,65,104,169,42,7,31,30,89,190,335,1.4,0.23,2019,20,5.757575757575758,1.4,66,8,74,2.2837837837837838
2019-20,RegularSeason,1626195,340,Willy Hernangomez,1610612766,CHA,31,375,74,139,0.532,5,22,0.227,37,59,0.627,43,91,134,29,10,7,30,32,190,253,0.97,0.33,2019,20,6.129032258064516,0.9666666666666667,65,22,87,1.5402298850574712
2019-20,RegularSeason,1628372,342,Dennis Smith Jr.,1610612752,NYK,34,537,72,211,0.341,16,54,0.296,27,53,0.509,21,57,78,98,28,8,58,65,187,176,1.69,0.48,2019,20,5.5,1.6896551724137931,139,26,165,0.4727272727272727
2019-20,RegularSeason,203585,342,Rodney McGruder,1610612746,LAC,56,871,72,181,0.398,24,89,0.27,19,34,0.559,29,122,151,36,26,8,24,74,187,260,1.5,1.08,2019,20,3.3392857142857144,1.5,109,15,124,1.217741935483871
2019-20,RegularSeason,1628963,344,Marvin Bagley III,1610612758,SAC,13,334,78,167,0.467,4,22,0.182,25,31,0.806,29,68,97,10,6,12,18,43,185,197,0.56,0.33,2019,20,14.23076923076923,0.5555555555555556,89,6,95,1.0210526315789474
2019-20,RegularSeason,202688,345,Brandon Knight,1610612765,DET,25,462,59,167,0.353,45,131,0.344,20,34,0.588,4,37,41,69,10,3,38,40,183,146,1.82,0.26,2019,20,7.32,1.8157894736842106,108,14,122,0.3360655737704918
2019-20,RegularSeason,201961,345,Wayne Ellington,1610612752,NYK,36,558,61,174,0.351,50,143,0.35,11,13,0.846,4,61,65,44,13,4,18,41,183,176,2.44,0.72,2019,20,5.083333333333333,2.4444444444444446,113,2,115,0.5652173913043478
2019-20,RegularSeason,1628035,347,Alfonzo McKinnie,1610612739,CLE,40,593,73,171,0.427,14,65,0.215,22,31,0.71,37,76,113,14,23,8,26,72,182,207,0.54,0.89,2019,20,4.55,0.5384615384615384,98,9,107,1.0560747663551402
2019-20,RegularSeason,203521,348,Matthew Dellavedova,1610612739,CLE,57,821,62,175,0.354,21,91,0.231,32,37,0.865,18,57,75,180,20,2,59,78,177,277,3.05,0.34,2019,20,3.1052631578947367,3.0508474576271185,113,5,118,0.635593220338983
2019-20,RegularSeason,1629741,349,Marko Guduric,1610612763,MEM,44,484,62,157,0.395,25,83,0.301,24,26,0.923,14,59,73,45,12,8,36,34,173,178,1.25,0.33,2019,20,3.9318181818181817,1.25,95,2,97,0.7525773195876289
2019-20,RegularSeason,203459,350,Allen Crabbe,1610612750,MIN,37,653,63,177,0.356,36,119,0.303,10,14,0.714,11,66,77,33,15,4,17,47,172,166,1.94,0.88,2019,20,4.648648648648648,1.9411764705882353,114,4,118,0.652542372881356
2019-20,RegularSeason,1629048,350,Goga Bitadze,1610612754,IND,54,471,70,150,0.467,8,42,0.19,24,33,0.727,25,81,106,23,10,37,28,65,172,231,0.82,0.36,2019,20,3.185185185185185,0.8214285714285714,80,9,89,1.1910112359550562
2019-20,RegularSeason,1629642,350,Nassir Little,1610612757,POR,48,572,65,151,0.43,14,59,0.237,28,44,0.636,31,77,108,22,13,14,15,72,172,212,1.47,0.87,2019,20,3.5833333333333335,1.4666666666666666,86,16,102,1.0588235294117647
2019-20,RegularSeason,1627775,353,Patrick McCaw,1610612761,TOR,37,908,67,162,0.414,23,71,0.324,13,18,0.722,19,67,86,79,39,4,29,60,170,249,2.72,1.34,2019,20,4.594594594594595,2.7241379310344827,95,5,100,0.86
2019-20,RegularSeason,1628408,354,PJ Dozier,1610612743,DEN,29,412,65,157,0.414,17,49,0.347,21,29,0.724,10,45,55,63,14,6,27,45,168,179,2.33,0.52,2019,20,5.793103448275862,2.3333333333333335,92,8,100,0.55
2019-20,RegularSeason,203490,355,Otto Porter Jr.,1610612741,CHI,14,331,62,140,0.443,24,62,0.387,19,27,0.704,13,35,48,25,15,6,11,31,167,164,2.27,1.36,2019,20,11.928571428571429,2.272727272727273,78,8,86,0.5581395348837209
2019-20,RegularSeason,1629750,356,Javonte Green,1610612738,BOS,48,468,63,126,0.5,9,33,0.273,28,42,0.667,24,69,93,26,24,8,23,43,163,214,1.13,1.04,2019,20,3.3958333333333335,1.1304347826086956,63,14,77,1.2077922077922079
2019-20,RegularSeason,1629598,357,Chris Clemons,1610612745,HOU,33,291,57,142,0.401,37,107,0.346,10,11,0.909,4,26,30,27,9,6,19,26,161,128,1.42,0.47,2019,20,4.878787878787879,1.4210526315789473,85,1,86,0.3488372093023256
2019-20,RegularSeason,203957,358,Dante Exum,1610612739,CLE,35,486,56,119,0.471,15,43,0.349,32,43,0.744,12,55,67,40,13,8,31,38,159,182,1.29,0.42,2019,20,4.542857142857143,1.2903225806451613,63,11,74,0.9054054054054054
2019-20,RegularSeason,1628394,359,Anzejs Pasecniks,1610612764,WAS,27,437,61,116,0.526,0,3,0.0,34,58,0.586,42,65,107,18,9,12,24,75,156,199,0.75,0.38,2019,20,5.777777777777778,0.75,55,24,79,1.3544303797468353
2019-20,RegularSeason,1629109,359,Gary Clark,1610612753,ORL,42,566,54,133,0.406,39,111,0.351,9,10,0.9,37,73,110,17,6,22,10,46,156,221,1.7,0.6,2019,20,3.7142857142857144,1.7,79,1,80,1.375
2019-20,RegularSeason,203960,359,JaKarr Sampson,1610612754,IND,34,471,68,115,0.591,2,13,0.154,18,27,0.667,20,68,88,21,16,12,15,64,156,222,1.4,1.07,2019,20,4.588235294117647,1.4,47,9,56,1.5714285714285714
2019-20,RegularSeason,1629019,362,Allonzo Trier,1610612752,NYK,24,291,51,106,0.481,19,53,0.358,34,43,0.791,6,23,29,28,3,4,22,29,155,133,1.27,0.14,2019,20,6.458333333333333,1.2727272727272727,55,9,64,0.453125
2019-20,RegularSeason,1629640,363,Keldon Johnson,1610612759,SAS,17,301,53,89,0.596,13,22,0.591,35,44,0.795,10,47,57,15,14,2,13,28,154,184,1.15,1.08,2019,20,9.058823529411764,1.1538461538461537,36,9,45,1.2666666666666666
2019-20,RegularSeason,1628410,364,Edmond Sumner,1610612754,IND,31,447,61,142,0.43,14,53,0.264,16,29,0.552,11,35,46,55,15,9,22,44,152,161,2.5,0.68,2019,20,4.903225806451613,2.5,81,13,94,0.48936170212765956
2019-20,RegularSeason,1629057,365,Robert Williams III,1610612738,BOS,29,388,64,88,0.727,0,0,0.0,22,34,0.647,40,88,128,27,22,35,21,51,150,305,1.29,1.05,2019,20,5.172413793103448,1.2857142857142858,24,12,36,3.5555555555555554
2019-20,RegularSeason,1629185,366,Chris Chiozza,1610612751,BKN,28,401,55,140,0.393,27,72,0.375,5,5,1.0,9,44,53,83,21,4,32,37,142,186,2.59,0.66,2019,20,5.071428571428571,2.59375,85,0,85,0.6235294117647059
2019-20,RegularSeason,203994,367,Jusuf Nurkic,1610612757,POR,8,253,54,109,0.495,2,10,0.2,31,35,0.886,23,59,82,32,11,16,19,39,141,204,1.68,0.58,2019,20,17.625,1.6842105263157894,55,4,59,1.3898305084745763
2019-20,RegularSeason,1629026,368,Kenrich Williams,1610612740,NOP,39,832,51,147,0.347,25,97,0.258,9,26,0.346,51,135,186,57,27,21,22,88,136,292,2.59,1.23,2019,20,3.4871794871794872,2.590909090909091,96,17,113,1.6460176991150441
2019-20,RegularSeason,1629735,369,Chris Silva,1610612748,MIA,44,346,48,78,0.615,0,3,0.0,37,55,0.673,60,66,126,23,9,21,32,85,133,232,0.72,0.28,2019,20,3.022727272727273,0.71875,30,18,48,2.625
2019-20,RegularSeason,1628391,369,D.J. Wilson,1610612749,MIL,37,363,52,132,0.394,18,73,0.247,11,18,0.611,12,80,92,25,3,5,19,33,133,152,1.32,0.16,2019,20,3.5945945945945947,1.3157894736842106,80,7,87,1.0574712643678161
2019-20,RegularSeason,203943,371,Noah Vonleh,1610612743,DEN,36,378,52,92,0.565,3,15,0.2,25,32,0.781,37,87,124,28,11,6,21,40,132,233,1.33,0.52,2019,20,3.6666666666666665,1.3333333333333333,40,7,47,2.6382978723404253
2019-20,RegularSeason,1628980,372,Jacob Evans,1610612750,MIN,29,418,45,134,0.336,13,39,0.333,25,29,0.862,9,32,41,31,11,12,25,41,128,105,1.24,0.44,2019,20,4.413793103448276,1.24,89,4,93,0.44086021505376344
2019-20,RegularSeason,1626159,373,Justise Winslow,1610612763,MEM,11,352,50,129,0.388,6,27,0.222,18,27,0.667,16,57,73,44,7,5,24,38,124,141,1.83,0.29,2019,20,11.272727272727273,1.8333333333333333,79,9,88,0.8295454545454546
2019-20,RegularSeason,1629035,374,Carsen Edwards,1610612738,BOS,37,351,42,128,0.328,24,76,0.316,13,19,0.684,6,41,47,24,12,4,15,34,121,101,1.6,0.8,2019,20,3.27027027027027,1.6,86,6,92,0.5108695652173914
2019-20,RegularSeason,1629033,375,Theo Pinson,1610612752,NYK,33,365,45,155,0.29,15,80,0.188,15,16,0.938,10,44,54,56,17,4,33,35,120,107,1.7,0.52,2019,20,3.6363636363636362,1.696969696969697,110,1,111,0.4864864864864865
2019-20,RegularSeason,1627780,376,Gary Payton II,1610612764,WAS,29,432,48,116,0.414,13,46,0.283,4,8,0.5,26,54,80,48,33,7,20,54,113,189,2.4,1.65,2019,20,3.896551724137931,2.4,68,4,72,1.1111111111111112
2019-20,RegularSeason,1628997,377,Caleb Martin,1610612766,CHA,18,317,37,84,0.44,20,37,0.541,17,21,0.81,10,28,38,23,12,7,15,32,111,125,1.53,0.8,2019,20,6.166666666666667,1.5333333333333334,47,4,51,0.7450980392156863
2019-20,RegularSeason,203079,377,Dion Waiters,1610612747,LAL,10,207,41,99,0.414,15,47,0.319,14,17,0.824,2,22,24,20,4,6,16,21,111,88,1.25,0.25,2019,20,11.1,1.25,58,3,61,0.39344262295081966
2019-20,RegularSeason,201584,379,Courtney Lee,1610612742,DAL,24,345,40,82,0.488,21,47,0.447,6,7,0.857,7,25,32,12,18,6,11,33,107,121,1.09,1.64,2019,20,4.458333333333333,1.0909090909090908,42,1,43,0.7441860465116279
2019-20,RegularSeason,1627733,379,Dragan Bender,1610612744,GSW,16,286,41,92,0.446,15,43,0.349,10,14,0.714,16,57,73,28,4,9,21,42,107,145,1.33,0.19,2019,20,6.6875,1.3333333333333333,51,4,55,1.3272727272727274
2019-20,RegularSeason,1629234,379,Drew Eubanks,1610612759,SAS,22,272,43,67,0.642,1,1,1.0,20,26,0.769,28,57,85,15,5,17,21,37,107,178,0.71,0.24,2019,20,4.863636363636363,0.7142857142857143,24,6,30,2.8333333333333335
2019-20,RegularSeason,1628392,379,Isaiah Hartenstein,1610612745,HOU,23,266,44,67,0.657,0,5,0.0,19,28,0.679,29,61,90,18,9,12,16,41,107,188,1.13,0.56,2019,20,4.6521739130434785,1.125,23,9,32,2.8125
2019-20,RegularSeason,1628021,383,David Nwaba,1610612745,HOU,20,268,37,71,0.521,12,28,0.429,18,27,0.667,8,37,45,8,11,12,8,32,104,129,1.0,1.38,2019,20,5.2,1.0,34,9,43,1.0465116279069768
2019-20,RegularSeason,1629126,383,Deonte Burton,1610612760,OKC,39,357,43,125,0.344,10,53,0.189,8,14,0.571,7,50,57,17,7,10,19,34,104,88,0.9,0.37,2019,20,2.6666666666666665,0.8947368421052632,82,6,88,0.6477272727272727
2019-20,RegularSeason,201939,383,Stephen Curry,1610612744,GSW,5,139,33,82,0.402,12,49,0.245,26,26,1.0,4,22,26,33,5,2,16,11,104,105,2.06,0.31,2019,20,20.8,2.0625,49,0,49,0.5306122448979592
2019-20,RegularSeason,203124,386,Kyle O'Quinn,1610612755,PHI,29,313,42,85,0.494,7,27,0.259,11,20,0.55,34,82,116,51,7,24,20,37,102,228,2.55,0.35,2019,20,3.5172413793103448,2.55,43,9,52,2.230769230769231
2019-20,RegularSeason,1629660,386,Ty Jerome,1610612756,PHX,31,328,38,113,0.336,14,50,0.28,12,16,0.75,7,39,46,44,15,3,18,29,102,113,2.44,0.83,2019,20,3.2903225806451615,2.4444444444444446,75,4,79,0.5822784810126582
2019-20,RegularSeason,1629678,388,Admiral Schofield,1610612764,WAS,33,368,35,92,0.38,19,61,0.311,10,15,0.667,7,40,47,15,8,4,7,50,99,104,2.14,1.14,2019,20,3.0,2.142857142857143,57,5,62,0.7580645161290323
2019-20,RegularSeason,1629611,388,Terance Mann,1610612746,LAC,41,362,37,79,0.468,7,20,0.35,18,27,0.667,10,45,55,53,11,5,18,46,99,154,2.94,0.61,2019,20,2.4146341463414633,2.9444444444444446,42,9,51,1.0784313725490196
2019-20,RegularSeason,1629726,390,Garrison Mathews,1610612764,WAS,18,227,24,56,0.429,19,46,0.413,31,34,0.912,6,18,24,10,8,1,8,32,98,98,1.25,1.0,2019,20,5.444444444444445,1.25,32,3,35,0.6857142857142857
2019-20,RegularSeason,204025,391,Tim Frazier,1610612765,DET,27,355,34,94,0.362,10,30,0.333,19,24,0.792,9,24,33,93,14,4,36,42,97,140,2.58,0.39,2019,20,3.5925925925925926,2.5833333333333335,60,5,65,0.5076923076923077
2019-20,RegularSeason,2738,392,Andre Iguodala,1610612748,MIA,21,418,38,88,0.432,14,47,0.298,6,15,0.4,17,61,78,51,14,21,26,35,96,175,1.96,0.54,2019,20,4.571428571428571,1.9615384615384615,50,9,59,1.3220338983050848
2019-20,RegularSeason,1627790,392,Ante Zizic,1610612739,CLE,22,221,41,72,0.569,0,0,0.0,14,19,0.737,18,48,66,6,7,5,10,27,96,134,0.6,0.7,2019,20,4.363636363636363,0.6,31,5,36,1.8333333333333333
2019-20,RegularSeason,1628395,394,Jordan Bell,1610612739,CLE,29,256,35,67,0.522,4,12,0.333,19,31,0.613,30,51,81,16,3,10,21,19,93,138,0.76,0.14,2019,20,3.206896551724138,0.7619047619047619,32,12,44,1.8409090909090908
2019-20,RegularSeason,200757,395,Thabo Sefolosha,1610612745,HOU,41,436,37,91,0.407,15,54,0.278,3,8,0.375,21,72,93,25,24,12,15,43,92,172,1.67,1.6,2019,20,2.2439024390243905,1.6666666666666667,54,5,59,1.576271186440678
2019-20,RegularSeason,203998,396,Bruno Caboclo,1610612745,HOU,30,244,38,89,0.427,6,33,0.182,8,9,0.889,23,37,60,12,15,17,13,31,90,129,0.92,1.15,2019,20,3.0,0.9230769230769231,51,1,52,1.1538461538461537
2019-20,RegularSeason,1629667,397,Jalen McDaniels,1610612766,CHA,16,293,33,70,0.471,9,24,0.375,14,17,0.824,15,50,65,13,8,3,11,36,89,127,1.18,0.73,2019,20,5.5625,1.1818181818181819,37,3,40,1.625
2019-20,RegularSeason,1629713,397,Justin James,1610612758,SAC,36,232,35,84,0.417,9,29,0.31,10,21,0.476,6,26,32,18,6,9,8,17,89,86,2.25,0.75,2019,20,2.4722222222222223,2.25,49,11,60,0.5333333333333333
2019-20,RegularSeason,1626166,399,Cameron Payne,1610612756,PHX,8,183,33,68,0.485,15,29,0.517,6,7,0.857,4,27,31,24,8,2,11,20,87,105,2.18,0.73,2019,20,10.875,2.1818181818181817,35,1,36,0.8611111111111112
2019-20,RegularSeason,201960,399,DeMarre Carroll,1610612745,HOU,24,290,25,66,0.379,8,33,0.242,29,42,0.69,12,43,55,25,8,5,17,32,87,109,1.47,0.47,2019,20,3.625,1.4705882352941178,41,13,54,1.0185185185185186
2019-20,RegularSeason,1626245,401,Cristiano Felicio,1610612741,CHI,22,386,34,54,0.63,0,2,0.0,18,23,0.783,55,47,102,16,10,2,18,34,86,173,0.89,0.56,2019,20,3.909090909090909,0.8888888888888888,20,5,25,4.08
2019-20,RegularSeason,1628388,402,T.J. Leaf,1610612754,IND,28,222,36,86,0.419,5,18,0.278,7,16,0.438,23,48,71,9,10,4,8,22,84,111,1.13,1.25,2019,20,3.0,1.125,50,9,59,1.2033898305084745
2019-20,RegularSeason,201587,403,Nicolas Batum,1610612766,CHA,22,505,28,81,0.346,14,49,0.286,9,10,0.9,25,75,100,66,17,8,22,41,79,194,3.0,0.77,2019,20,3.590909090909091,3.0,53,1,54,1.8518518518518519
2019-20,RegularSeason,1629641,403,Romeo Langford,1610612738,BOS,32,370,28,80,0.35,5,27,0.185,18,25,0.72,15,26,41,13,8,8,11,33,79,79,1.18,0.73,2019,20,2.46875,1.1818181818181819,52,7,59,0.6949152542372882
2019-20,RegularSeason,202329,405,Al-Farouq Aminu,1610612753,ORL,18,380,25,86,0.291,9,36,0.25,19,29,0.655,24,63,87,21,18,8,17,27,78,124,1.24,1.06,2019,20,4.333333333333333,1.2352941176470589,61,10,71,1.2253521126760563
2019-20,RegularSeason,1628539,406,Mychal Mulder,1610612744,GSW,7,204,26,67,0.388,16,52,0.308,9,12,0.75,3,20,23,8,2,1,5,20,77,62,1.6,0.4,2019,20,11.0,1.6,41,3,44,0.5227272727272727
2019-20,RegularSeason,1628380,406,Zach Collins,1610612757,POR,11,290,32,68,0.471,7,19,0.368,6,8,0.75,25,44,69,16,5,5,14,36,77,120,1.14,0.36,2019,20,7.0,1.1428571428571428,36,2,38,1.8157894736842106
2019-20,RegularSeason,1629151,408,Ryan Broekhoff,1610612755,PHI,17,180,22,59,0.373,20,51,0.392,7,8,0.875,5,38,43,11,5,4,6,15,71,90,1.83,0.83,2019,20,4.176470588235294,1.8333333333333333,37,1,38,1.131578947368421
2019-20,RegularSeason,1629308,409,Juan Toscano-Anderson,1610612744,GSW,13,272,29,63,0.46,8,23,0.348,3,5,0.6,9,43,52,26,13,5,16,30,69,113,1.63,0.81,2019,20,5.3076923076923075,1.625,34,2,36,1.4444444444444444
2019-20,RegularSeason,201162,410,Jared Dudley,1610612747,LAL,45,364,24,60,0.4,18,42,0.429,2,2,1.0,6,46,52,28,15,3,8,41,68,122,3.5,1.88,2019,20,1.511111111111111,3.5,36,0,36,1.4444444444444444
2019-20,RegularSeason,1626172,410,Kevon Looney,1610612744,GSW,20,262,29,79,0.367,1,14,0.071,9,12,0.75,28,38,66,20,12,6,12,34,68,107,1.67,1.0,2019,20,3.4,1.6666666666666667,50,3,53,1.2452830188679245
2019-20,RegularSeason,1629651,412,Nic Claxton,1610612751,BKN,15,187,27,48,0.563,1,7,0.143,11,21,0.524,19,25,44,16,1,8,9,14,66,95,1.78,0.11,2019,20,4.4,1.7777777777777777,21,10,31,1.4193548387096775
2019-20,RegularSeason,1628403,413,Caleb Swanigan,1610612757,POR,27,288,28,47,0.596,0,2,0.0,9,17,0.529,27,73,100,31,3,7,37,62,65,142,0.84,0.08,2019,20,2.4074074074074074,0.8378378378378378,19,8,27,3.7037037037037037
2019-20,RegularSeason,101139,414,CJ Miles,1610612764,WAS,10,161,19,59,0.322,11,35,0.314,15,20,0.75,4,8,12,12,10,4,4,14,64,53,3.0,2.5,2019,20,6.4,3.0,40,5,45,0.26666666666666666
2019-20,RegularSeason,1629725,414,Jeremiah Martin,1610612751,BKN,9,99,24,53,0.453,5,18,0.278,11,14,0.786,1,9,10,18,7,2,4,7,64,65,4.5,1.75,2019,20,7.111111111111111,4.5,29,3,32,0.3125
2019-20,RegularSeason,1629117,416,Wenyen Gabriel,1610612757,POR,30,235,21,48,0.438,6,20,0.3,15,22,0.682,21,31,52,8,11,7,16,39,63,91,0.5,0.69,2019,20,2.1,0.5,27,7,34,1.5294117647058822
2019-20,RegularSeason,202323,417,Evan Turner,1610612750,MIN,19,251,25,67,0.373,0,5,0.0,12,14,0.857,8,30,38,38,9,8,26,20,62,85,1.46,0.35,2019,20,3.263157894736842,1.4615384615384615,42,2,44,0.8636363636363636
2019-20,RegularSeason,1628412,417,Frank Mason III,1610612749,MIL,9,118,23,51,0.451,6,21,0.286,10,17,0.588,5,14,19,29,5,1,11,11,62,70,2.64,0.46,2019,20,6.888888888888889,2.6363636363636362,28,7,35,0.5428571428571428
2019-20,RegularSeason,1629730,417,Rayjon Tucker,1610612762,UTA,20,161,20,43,0.465,3,17,0.176,19,23,0.826,3,17,20,5,1,1,8,10,62,54,0.63,0.13,2019,20,3.1,0.625,23,4,27,0.7407407407407407
2019-20,RegularSeason,203077,420,Michael Kidd-Gilchrist,1610612742,DAL,25,281,22,66,0.333,5,20,0.25,11,14,0.786,14,53,67,14,2,6,16,37,60,86,0.88,0.13,2019,20,2.4,0.875,44,3,47,1.425531914893617
2019-20,RegularSeason,1626169,420,Stanley Johnson,1610612761,TOR,25,150,22,59,0.373,7,24,0.292,9,16,0.563,7,30,37,20,6,4,15,16,60,68,1.33,0.4,2019,20,2.4,1.3333333333333333,37,7,44,0.8409090909090909
2019-20,RegularSeason,1629346,422,Alen Smailagic,1610612744,GSW,14,139,20,40,0.5,3,13,0.231,16,19,0.842,10,17,27,13,3,4,11,14,59,72,1.18,0.27,2019,20,4.214285714285714,1.1818181818181819,20,3,23,1.173913043478261
2019-20,RegularSeason,1629599,423,Amir Coffey,1610612746,LAC,18,159,23,54,0.426,6,19,0.316,6,11,0.545,4,12,16,14,5,2,8,20,58,51,1.75,0.63,2019,20,3.2222222222222223,1.75,31,5,36,0.4444444444444444
2019-20,RegularSeason,1629002,423,Chimezie Metu,1610612759,SAS,18,105,24,42,0.571,0,2,0.0,10,13,0.769,12,21,33,10,3,6,10,7,58,79,1.0,0.3,2019,20,3.2222222222222223,1.0,18,3,21,1.5714285714285714
2019-20,RegularSeason,1629669,425,Jaylen Nowell,1610612750,MIN,15,151,19,53,0.358,3,26,0.115,16,17,0.941,3,10,13,19,3,1,3,11,57,55,6.33,1.0,2019,20,3.8,6.333333333333333,34,1,35,0.37142857142857144
2019-20,RegularSeason,203658,425,Norvel Pelle,1610612755,PHI,24,232,25,48,0.521,0,1,0.0,7,14,0.5,20,52,72,8,3,31,18,55,57,123,0.44,0.17,2019,20,2.375,0.4444444444444444,23,7,30,2.4
2019-20,RegularSeason,203648,427,Thanasis Antetokounmpo,1610612749,MIL,20,129,24,48,0.5,0,10,0.0,7,17,0.412,12,12,24,15,7,2,12,18,55,57,1.25,0.58,2019,20,2.75,1.25,24,10,34,0.7058823529411765
2019-20,RegularSeason,202697,428,Iman Shumpert,1610612751,BKN,13,241,21,64,0.328,8,33,0.242,4,7,0.571,9,25,34,12,12,2,10,21,54,58,1.2,1.2,2019,20,4.153846153846154,1.2,43,3,46,0.7391304347826086
2019-20,RegularSeason,1629723,428,John Konchar,1610612763,MEM,19,181,24,37,0.649,5,10,0.5,1,2,0.5,18,29,47,22,7,3,7,7,54,112,3.14,1.0,2019,20,2.8421052631578947,3.142857142857143,13,1,14,3.357142857142857
2019-20,RegularSeason,1628476,430,Derrick Walton Jr.,1610612765,DET,26,248,18,39,0.462,10,24,0.417,7,9,0.778,2,14,16,27,7,0,5,21,53,75,5.4,1.4,2019,20,2.0384615384615383,5.4,21,2,23,0.6956521739130435
2019-20,RegularSeason,202334,431,Ed Davis,1610612762,UTA,28,303,22,46,0.478,0,0,0.0,7,14,0.5,35,70,105,12,11,9,13,61,51,144,0.92,0.85,2019,20,1.8214285714285714,0.9230769230769231,24,7,31,3.3870967741935485
2019-20,RegularSeason,1629610,432,DaQuan Jeffries,1610612758,SAC,13,141,20,40,0.5,5,18,0.278,5,6,0.833,3,15,18,7,4,1,2,19,50,57,3.5,2.0,2019,20,3.8461538461538463,3.5,20,1,21,0.8571428571428571
2019-20,RegularSeason,1628443,432,Kadeem Allen,1610612752,NYK,10,117,19,44,0.432,5,16,0.313,7,11,0.636,2,7,9,21,5,2,8,7,50,50,2.63,0.63,2019,20,5.0,2.625,25,4,29,0.3103448275862069
2019-20,RegularSeason,1629140,434,Johnathan Williams,1610612764,WAS,15,180,19,34,0.559,0,2,0.0,7,13,0.538,24,40,64,8,1,8,5,16,45,100,1.6,0.2,2019,20,3.0,1.6,15,6,21,3.0476190476190474
2019-20,RegularSeason,1629662,435,Mfiondu Kabengele,1610612746,LAC,12,64,14,32,0.438,9,20,0.45,5,5,1.0,1,10,11,2,2,2,2,9,42,39,1.0,1.0,2019,20,3.5,1.0,18,0,18,0.6111111111111112
2019-20,RegularSeason,1629738,436,Vincent Poirier,1610612738,BOS,22,130,17,36,0.472,1,2,0.5,6,7,0.857,13,30,43,8,2,9,8,25,41,75,1.0,0.25,2019,20,1.8636363636363635,1.0,19,1,20,2.15
2019-20,RegularSeason,1629626,437,Bol Bol,1610612743,DEN,7,87,14,28,0.5,4,9,0.444,8,10,0.8,5,14,19,6,2,6,10,11,40,47,0.6,0.2,2019,20,5.714285714285714,0.6,14,2,16,1.1875
2019-20,RegularSeason,1628982,437,Melvin Frazier Jr.,1610612753,ORL,19,126,15,34,0.441,8,16,0.5,2,4,0.5,2,8,10,3,9,2,5,11,40,38,0.6,1.8,2019,20,2.1052631578947367,0.6,19,2,21,0.47619047619047616
2019-20,RegularSeason,1629682,437,Tremont Waters,1610612738,BOS,11,119,14,49,0.286,4,24,0.167,8,8,1.0,0,12,12,16,10,2,15,13,40,30,1.07,0.67,2019,20,3.6363636363636362,1.0666666666666667,35,0,35,0.34285714285714286
2019-20,RegularSeason,1627820,437,Tyrone Wallace,1610612737,ATL,14,160,14,44,0.318,1,15,0.067,11,17,0.647,3,19,22,13,7,1,10,19,40,37,1.3,0.7,2019,20,2.857142857142857,1.3,30,6,36,0.6111111111111112
2019-20,RegularSeason,1629743,441,Donta Hall,1610612751,BKN,9,133,15,22,0.682,0,0,0.0,9,18,0.5,14,24,38,4,3,6,5,23,39,69,0.8,0.6,2019,20,4.333333333333333,0.8,7,9,16,2.375
2019-20,RegularSeason,1629658,442,Jaylen Hoard,1610612757,POR,13,103,15,32,0.469,0,3,0.0,8,13,0.615,14,18,32,4,5,0,4,12,38,53,1.0,1.25,2019,20,2.923076923076923,1.0,17,5,22,1.4545454545454546
2019-20,RegularSeason,1629052,443,Oshae Brissett,1610612761,TOR,19,135,13,36,0.361,3,15,0.2,8,10,0.8,9,17,26,7,4,1,7,18,37,43,1.0,0.57,2019,20,1.9473684210526316,1.0,23,2,25,1.04
2019-20,RegularSeason,1629752,444,Juwan Morgan,1610612762,UTA,21,134,15,26,0.577,3,8,0.375,3,4,0.75,10,19,29,6,1,2,6,19,36,56,1.0,0.17,2019,20,1.7142857142857142,1.0,11,1,12,2.4166666666666665
2019-20,RegularSeason,1629139,444,Yuta Watanabe,1610612763,MEM,18,105,15,34,0.441,3,8,0.375,3,8,0.375,7,13,20,5,5,1,2,9,36,41,2.5,2.5,2019,20,2.0,2.5,19,5,24,0.8333333333333334
2019-20,RegularSeason,1626259,446,Malcolm Miller,1610612761,TOR,28,162,12,29,0.414,8,22,0.364,3,8,0.375,2,14,16,11,5,2,4,18,35,43,2.75,1.25,2019,20,1.25,2.75,17,5,22,0.7272727272727273
2019-20,RegularSeason,1629671,446,Miye Oni,1610612762,UTA,10,109,12,32,0.375,7,19,0.368,4,5,0.8,5,12,17,4,4,2,4,9,35,37,1.0,1.0,2019,20,3.5,1.0,20,1,21,0.8095238095238095
2019-20,RegularSeason,1628993,448,Alize Johnson,1610612754,IND,17,118,12,29,0.414,3,8,0.375,7,10,0.7,16,32,48,7,3,2,7,12,34,67,1.0,0.43,2019,20,2.0,1.0,17,3,20,2.4
2019-20,RegularSeason,1629659,448,Talen Horton-Tucker,1610612747,LAL,6,81,14,30,0.467,4,13,0.308,2,4,0.5,2,5,7,6,8,1,6,10,34,32,1.0,1.33,2019,20,5.666666666666667,1.0,16,2,18,0.3888888888888889
2019-20,RegularSeason,2199,448,Tyson Chandler,1610612745,HOU,26,219,14,18,0.778,0,0,0.0,6,13,0.462,25,41,66,6,6,8,8,32,34,101,0.75,0.75,2019,20,1.3076923076923077,0.75,4,7,11,6.0
2019-20,RegularSeason,1629690,451,Adam Mokoka,1610612741,CHI,11,112,12,28,0.429,6,15,0.4,2,4,0.5,7,3,10,4,4,0,2,17,32,30,2.0,2.0,2019,20,2.909090909090909,2.0,16,2,18,0.5555555555555556
2019-20,RegularSeason,1628778,452,Paul Watson,1610612761,TOR,10,87,10,26,0.385,4,12,0.333,7,9,0.778,2,15,17,8,4,1,3,5,31,40,2.67,1.33,2019,20,3.1,2.6666666666666665,16,2,18,0.9444444444444444
2019-20,RegularSeason,1629168,453,BJ Johnson,1610612753,ORL,10,83,9,32,0.281,3,9,0.333,9,10,0.9,3,12,15,3,3,0,6,3,30,21,0.5,0.5,2019,20,3.0,0.5,23,1,24,0.625
2019-20,RegularSeason,1628405,454,Johnathan Motley,1610612746,LAC,13,41,11,15,0.733,1,1,1.0,5,7,0.714,3,7,10,8,3,0,5,6,28,38,1.6,0.6,2019,20,2.1538461538461537,1.6,4,2,6,1.6666666666666667
2019-20,RegularSeason,1626147,454,Justin Anderson,1610612751,BKN,10,107,10,38,0.263,6,29,0.207,2,4,0.5,1,20,21,8,0,6,4,13,28,29,2.0,0.0,2019,20,2.8,2.0,28,2,30,0.7
2019-20,RegularSeason,1626170,456,Jerian Grant,1610612764,WAS,6,80,10,27,0.37,2,8,0.25,5,7,0.714,2,4,6,9,1,1,3,11,27,22,3.0,0.33,2019,20,4.5,3.0,17,2,19,0.3157894736842105
2019-20,RegularSeason,1626187,456,Michael Frazier II,1610612745,HOU,13,145,7,29,0.241,4,23,0.174,9,14,0.643,1,9,10,2,2,0,5,22,27,9,0.4,0.4,2019,20,2.076923076923077,0.4,22,5,27,0.37037037037037035
2019-20,RegularSeason,202951,458,Jeremy Pargo,1610612744,GSW,3,44,11,22,0.5,3,7,0.429,0,1,0.0,1,2,3,8,1,0,4,8,25,21,2.0,0.25,2019,20,8.333333333333334,2.0,11,1,12,0.25
2019-20,RegularSeason,1629714,459,Jarrell Brantley,1610612762,UTA,9,96,10,28,0.357,3,13,0.231,1,2,0.5,2,18,20,11,3,5,7,7,24,37,1.57,0.43,2019,20,2.6666666666666665,1.5714285714285714,18,1,19,1.0526315789473684
2019-20,RegularSeason,202498,459,Lance Thomas,1610612751,BKN,7,98,8,23,0.348,4,13,0.308,4,4,1.0,2,11,13,6,0,0,6,11,24,22,1.0,0.0,2019,20,3.4285714285714284,1.0,15,0,15,0.8666666666666667
2019-20,RegularSeason,1629605,461,Tacko Fall,1610612738,BOS,7,33,11,14,0.786,0,0,0.0,1,3,0.333,1,14,15,1,1,4,3,7,23,36,0.33,0.33,2019,20,3.2857142857142856,0.3333333333333333,3,2,5,3.0
2019-20,RegularSeason,1629076,461,Tyler Cook,1610612743,DEN,13,54,8,12,0.667,0,0,0.0,7,8,0.875,6,8,14,1,3,0,3,5,23,33,0.33,1.0,2019,20,1.7692307692307692,0.3333333333333333,4,1,5,2.8
2019-20,RegularSeason,1629216,463,Gabe Vincent,1610612748,MIA,9,83,8,37,0.216,6,27,0.222,0,0,0.0,0,5,5,6,5,0,1,6,22,8,6.0,5.0,2019,20,2.4444444444444446,6.0,29,0,29,0.1724137931034483
2019-20,RegularSeason,203460,464,Andre Roberson,1610612760,OKC,7,87,8,29,0.276,3,14,0.214,1,2,0.5,7,20,27,4,1,3,2,13,20,31,2.0,0.5,2019,20,2.857142857142857,2.0,21,1,22,1.2272727272727273
2019-20,RegularSeason,1629718,464,Charlie Brown Jr.,1610612737,ATL,10,40,6,19,0.316,3,9,0.333,5,5,1.0,2,2,4,2,2,2,3,3,20,14,0.67,0.67,2019,20,2.0,0.6666666666666666,13,0,13,0.3076923076923077
2019-20,RegularSeason,1629731,464,Dean Wade,1610612739,CLE,12,71,9,13,0.692,2,4,0.5,0,1,0.0,3,16,19,2,2,4,3,8,20,39,0.67,0.67,2019,20,1.6666666666666667,0.6666666666666666,4,1,5,3.8
2019-20,RegularSeason,1628985,464,Devon Hall,1610612760,OKC,11,81,6,30,0.2,4,17,0.235,4,8,0.5,2,5,7,13,4,1,5,6,20,12,2.6,0.8,2019,20,1.8181818181818181,2.6,24,4,28,0.25
2019-20,RegularSeason,1629663,464,Louis King,1610612765,DET,10,62,8,21,0.381,4,11,0.364,0,3,0.0,1,9,10,5,2,0,2,10,20,19,2.5,1.0,2019,20,2.0,2.5,13,3,16,0.625
2019-20,RegularSeason,1627784,469,Jarrod Uthoff,1610612764,WAS,7,53,7,18,0.389,3,9,0.333,2,2,1.0,2,4,6,0,1,0,0,2,19,15,0.0,0.0,2019,20,2.7142857142857144,,11,0,11,0.5454545454545454
2019-20,RegularSeason,1629625,469,Justin Wright-Foreman,1610612762,UTA,4,45,7,20,0.35,2,10,0.2,3,4,0.75,0,5,5,7,2,0,3,5,19,16,2.33,0.67,2019,20,4.75,2.3333333333333335,13,1,14,0.35714285714285715
2019-20,RegularSeason,1629649,471,Ignas Brazdeikis,1610612752,NYK,9,53,6,22,0.273,1,9,0.111,4,5,0.8,2,3,5,4,0,1,2,3,17,8,2.0,0.0,2019,20,1.8888888888888888,2.0,16,1,17,0.29411764705882354
2019-20,RegularSeason,2747,471,JR Smith,1610612747,LAL,6,79,7,22,0.318,1,11,0.091,2,2,1.0,0,5,5,3,1,0,4,5,17,7,0.75,0.25,2019,20,2.8333333333333335,0.75,15,0,15,0.3333333333333333
2019-20,RegularSeason,1628987,471,Kevin Hervey,1610612760,OKC,10,52,7,27,0.259,3,20,0.15,0,0,0.0,1,11,12,5,1,1,0,4,17,16,0.0,0.0,2019,20,1.7,inf,20,0,20,0.6
2019-20,RegularSeason,1629017,471,Khyri Thomas,1610612765,DET,8,61,5,17,0.294,5,14,0.357,2,4,0.5,1,0,1,3,3,0,3,9,17,7,1.0,1.0,2019,20,2.125,1.0,12,2,14,0.07142857142857142
2019-20,RegularSeason,1628427,471,Vlatko Cancar,1610612743,DEN,14,45,6,15,0.4,1,6,0.167,4,4,1.0,5,5,10,3,1,1,3,7,17,20,1.0,0.33,2019,20,1.2142857142857142,1.0,9,0,9,1.1111111111111112
2019-20,RegularSeason,1629677,476,Luka Samanic,1610612759,SAS,3,48,5,16,0.313,3,8,0.375,3,4,0.75,1,9,10,6,0,2,2,6,16,20,3.0,0.0,2019,20,5.333333333333333,3.0,11,1,12,0.8333333333333334
2019-20,RegularSeason,1628414,476,Sindarius Thornwell,1610612740,NOP,2,35,6,11,0.545,2,4,0.5,2,4,0.5,0,4,4,4,1,1,2,2,16,17,2.0,0.5,2019,20,8.0,2.0,5,2,7,0.5714285714285714
2019-20,RegularSeason,1628518,478,Amile Jefferson,1610612753,ORL,18,74,5,14,0.357,0,0,0.0,5,14,0.357,10,13,23,4,1,3,3,7,15,25,1.33,0.33,2019,20,0.8333333333333334,1.3333333333333333,9,9,18,1.2777777777777777
2019-20,RegularSeason,1629724,478,Vic Law,1610612753,ORL,8,62,6,18,0.333,1,7,0.143,2,6,0.333,2,9,11,3,2,0,2,6,15,13,1.5,1.0,2019,20,1.875,1.5,12,4,16,0.6875
2019-20,RegularSeason,202718,480,Chandler Parsons,1610612737,ATL,5,54,5,18,0.278,4,14,0.286,0,0,0.0,1,6,7,3,4,1,3,3,14,13,1.0,1.33,2019,20,2.8,1.0,13,0,13,0.5384615384615384
2019-20,RegularSeason,1629608,480,Dewan Hernandez,1610612761,TOR,6,28,5,14,0.357,1,2,0.5,3,5,0.6,5,9,14,3,1,0,3,6,14,18,1.0,0.33,2019,20,2.3333333333333335,1.0,9,2,11,1.2727272727272727
2019-20,RegularSeason,201149,480,Joakim Noah,1610612746,LAC,5,50,4,8,0.5,0,0,0.0,6,8,0.75,5,11,16,7,1,1,6,9,14,27,1.17,0.17,2019,20,2.8,1.1666666666666667,4,2,6,2.6666666666666665
2019-20,RegularSeason,1628513,480,Naz Mitrou-Long,1610612754,IND,5,47,6,17,0.353,2,12,0.167,0,0,0.0,0,7,7,8,1,1,3,2,14,17,2.67,0.33,2019,20,2.8,2.6666666666666665,11,0,11,0.6363636363636364
2019-20,RegularSeason,1628430,480,Nigel Williams-Goss,1610612762,UTA,10,50,5,16,0.313,2,7,0.286,2,2,1.0,2,4,6,6,3,1,3,6,14,16,2.0,1.0,2019,20,1.4,2.0,11,0,11,0.5454545454545454
2019-20,RegularSeason,1629620,485,Justin Robinson,1610612764,WAS,9,49,5,12,0.417,3,5,0.6,0,0,0.0,1,4,5,7,0,1,3,2,13,16,2.33,0.0,2019,20,1.4444444444444444,2.3333333333333335,7,0,7,0.7142857142857143
2019-20,RegularSeason,1628605,486,Dusty Hannahs,1610612763,MEM,2,13,4,9,0.444,2,3,0.667,2,2,1.0,0,1,1,0,0,0,0,1,12,8,0.0,0.0,2019,20,6.0,,5,0,5,0.2
2019-20,RegularSeason,1629020,486,Jarred Vanderbilt,1610612750,MIN,11,47,5,8,0.625,0,1,0.0,2,2,1.0,3,6,9,2,3,1,7,6,12,17,0.29,0.43,2019,20,1.0909090909090908,0.2857142857142857,3,0,3,3.0
2019-20,RegularSeason,1629648,486,Jordan Bone,1610612765,DET,10,53,5,20,0.25,2,10,0.2,0,0,0.0,0,4,4,8,1,0,2,6,12,8,4.0,0.5,2019,20,1.2,4.0,15,0,15,0.26666666666666666
2019-20,RegularSeason,203705,486,Josh Magette,1610612753,ORL,8,38,5,15,0.333,1,4,0.25,1,2,0.5,1,5,6,5,3,1,5,4,12,11,1.0,0.6,2019,20,1.5,1.0,10,1,11,0.5454545454545454
2019-20,RegularSeason,1629683,486,Quinndary Weatherspoon,1610612759,SAS,11,78,5,17,0.294,1,5,0.2,1,2,0.5,1,6,7,11,3,1,5,8,12,16,2.2,0.6,2019,20,1.0909090909090908,2.2,12,1,13,0.5384615384615384
2019-20,RegularSeason,2617,486,Udonis Haslem,1610612748,MIA,4,44,4,11,0.364,1,3,0.333,3,4,0.75,1,15,16,1,0,0,1,6,12,20,1.0,0.0,2019,20,3.0,1.0,7,1,8,2.0
2019-20,RegularSeason,1629597,486,Zylan Cheatham,1610612740,NOP,4,51,6,9,0.667,0,1,0.0,0,0,0.0,3,6,9,3,1,1,4,10,12,19,0.75,0.25,2019,20,3.0,0.75,3,0,3,3.0
2019-20,RegularSeason,1628499,493,Antonius Cleveland,1610612742,DAL,11,46,4,14,0.286,0,3,0.0,3,5,0.6,2,5,7,1,1,3,2,8,11,9,0.5,0.5,2019,20,1.0,0.5,10,2,12,0.5833333333333334
2019-20,RegularSeason,1629621,493,Marial Shayok,1610612755,PHI,4,28,3,12,0.25,2,6,0.333,3,4,0.75,1,6,7,1,0,1,3,4,11,7,0.33,0.0,2019,20,2.75,0.3333333333333333,9,1,10,0.7
2019-20,RegularSeason,1629650,493,Moses Brown,1610612757,POR,9,33,4,10,0.4,0,0,0.0,3,8,0.375,3,11,14,1,1,1,3,7,11,14,0.33,0.33,2019,20,1.2222222222222223,0.3333333333333333,6,5,11,1.2727272727272727
2019-20,RegularSeason,1629665,496,Jalen Lecque,1610612756,PHX,5,32,4,10,0.4,0,4,0.0,2,2,1.0,0,2,2,2,0,0,2,3,10,6,1.0,0.0,2019,20,2.0,1.0,6,0,6,0.3333333333333333
2019-20,RegularSeason,1628413,496,Jonah Bolden,1610612756,PHX,7,47,4,11,0.364,0,4,0.0,2,4,0.5,3,6,9,0,3,2,2,10,10,13,0.0,1.5,2019,20,1.4285714285714286,0.0,7,2,9,1.0
2019-20,RegularSeason,1629668,496,Zach Norvell Jr.,1610612744,GSW,5,41,3,12,0.25,3,8,0.375,1,1,1.0,0,6,6,3,2,0,3,4,10,9,1.0,0.67,2019,20,2.0,1.0,9,0,9,0.6666666666666666
2019-20,RegularSeason,1628383,499,Justin Patton,1610612765,DET,5,24,4,10,0.4,1,4,0.25,0,0,0.0,1,4,5,2,0,0,2,4,9,8,1.0,0.0,2019,20,1.8,1.0,6,0,6,0.8333333333333334
2019-20,RegularSeason,1629044,499,Shamorie Ponds,1610612761,TOR,4,11,3,5,0.6,1,2,0.5,2,2,1.0,0,1,1,2,0,1,0,2,9,11,0.0,0.0,2019,20,2.25,inf,2,0,2,0.5
2019-20,RegularSeason,1629729,501,Josh Reaves,1610612742,DAL,4,28,3,9,0.333,0,2,0.0,2,2,1.0,1,2,3,3,0,0,0,5,8,8,0.0,0.0,2019,20,2.0,inf,6,0,6,0.5
2019-20,RegularSeason,1629015,501,Zhaire Smith,1610612755,PHI,7,32,3,11,0.273,0,3,0.0,2,4,0.5,0,2,2,2,3,0,2,4,8,3,1.0,1.5,2019,20,1.1428571428571428,1.0,8,2,10,0.2
2019-20,RegularSeason,1629644,503,KZ Okpala,1610612748,MIA,5,26,3,5,0.6,0,1,0.0,1,2,0.5,1,4,5,1,2,1,1,2,7,12,1.0,2.0,2019,20,1.4,1.0,2,1,3,1.6666666666666667
2019-20,RegularSeason,1628961,503,Kostas Antetokounmpo,1610612747,LAL,5,20,3,3,1.0,0,0,0.0,1,2,0.5,2,1,3,2,0,0,1,2,7,10,2.0,0.0,2019,20,1.4,2.0,0,1,1,3.0
2019-20,RegularSeason,1628968,505,Brian Bowen II,1610612754,IND,6,31,3,10,0.3,0,2,0.0,0,0,0.0,1,6,7,0,0,1,1,3,6,6,0.0,0.0,2019,20,1.0,0.0,7,0,7,1.0
2019-20,RegularSeason,1629719,505,Devontae Cacok,1610612747,LAL,1,9,3,6,0.5,0,0,0.0,0,0,0.0,2,3,5,1,0,0,0,0,6,9,0.0,0.0,2019,20,6.0,inf,3,0,3,1.6666666666666667
2019-20,RegularSeason,1628450,505,Eric Mika,1610612758,SAC,1,19,2,3,0.667,0,0,0.0,2,2,1.0,2,5,7,0,0,0,0,5,6,12,0.0,0.0,2019,20,6.0,,1,0,1,7.0
2019-20,RegularSeason,1626184,508,Chasson Randle,1610612744,GSW,3,40,0,4,0.0,0,2,0.0,5,6,0.833,0,2,2,5,2,0,0,3,5,9,0.0,0.0,2019,20,1.6666666666666667,inf,4,1,5,0.4
2019-20,RegularSeason,201147,508,Corey Brewer,1610612758,SAC,5,33,2,4,0.5,0,1,0.0,1,3,0.333,2,6,8,2,4,0,2,7,5,13,1.0,2.0,2019,20,1.0,1.0,2,2,4,2.0
2019-20,RegularSeason,2037,508,Jamal Crawford,1610612751,BKN,1,6,2,4,0.5,1,2,0.5,0,0,0.0,0,0,0,3,0,0,0,1,5,6,0.0,0.0,2019,20,5.0,inf,2,0,2,0.0
2019-20,RegularSeason,201601,508,Luc Mbah a Moute,1610612745,HOU,3,25,2,5,0.4,0,2,0.0,1,2,0.5,1,1,2,0,2,0,1,0,5,4,0.0,2.0,2019,20,1.6666666666666667,0.0,3,1,4,0.5
2019-20,RegularSeason,1629622,508,Max Strus,1610612741,CHI,2,6,2,3,0.667,0,1,0.0,1,1,1.0,1,0,1,0,0,0,0,1,5,5,0.0,0.0,2019,20,2.5,,1,0,1,1.0
2019-20,RegularSeason,201583,508,Ryan Anderson,1610612745,HOU,2,14,2,7,0.286,1,5,0.2,0,0,0.0,0,7,7,2,1,0,1,1,5,9,2.0,1.0,2019,20,2.5,2.0,5,0,5,1.4
2019-20,RegularSeason,1629657,514,Kyle Guy,1610612758,SAC,3,10,2,5,0.4,0,3,0.0,0,0,0.0,0,1,1,1,0,0,0,1,4,3,0.0,0.0,2019,20,1.3333333333333333,inf,3,0,3,0.3333333333333333
2019-20,RegularSeason,1629745,514,Tariq Owens,1610612756,PHX,3,15,1,5,0.2,0,2,0.0,2,2,1.0,2,1,3,0,1,0,0,1,4,4,0.0,0.0,2019,20,1.3333333333333333,,4,0,4,0.75
2019-20,RegularSeason,1629133,516,Daryl Macon,1610612748,MIA,4,14,1,3,0.333,1,2,0.5,0,0,0.0,0,0,0,1,0,0,2,1,3,0,0.5,0.0,2019,20,0.75,0.5,2,0,2,0.0
2019-20,RegularSeason,1627740,517,Henry Ellenson,1610612751,BKN,5,15,1,7,0.143,0,4,0.0,0,0,0.0,2,4,6,1,0,0,0,1,2,3,0.0,0.0,2019,20,0.4,inf,6,0,6,1.0
2019-20,RegularSeason,1629607,517,Jared Harper,1610612752,NYK,3,8,1,4,0.25,0,2,0.0,0,0,0.0,0,0,0,0,0,0,0,0,2,-1,0.0,0.0,2019,20,0.6666666666666666,,3,0,3,0.0
2019-20,RegularSeason,1629147,517,Joe Chealey,1610612766,CHA,4,33,0,7,0.0,0,4,0.0,2,2,1.0,0,0,0,1,4,0,2,2,2,-2,0.5,2.0,2019,20,0.5,0.5,7,0,7,0.0
2019-20,RegularSeason,1627982,517,Josh Gray,1610612740,NOP,2,23,1,2,0.5,0,0,0.0,0,0,0.0,1,1,2,2,0,0,5,1,2,0,0.4,0.0,2019,20,1.0,0.4,1,0,1,2.0
2019-20,RegularSeason,1629734,517,Kyle Alexander,1610612748,MIA,2,13,1,2,0.5,0,0,0.0,0,0,0.0,2,1,3,0,0,0,1,1,2,3,0.0,0.0,2019,20,1.0,0.0,1,0,1,3.0
2019-20,RegularSeason,1629005,517,Malik Newman,1610612739,CLE,1,4,0,2,0.0,0,1,0.0,2,2,1.0,0,0,0,0,0,0,1,0,2,-1,0.0,0.0,2019,20,2.0,0.0,2,0,2,0.0
2019-20,RegularSeason,1629760,517,Matt Mooney,1610612739,CLE,4,19,1,4,0.25,0,2,0.0,0,0,0.0,0,3,3,1,2,1,0,1,2,6,0.0,0.0,2019,20,0.5,inf,3,0,3,1.0
2019-20,RegularSeason,203092,517,Tyler Zeller,1610612759,SAS,2,4,1,4,0.25,0,0,0.0,0,0,0.0,3,1,4,0,0,0,0,0,2,3,0.0,0.0,2019,20,1.0,,3,0,3,1.3333333333333333
2019-20,RegularSeason,1629676,525,Isaiah Roby,1610612760,OKC,3,11,0,1,0.0,0,0,0.0,0,0,0.0,0,2,2,0,0,0,1,1,0,0,0.0,0.0,2019,20,0.0,0.0,1,0,1,2.0
2019-20,RegularSeason,1629122,525,J.P. Macura,1610612739,CLE,1,1,0,0,0.0,0,0,0.0,0,0,0.0,0,0,0,0,0,0,0,0,0,0,0.0,0.0,2019,20,0.0,,0,0,0,
2019-20,RegularSeason,1629716,525,Marques Bolden,1610612739,CLE,1,3,0,0,0.0,0,0,0.0,0,0,0.0,0,2,2,0,1,0,0,1,0,3,0.0,0.0,2019,20,0.0,,0,0,0,inf
2019-20,RegularSeason,1629742,525,Stanton Kidd,1610612762,UTA,4,15,0,3,0.0,0,1,0.0,0,0,0.0,0,3,3,1,0,0,2,3,0,-1,0.5,0.0,2019,20,0.0,0.5,3,0,3,1.0
2019-20,RegularSeason,1629739,525,William Howard,1610612745,HOU,2,13,0,4,0.0,0,4,0.0,0,0,0.0,0,2,2,1,0,0,1,1,0,-2,1.0,0.0,2019,20,0.0,1.0,4,0,4,0.5
2019-20,Playoffs,203076,1,Anthony Davis,1610612747,LAL,21,769,205,359,0.571,23,60,0.383,149,179,0.832,55,149,204,73,26,30,53,56,582,678,1.38,0.49,2019,20,27.714285714285715,1.3773584905660377,154,30,184,1.108695652173913
2019-20,Playoffs,2544,2,LeBron James,1610612747,LAL,21,762,214,382,0.56,44,119,0.37,108,150,0.72,28,198,226,184,26,18,84,40,580,740,2.19,0.31,2019,20,27.61904761904762,2.1904761904761907,168,42,210,1.0761904761904761
2019-20,Playoffs,1627750,3,Jamal Murray,1610612743,DEN,19,753,186,368,0.505,62,137,0.453,70,78,0.897,20,72,92,126,18,6,53,42,504,503,2.38,0.34,2019,20,26.526315789473685,2.3773584905660377,182,8,190,0.4842105263157895
2019-20,Playoffs,202710,4,Jimmy Butler,1610612748,MIA,21,806,144,295,0.488,15,43,0.349,164,191,0.859,46,90,136,127,41,14,59,37,467,548,2.15,0.69,2019,20,22.238095238095237,2.152542372881356,151,27,178,0.7640449438202247
2019-20,Playoffs,203999,5,Nikola Jokic,1610612743,DEN,19,694,178,343,0.519,42,98,0.429,66,79,0.835,37,150,187,109,20,15,62,68,464,555,1.76,0.32,2019,20,24.42105263157895,1.7580645161290323,165,13,178,1.050561797752809
2019-20,Playoffs,1628369,6,Jayson Tatum,1610612738,BOS,17,690,145,334,0.434,47,126,0.373,100,123,0.813,22,148,170,85,17,20,48,41,437,469,1.77,0.35,2019,20,25.705882352941178,1.7708333333333333,189,23,212,0.8018867924528302
2019-20,Playoffs,1627759,7,Jaylen Brown,1610612738,BOS,17,672,137,288,0.476,43,120,0.358,53,63,0.841,24,103,127,39,26,9,41,48,370,369,0.95,0.63,2019,20,21.764705882352942,0.9512195121951219,151,10,161,0.7888198757763976
2019-20,Playoffs,202695,8,Kawhi Leonard,1610612746,LAC,13,511,131,268,0.489,24,73,0.329,81,94,0.862,24,97,121,72,30,11,33,29,367,418,2.18,0.91,2019,20,28.23076923076923,2.1818181818181817,137,13,150,0.8066666666666666
2019-20,Playoffs,201935,9,James Harden,1610612745,HOU,12,448,109,228,0.478,39,117,0.333,98,116,0.845,12,55,67,92,18,10,45,43,355,360,2.04,0.4,2019,20,29.583333333333332,2.0444444444444443,119,18,137,0.48905109489051096
2019-20,Playoffs,1628389,10,Bam Adebayo,1610612748,MIA,19,687,124,220,0.564,0,1,0.0,90,115,0.783,47,149,196,84,19,16,47,58,338,485,1.79,0.4,2019,20,17.789473684210527,1.7872340425531914,96,25,121,1.6198347107438016
2019-20,Playoffs,1629639,11,Tyler Herro,1610612748,MIA,21,707,120,277,0.433,48,128,0.375,47,54,0.87,7,100,107,77,8,2,42,31,335,323,1.83,0.19,2019,20,15.952380952380953,1.8333333333333333,157,7,164,0.6524390243902439
2019-20,Playoffs,202689,12,Kemba Walker,1610612738,BOS,17,628,113,256,0.441,39,126,0.31,69,81,0.852,6,63,69,86,15,7,32,43,334,324,2.69,0.47,2019,20,19.647058823529413,2.6875,143,12,155,0.44516129032258067
2019-20,Playoffs,201609,13,Goran Dragic,1610612748,MIA,17,553,119,268,0.444,37,107,0.346,49,61,0.803,13,56,69,75,17,2,39,50,324,287,1.92,0.44,2019,20,19.058823529411764,1.9230769230769231,149,12,161,0.42857142857142855
2019-20,Playoffs,202331,14,Paul George,1610612746,LAC,13,479,88,221,0.398,37,111,0.333,50,55,0.909,14,65,79,49,19,7,40,49,263,239,1.23,0.47,2019,20,20.23076923076923,1.225,133,5,138,0.572463768115942
2019-20,Playoffs,1628378,15,Donovan Mitchell,1610612762,UTA,7,264,83,157,0.529,33,64,0.516,55,58,0.948,6,29,35,34,7,2,29,11,254,226,1.17,0.24,2019,20,36.285714285714285,1.1724137931034482,74,3,77,0.45454545454545453
2019-20,Playoffs,203109,16,Jae Crowder,1610612748,MIA,21,660,81,201,0.403,55,161,0.342,35,46,0.761,11,106,117,39,14,12,15,55,252,288,2.6,0.93,2019,20,12.0,2.6,120,11,131,0.8931297709923665
2019-20,Playoffs,203935,17,Marcus Smart,1610612738,BOS,17,648,78,198,0.394,41,123,0.333,49,56,0.875,10,79,89,78,21,8,45,55,246,270,1.73,0.47,2019,20,14.470588235294118,1.7333333333333334,120,7,127,0.7007874015748031
2019-20,Playoffs,1629130,18,Duncan Robinson,1610612748,MIA,21,600,75,176,0.426,62,156,0.397,33,38,0.868,5,53,58,38,14,6,16,65,245,239,2.38,0.88,2019,20,11.666666666666666,2.375,101,5,106,0.5471698113207547
2019-20,Playoffs,203507,19,Giannis Antetokounmpo,1610612749,MIL,9,277,90,161,0.559,13,40,0.325,47,81,0.58,27,97,124,51,6,8,30,31,240,294,1.7,0.2,2019,20,26.666666666666668,1.7,71,34,105,1.180952380952381
2019-20,Playoffs,203484,20,Kentavious Caldwell-Pope,1610612747,LAL,21,608,79,189,0.418,45,119,0.378,22,27,0.815,8,36,44,28,21,4,15,40,225,192,1.87,1.4,2019,20,10.714285714285714,1.8666666666666667,110,5,115,0.3826086956521739
2019-20,Playoffs,203924,21,Jerami Grant,1610612743,DEN,19,653,71,175,0.406,31,95,0.326,48,54,0.889,8,55,63,25,11,15,25,59,221,200,1.0,0.44,2019,20,11.631578947368421,1.0,104,6,110,0.5727272727272728
2019-20,Playoffs,1627832,22,Fred VanVleet,1610612761,TOR,11,430,76,190,0.4,43,110,0.391,21,25,0.84,5,43,48,76,18,7,22,27,216,225,3.46,0.82,2019,20,19.636363636363637,3.4545454545454546,114,4,118,0.4067796610169492
2019-20,Playoffs,1629008,22,Michael Porter Jr.,1610612743,DEN,19,451,78,164,0.476,34,89,0.382,26,35,0.743,21,106,127,16,13,6,25,43,216,258,0.64,0.52,2019,20,11.368421052631579,0.64,86,9,95,1.3368421052631578
2019-20,Playoffs,1628398,24,Kyle Kuzma,1610612747,LAL,21,484,77,179,0.43,26,83,0.313,29,37,0.784,18,47,65,17,6,7,21,50,209,173,0.81,0.29,2019,20,9.952380952380953,0.8095238095238095,102,8,110,0.5909090909090909
2019-20,Playoffs,201569,25,Eric Gordon,1610612745,HOU,12,410,72,176,0.409,29,90,0.322,35,40,0.875,6,26,32,36,10,7,24,26,208,160,1.5,0.42,2019,20,17.333333333333332,1.5,104,5,109,0.29357798165137616
2019-20,Playoffs,203114,26,Khris Middleton,1610612749,MIL,10,355,71,180,0.394,23,65,0.354,38,46,0.826,5,64,69,60,11,2,34,41,203,194,1.76,0.32,2019,20,20.3,1.7647058823529411,109,8,117,0.5897435897435898
2019-20,Playoffs,200768,27,Kyle Lowry,1610612761,TOR,11,413,62,148,0.419,23,72,0.319,48,60,0.8,8,64,72,64,19,8,28,40,195,232,2.29,0.68,2019,20,17.727272727272727,2.2857142857142856,86,12,98,0.7346938775510204
2019-20,Playoffs,1627783,28,Pascal Siakam,1610612761,TOR,11,418,72,182,0.396,10,53,0.189,33,46,0.717,14,69,83,42,12,4,22,33,187,183,1.91,0.55,2019,20,17.0,1.9090909090909092,110,13,123,0.6747967479674797
2019-20,Playoffs,1629029,29,Luka Doncic,1610612742,DAL,6,215,64,128,0.5,16,44,0.364,42,64,0.656,4,55,59,52,7,3,31,17,186,190,1.68,0.23,2019,20,31.0,1.6774193548387097,64,22,86,0.686046511627907
2019-20,Playoffs,1628420,30,Monte Morris,1610612743,DEN,19,406,66,133,0.496,12,40,0.3,28,34,0.824,4,25,29,52,12,2,10,20,172,184,5.2,1.2,2019,20,9.052631578947368,5.2,67,6,73,0.3972602739726027
2019-20,Playoffs,201980,31,Danny Green,1610612747,LAL,21,525,59,170,0.347,39,115,0.339,10,15,0.667,25,41,66,26,20,16,12,48,167,167,2.17,1.67,2019,20,7.9523809523809526,2.1666666666666665,111,5,116,0.5689655172413793
2019-20,Playoffs,101150,32,Lou Williams,1610612746,LAC,13,341,62,146,0.425,12,51,0.235,30,37,0.811,7,34,41,55,10,2,21,18,166,162,2.62,0.48,2019,20,12.76923076923077,2.619047619047619,84,7,91,0.45054945054945056
2019-20,Playoffs,201586,33,Serge Ibaka,1610612761,TOR,11,251,63,110,0.573,23,45,0.511,14,14,1.0,17,68,85,13,2,14,12,27,163,218,1.08,0.17,2019,20,14.818181818181818,1.0833333333333333,47,0,47,1.8085106382978724
2019-20,Playoffs,201572,34,Brook Lopez,1610612749,MIL,10,328,61,114,0.535,21,53,0.396,15,20,0.75,19,36,55,5,10,13,12,27,158,171,0.42,0.83,2019,20,15.8,0.4166666666666667,53,5,58,0.9482758620689655
2019-20,Playoffs,202694,35,Marcus Morris Sr.,1610612746,LAC,13,388,56,111,0.505,28,59,0.475,13,14,0.929,11,52,63,21,11,1,9,39,153,184,2.33,1.22,2019,20,11.76923076923077,2.3333333333333335,55,1,56,1.125
2019-20,Playoffs,1628464,36,Daniel Theis,1610612738,BOS,17,482,61,117,0.521,4,26,0.154,26,33,0.788,32,89,121,25,6,21,15,66,152,247,1.67,0.4,2019,20,8.941176470588236,1.6666666666666667,56,7,63,1.9206349206349207
2019-20,Playoffs,200794,36,Paul Millsap,1610612743,DEN,19,459,47,118,0.398,15,44,0.341,43,54,0.796,26,63,89,23,12,9,25,49,152,178,0.92,0.48,2019,20,8.0,0.92,71,11,82,1.0853658536585367
2019-20,Playoffs,101108,38,Chris Paul,1610612760,OKC,7,261,55,112,0.491,16,43,0.372,23,26,0.885,3,49,52,37,11,3,23,18,149,169,1.61,0.48,2019,20,21.285714285714285,1.608695652173913,57,3,60,0.8666666666666667
2019-20,Playoffs,1626181,39,Norman Powell,1610612761,TOR,11,273,51,104,0.49,22,52,0.423,23,29,0.793,4,22,26,11,6,3,11,29,147,123,1.0,0.55,2019,20,13.363636363636363,1.0,53,6,59,0.4406779661016949
2019-20,Playoffs,200765,40,Rajon Rondo,1610612747,LAL,16,395,55,121,0.455,20,50,0.4,13,19,0.684,13,56,69,105,22,2,34,36,143,235,3.09,0.65,2019,20,8.9375,3.088235294117647,66,6,72,0.9583333333333334
2019-20,Playoffs,201566,40,Russell Westbrook,1610612745,HOU,8,262,59,140,0.421,8,33,0.242,17,32,0.531,11,45,56,37,12,2,30,23,143,124,1.23,0.4,2019,20,17.875,1.2333333333333334,81,15,96,0.5833333333333334
2019-20,Playoffs,202696,42,Nikola Vucevic,1610612753,ORL,5,185,56,111,0.505,18,44,0.409,10,11,0.909,9,46,55,20,4,3,13,13,140,153,1.54,0.31,2019,20,28.0,1.5384615384615385,55,1,56,0.9821428571428571
2019-20,Playoffs,201145,43,Jeff Green,1610612745,HOU,12,341,51,103,0.495,23,54,0.426,14,17,0.824,5,55,60,19,6,6,15,27,139,160,1.27,0.4,2019,20,11.583333333333334,1.2666666666666666,52,3,55,1.0909090909090908
2019-20,Playoffs,1627936,44,Alex Caruso,1610612747,LAL,21,510,48,113,0.425,17,61,0.279,24,30,0.8,15,33,48,59,23,12,31,55,137,177,1.9,0.74,2019,20,6.523809523809524,1.903225806451613,65,6,71,0.676056338028169
2019-20,Playoffs,1626149,45,Montrezl Harrell,1610612746,LAC,13,243,47,82,0.573,1,5,0.2,41,68,0.603,11,27,38,5,5,7,12,28,136,117,0.42,0.42,2019,20,10.461538461538462,0.4166666666666667,35,27,62,0.6129032258064516
2019-20,Playoffs,203496,46,Robert Covington,1610612745,HOU,12,379,47,95,0.495,34,68,0.5,6,7,0.857,8,52,60,16,30,13,12,45,134,192,1.33,2.5,2019,20,11.166666666666666,1.3333333333333333,48,1,49,1.2244897959183674
2019-20,Playoffs,203482,47,Kelly Olynyk,1610612748,MIA,17,258,45,95,0.474,17,49,0.347,23,28,0.821,13,66,79,19,4,8,13,35,130,172,1.46,0.31,2019,20,7.647058823529412,1.4615384615384615,50,5,55,1.4363636363636363
2019-20,Playoffs,202693,48,Markieff Morris,1610612747,LAL,21,386,44,98,0.449,29,69,0.42,7,9,0.778,12,52,64,20,6,3,17,54,124,144,1.18,0.35,2019,20,5.904761904761905,1.1764705882352942,54,2,56,1.1428571428571428
2019-20,Playoffs,203471,49,Dennis Schroder,1610612760,OKC,7,227,44,109,0.404,13,45,0.289,20,25,0.8,2,24,26,25,4,1,17,15,121,90,1.47,0.23,2019,20,17.285714285714285,1.4705882352941178,65,5,70,0.37142857142857144
2019-20,Playoffs,203954,50,Joel Embiid,1610612755,PHI,4,145,34,74,0.459,4,16,0.25,48,59,0.814,11,38,49,5,6,5,15,18,120,119,0.33,0.4,2019,20,30.0,0.3333333333333333,40,11,51,0.9607843137254902
2019-20,Playoffs,1627826,51,Ivica Zubac,1610612746,LAC,13,320,44,78,0.564,0,0,0.0,30,37,0.811,31,62,93,8,2,10,12,34,118,178,0.67,0.17,2019,20,9.076923076923077,0.6666666666666666,34,7,41,2.268292682926829
2019-20,Playoffs,203497,51,Rudy Gobert,1610612762,UTA,7,270,48,74,0.649,0,0,0.0,22,42,0.524,24,56,80,8,4,10,9,26,118,165,0.89,0.44,2019,20,16.857142857142858,0.8888888888888888,26,20,46,1.7391304347826086
2019-20,Playoffs,203903,53,Jordan Clarkson,1610612762,UTA,7,200,45,97,0.464,17,49,0.347,10,10,1.0,2,22,24,15,6,0,7,15,117,103,2.14,0.86,2019,20,16.714285714285715,2.142857142857143,52,0,52,0.46153846153846156
2019-20,Playoffs,203468,54,CJ McCollum,1610612757,POR,5,196,44,99,0.444,13,35,0.371,15,22,0.682,5,24,29,16,6,2,15,10,116,92,1.07,0.4,2019,20,23.2,1.0666666666666667,55,7,62,0.46774193548387094
2019-20,Playoffs,1628384,55,OG Anunoby,1610612761,TOR,11,393,40,88,0.455,17,41,0.415,18,28,0.643,26,50,76,13,11,13,16,27,115,154,0.81,0.69,2019,20,10.454545454545455,0.8125,48,10,58,1.3103448275862069
2019-20,Playoffs,1628983,56,Shai Gilgeous-Alexander,1610612760,OKC,7,279,39,90,0.433,14,35,0.4,22,23,0.957,3,34,37,29,7,3,15,17,114,123,1.93,0.47,2019,20,16.285714285714285,1.9333333333333333,51,1,52,0.7115384615384616
2019-20,Playoffs,203501,57,Tim Hardaway Jr.,1610612742,DAL,6,204,40,95,0.421,19,54,0.352,8,11,0.727,3,18,21,11,2,0,3,16,107,80,3.67,0.67,2019,20,17.833333333333332,3.6666666666666665,55,3,58,0.3620689655172414
2019-20,Playoffs,201568,58,Danilo Gallinari,1610612760,OKC,7,212,32,79,0.405,12,37,0.324,29,30,0.967,5,33,38,7,5,1,15,11,105,93,0.47,0.33,2019,20,15.0,0.4666666666666667,47,1,48,0.7916666666666666
2019-20,Playoffs,202339,58,Eric Bledsoe,1610612749,MIL,9,267,38,98,0.388,8,32,0.25,21,26,0.808,5,36,41,53,11,6,23,20,105,128,2.3,0.48,2019,20,11.666666666666666,2.3043478260869565,60,5,65,0.6307692307692307
2019-20,Playoffs,2730,60,Dwight Howard,1610612747,LAL,18,282,39,57,0.684,1,2,0.5,25,45,0.556,32,51,83,9,8,8,16,55,104,158,0.56,0.5,2019,20,5.777777777777778,0.5625,18,20,38,2.1842105263157894
2019-20,Playoffs,203914,60,Gary Harris,1610612743,DEN,14,379,34,90,0.378,19,52,0.365,17,22,0.773,7,21,28,24,16,4,21,45,104,94,1.14,0.76,2019,20,7.428571428571429,1.1428571428571428,56,5,61,0.45901639344262296
2019-20,Playoffs,1627863,62,Danuel House Jr.,1610612745,HOU,9,279,37,85,0.435,19,53,0.358,10,13,0.769,10,42,52,13,8,0,7,22,103,118,1.86,1.14,2019,20,11.444444444444445,1.8571428571428572,48,3,51,1.0196078431372548
2019-20,Playoffs,201144,63,Mike Conley,1610612762,UTA,5,165,31,64,0.484,18,34,0.529,19,22,0.864,3,11,14,26,8,1,5,10,99,107,5.2,1.6,2019,20,19.8,5.2,33,3,36,0.3888888888888889
2019-20,Playoffs,203081,64,Damian Lillard,1610612757,POR,4,143,26,64,0.406,13,33,0.394,32,33,0.97,1,13,14,17,2,1,14,4,97,78,1.21,0.14,2019,20,24.25,1.2142857142857142,38,1,39,0.358974358974359
2019-20,Playoffs,201588,65,George Hill,1610612749,MIL,10,268,32,67,0.478,10,28,0.357,21,26,0.808,5,19,24,31,6,0,16,17,95,100,1.94,0.38,2019,20,9.5,1.9375,35,5,40,0.6
2019-20,Playoffs,200782,65,P.J. Tucker,1610612745,HOU,12,414,35,88,0.398,25,67,0.373,0,0,0.0,23,63,86,18,13,3,12,47,95,150,1.5,1.08,2019,20,7.916666666666667,1.5,53,0,53,1.6226415094339623
2019-20,Playoffs,1629134,67,Kendrick Nunn,1610612748,MIA,15,239,36,92,0.391,12,43,0.279,8,8,1.0,3,29,32,20,3,3,12,21,92,82,1.67,0.25,2019,20,6.133333333333334,1.6666666666666667,56,0,56,0.5714285714285714
2019-20,Playoffs,1627763,68,Malcolm Brogdon,1610612754,IND,4,160,26,65,0.4,9,24,0.375,25,28,0.893,0,17,17,40,4,0,10,10,86,95,4.0,0.4,2019,20,21.5,4.0,39,3,42,0.40476190476190477
2019-20,Playoffs,1628470,68,Torrey Craig,1610612743,DEN,19,376,33,78,0.423,11,42,0.262,9,13,0.692,13,49,62,13,7,7,9,44,86,117,1.44,0.78,2019,20,4.526315789473684,1.4444444444444444,45,4,49,1.2653061224489797
2019-20,Playoffs,202954,70,Brad Wanamaker,1610612738,BOS,17,273,29,60,0.483,12,27,0.444,14,16,0.875,2,32,34,30,12,4,18,32,84,113,1.67,0.67,2019,20,4.9411764705882355,1.6666666666666667,31,2,33,1.0303030303030303
2019-20,Playoffs,203082,71,Terrence Ross,1610612753,ORL,5,135,30,64,0.469,10,30,0.333,12,14,0.857,1,21,22,5,4,1,8,14,82,70,0.63,0.5,2019,20,16.4,0.625,34,2,36,0.6111111111111112
2019-20,Playoffs,1627747,72,Caris LeVert,1610612751,BKN,4,140,27,73,0.37,9,21,0.429,18,25,0.72,8,16,24,38,5,1,13,7,81,83,2.92,0.39,2019,20,20.25,2.923076923076923,46,7,53,0.4528301886792453
2019-20,Playoffs,203933,73,T.J. Warren,1610612754,IND,4,156,32,68,0.471,7,19,0.368,9,9,1.0,5,20,25,12,9,1,11,16,80,80,1.09,0.82,2019,20,20.0,1.0909090909090908,36,0,36,0.6944444444444444
2019-20,Playoffs,2738,74,Andre Iguodala,1610612748,MIA,21,410,30,65,0.462,14,39,0.359,5,7,0.714,11,43,54,31,17,13,14,44,79,143,2.21,1.21,2019,20,3.761904761904762,2.2142857142857144,35,2,37,1.4594594594594594
2019-20,Playoffs,203210,74,JaMychal Green,1610612746,LAC,13,222,31,55,0.564,10,23,0.435,7,9,0.778,13,36,49,7,2,3,5,29,79,109,1.4,0.4,2019,20,6.076923076923077,1.4,24,2,26,1.8846153846153846
2019-20,Playoffs,203552,76,Seth Curry,1610612742,DAL,6,173,31,53,0.585,10,21,0.476,5,5,1.0,2,9,11,8,6,0,8,14,77,72,1.0,0.75,2019,20,12.833333333333334,1.0,22,0,22,0.5
2019-20,Playoffs,2546,77,Carmelo Anthony,1610612757,POR,5,176,28,68,0.412,8,19,0.421,12,14,0.857,1,24,25,10,5,2,13,20,76,63,0.77,0.39,2019,20,15.2,0.7692307692307693,40,2,42,0.5952380952380952
2019-20,Playoffs,1629652,78,Luguentz Dort,1610612760,OKC,6,175,27,76,0.355,13,50,0.26,8,15,0.533,5,17,22,6,2,6,15,25,75,40,0.4,0.13,2019,20,12.5,0.4,49,7,56,0.39285714285714285
2019-20,Playoffs,203504,79,Trey Burke,1610612742,DAL,6,156,30,59,0.508,8,17,0.471,6,10,0.6,2,17,19,12,8,2,6,14,74,76,2.0,1.33,2019,20,12.333333333333334,2.0,29,4,33,0.5757575757575758
2019-20,Playoffs,202083,80,Wesley Matthews,1610612749,MIL,10,246,24,57,0.421,17,43,0.395,7,10,0.7,6,12,18,9,9,4,7,20,72,69,1.29,1.29,2019,20,7.2,1.2857142857142858,33,3,36,0.5
2019-20,Playoffs,203994,81,Jusuf Nurkic,1610612757,POR,5,161,25,57,0.439,3,11,0.273,18,23,0.783,14,38,52,18,7,1,13,21,71,99,1.39,0.54,2019,20,14.2,1.3846153846153846,32,5,37,1.4054054054054055
2019-20,Playoffs,204001,81,Kristaps Porzingis,1610612742,DAL,3,94,21,40,0.525,9,17,0.529,20,23,0.87,3,23,26,2,0,3,3,9,71,77,0.67,0.0,2019,20,23.666666666666668,0.6666666666666666,19,3,22,1.1818181818181819
2019-20,Playoffs,203500,81,Steven Adams,1610612760,OKC,7,210,31,52,0.596,0,1,0.0,9,20,0.45,34,47,81,9,4,2,16,10,71,119,0.56,0.25,2019,20,10.142857142857142,0.5625,21,11,32,2.53125
2019-20,Playoffs,203506,81,Victor Oladipo,1610612754,IND,4,123,22,56,0.393,12,33,0.364,15,16,0.938,0,13,13,10,9,0,14,14,71,54,0.71,0.64,2019,20,17.75,0.7142857142857143,34,1,35,0.37142857142857144
2019-20,Playoffs,1629013,85,Landry Shamet,1610612746,LAC,13,243,24,59,0.407,15,42,0.357,5,7,0.714,0,22,22,17,6,3,13,18,68,66,1.31,0.46,2019,20,5.230769230769231,1.3076923076923077,35,2,37,0.5945945945945946
2019-20,Playoffs,1626196,86,Josh Richardson,1610612755,PHI,4,144,20,56,0.357,10,28,0.357,17,18,0.944,4,11,15,13,2,2,8,12,67,54,1.63,0.25,2019,20,16.75,1.625,36,1,37,0.40540540540540543
2019-20,Playoffs,201571,87,D.J. Augustin,1610612753,ORL,5,128,18,46,0.391,8,17,0.471,22,23,0.957,0,10,10,30,1,0,12,6,66,66,2.5,0.08,2019,20,13.2,2.5,28,1,29,0.3448275862068966
2019-20,Playoffs,1628978,87,Donte DiVincenzo,1610612749,MIL,10,165,23,51,0.451,7,21,0.333,13,20,0.65,8,24,32,12,7,3,10,21,66,75,1.2,0.7,2019,20,6.6,1.2,28,7,35,0.9142857142857143
2019-20,Playoffs,201188,87,Marc Gasol,1610612761,TOR,11,228,25,64,0.391,5,27,0.185,11,15,0.733,4,44,48,29,5,7,16,32,66,96,1.81,0.31,2019,20,6.0,1.8125,39,4,43,1.1162790697674418
2019-20,Playoffs,203095,90,Evan Fournier,1610612753,ORL,5,171,20,57,0.351,12,35,0.343,12,17,0.706,3,17,20,13,6,3,9,10,64,55,1.44,0.67,2019,20,12.8,1.4444444444444444,37,5,42,0.47619047619047616
2019-20,Playoffs,204060,90,Joe Ingles,1610612762,UTA,7,234,22,54,0.407,14,40,0.35,6,6,1.0,1,23,24,33,4,1,4,15,64,90,8.25,1.0,2019,20,9.142857142857142,8.25,32,0,32,0.75
2019-20,Playoffs,1627789,90,Timothe Luwawu-Cabarrot,1610612751,BKN,4,131,20,59,0.339,13,39,0.333,11,12,0.917,1,14,15,6,3,0,8,14,64,40,0.75,0.38,2019,20,16.0,0.75,39,1,40,0.375
2019-20,Playoffs,1626167,93,Myles Turner,1610612754,IND,4,146,25,44,0.568,6,14,0.429,7,16,0.438,11,32,43,3,2,16,9,13,63,90,0.33,0.22,2019,20,15.75,0.3333333333333333,19,9,28,1.5357142857142858
2019-20,Playoffs,202699,93,Tobias Harris,1610612755,PHI,4,149,23,60,0.383,2,15,0.133,15,19,0.789,14,24,38,16,2,1,5,11,63,74,3.2,0.4,2019,20,15.75,3.2,37,4,41,0.926829268292683
2019-20,Playoffs,2594,95,Kyle Korver,1610612749,MIL,10,119,20,47,0.426,15,37,0.405,7,7,1.0,1,7,8,1,3,1,5,9,62,43,0.2,0.6,2019,20,6.2,0.2,27,0,27,0.2962962962962963
2019-20,Playoffs,1627827,96,Dorian Finney-Smith,1610612742,DAL,6,191,23,52,0.442,11,30,0.367,4,5,0.8,12,22,34,19,7,3,9,22,61,85,2.11,0.78,2019,20,10.166666666666666,2.111111111111111,29,1,30,1.1333333333333333
2019-20,Playoffs,1628365,97,Markelle Fultz,1610612753,ORL,5,147,24,60,0.4,6,16,0.375,6,7,0.857,0,11,11,26,5,3,13,20,60,55,2.0,0.39,2019,20,12.0,2.0,36,1,37,0.2972972972972973
2019-20,Playoffs,202704,98,Reggie Jackson,1610612746,LAC,12,170,21,48,0.438,17,32,0.531,0,0,0.0,2,19,21,11,2,1,5,18,59,62,2.2,0.4,2019,20,4.916666666666667,2.2,27,0,27,0.7777777777777778
2019-20,Playoffs,1627777,99,Georges Niang,1610612762,UTA,7,114,22,44,0.5,12,29,0.414,2,2,1.0,4,11,15,4,0,1,2,9,58,54,2.0,0.0,2019,20,8.285714285714286,2.0,22,0,22,0.6818181818181818
2019-20,Playoffs,1629003,99,Shake Milton,1610612755,PHI,4,126,21,44,0.477,10,25,0.4,6,7,0.857,1,12,13,11,2,0,6,13,58,54,1.83,0.33,2019,20,14.5,1.8333333333333333,23,1,24,0.5416666666666666
2019-20,Playoffs,203085,101,Austin Rivers,1610612745,HOU,12,211,19,61,0.311,9,35,0.257,10,13,0.769,2,28,30,16,7,1,8,22,57,58,2.0,0.88,2019,20,4.75,2.0,42,3,45,0.6666666666666666
2019-20,Playoffs,101107,102,Marvin Williams,1610612749,MIL,10,179,21,47,0.447,10,23,0.435,3,3,1.0,13,35,48,9,5,3,3,14,55,91,3.0,1.67,2019,20,5.5,3.0,26,0,26,1.8461538461538463
2019-20,Playoffs,204020,102,Tyler Johnson,1610612751,BKN,4,93,21,46,0.457,11,28,0.393,2,2,1.0,0,7,7,9,0,1,3,11,55,44,3.0,0.0,2019,20,13.75,3.0,25,0,25,0.28
2019-20,Playoffs,202330,104,Gordon Hayward,1610612738,BOS,5,157,20,50,0.4,7,24,0.292,7,8,0.875,3,17,20,14,7,2,7,10,54,59,2.0,1.0,2019,20,10.8,2.0,30,1,31,0.6451612903225806
2019-20,Playoffs,202683,105,Enes Freedom,1610612738,BOS,11,102,22,42,0.524,1,1,1.0,5,10,0.5,19,24,43,7,0,0,4,19,50,71,1.75,0.0,2019,20,4.545454545454546,1.75,20,5,25,1.72
2019-20,Playoffs,201976,105,Patrick Beverley,1610612746,LAC,8,166,20,39,0.513,8,22,0.364,2,4,0.5,9,24,33,19,8,3,7,31,50,85,2.71,1.14,2019,20,6.25,2.7142857142857144,19,2,21,1.5714285714285714
2019-20,Playoffs,202066,107,Garrett Temple,1610612751,BKN,4,137,17,49,0.347,9,36,0.25,5,6,0.833,0,11,11,8,3,1,6,12,48,32,1.33,0.5,2019,20,12.0,1.3333333333333333,32,1,33,0.3333333333333333
2019-20,Playoffs,1629018,107,Gary Trent Jr.,1610612757,POR,5,153,16,45,0.356,10,24,0.417,6,7,0.857,5,5,10,3,4,0,5,16,48,30,0.6,0.8,2019,20,9.6,0.6,29,1,30,0.3333333333333333
2019-20,Playoffs,1629057,107,Robert Williams III,1610612738,BOS,13,149,23,31,0.742,0,1,0.0,2,6,0.333,22,29,51,10,3,6,7,18,48,99,1.43,0.43,2019,20,3.6923076923076925,1.4285714285714286,8,4,12,4.25
2019-20,Playoffs,1629684,110,Grant Williams,1610612738,BOS,17,170,15,26,0.577,10,17,0.588,7,10,0.7,7,19,26,6,2,5,4,33,47,68,1.5,0.5,2019,20,2.764705882352941,1.5,11,3,14,1.8571428571428572
2019-20,Playoffs,1629647,111,Darius Bazley,1610612760,OKC,7,126,13,31,0.419,11,22,0.5,9,10,0.9,2,45,47,6,0,3,6,2,46,77,1.0,0.0,2019,20,6.571428571428571,1.0,18,1,19,2.473684210526316
2019-20,Playoffs,203486,111,Mason Plumlee,1610612743,DEN,19,207,19,39,0.487,0,1,0.0,8,12,0.667,31,30,61,25,4,8,11,40,46,109,2.27,0.36,2019,20,2.4210526315789473,2.272727272727273,20,4,24,2.5416666666666665
2019-20,Playoffs,203463,113,Ben McLemore,1610612745,HOU,11,130,15,40,0.375,14,36,0.389,0,0,0.0,2,9,11,6,4,0,3,8,44,37,2.0,1.33,2019,20,4.0,2.0,25,0,25,0.44
2019-20,Playoffs,1629056,114,Terence Davis,1610612761,TOR,6,84,14,29,0.483,8,19,0.421,7,7,1.0,2,11,13,7,1,0,6,11,43,43,1.17,0.17,2019,20,7.166666666666667,1.1666666666666667,15,0,15,0.8666666666666667
2019-20,Playoffs,202692,115,Alec Burks,1610612755,PHI,4,95,16,49,0.327,3,16,0.188,7,9,0.778,7,8,15,7,1,3,3,7,42,30,2.33,0.33,2019,20,10.5,2.3333333333333335,33,2,35,0.42857142857142855
2019-20,Playoffs,1626246,116,Boban Marjanovic,1610612742,DAL,6,82,17,30,0.567,0,1,0.0,7,9,0.778,6,29,35,5,0,2,3,9,41,65,1.67,0.0,2019,20,6.833333333333333,1.6666666666666667,13,2,15,2.3333333333333335
2019-20,Playoffs,201580,116,JaVale McGee,1610612747,LAL,14,135,20,32,0.625,0,2,0.0,1,2,0.5,16,28,44,7,2,10,9,22,41,82,0.78,0.22,2019,20,2.9285714285714284,0.7777777777777778,12,1,13,3.3846153846153846
2019-20,Playoffs,1628386,116,Jarrett Allen,1610612751,BKN,4,132,14,24,0.583,0,0,0.0,13,16,0.813,17,42,59,9,2,7,11,7,41,94,0.82,0.18,2019,20,10.25,0.8181818181818182,10,3,13,4.538461538461538
2019-20,Playoffs,1628467,119,Maxi Kleber,1610612742,DAL,6,203,13,39,0.333,5,26,0.192,9,12,0.75,10,29,39,9,2,7,4,20,40,64,2.25,0.5,2019,20,6.666666666666667,2.25,26,3,29,1.3448275862068966
2019-20,Playoffs,1626192,119,Pat Connaughton,1610612749,MIL,10,171,15,35,0.429,8,23,0.348,2,2,1.0,5,34,39,11,2,2,5,12,40,69,2.2,0.4,2019,20,4.0,2.2,20,0,20,1.95
2019-20,Playoffs,1626220,121,Royce O'Neale,1610612762,UTA,7,249,13,32,0.406,10,22,0.455,3,6,0.5,3,35,38,19,9,2,13,25,39,72,1.46,0.69,2019,20,5.571428571428571,1.4615384615384615,19,3,22,1.7272727272727273
2019-20,Playoffs,1628408,122,PJ Dozier,1610612743,DEN,12,125,14,33,0.424,2,8,0.25,8,14,0.571,2,16,18,12,2,2,8,13,38,39,1.5,0.25,2019,20,3.1666666666666665,1.5,19,6,25,0.72
2019-20,Playoffs,1629109,123,Gary Clark,1610612753,ORL,5,144,11,33,0.333,11,32,0.344,4,5,0.8,4,24,28,7,5,2,2,7,37,54,3.5,2.5,2019,20,7.4,3.5,22,1,23,1.2173913043478262
2019-20,Playoffs,203516,124,James Ennis III,1610612753,ORL,5,119,12,35,0.343,4,16,0.25,7,9,0.778,6,23,29,6,5,2,6,19,35,46,1.0,0.83,2019,20,7.0,1.0,23,2,25,1.16
2019-20,Playoffs,202355,125,Hassan Whiteside,1610612757,POR,5,106,13,24,0.542,1,1,1.0,7,14,0.5,7,28,35,2,1,10,6,17,34,58,0.33,0.17,2019,20,6.8,0.3333333333333333,11,7,18,1.9444444444444444
2019-20,Playoffs,203925,126,Joe Harris,1610612751,BKN,2,72,12,23,0.522,7,12,0.583,2,4,0.5,2,18,20,2,1,0,3,9,33,40,0.67,0.33,2019,20,16.5,0.6666666666666666,11,2,13,1.5384615384615385
2019-20,Playoffs,1628988,127,Aaron Holiday,1610612754,IND,4,72,12,21,0.571,4,9,0.444,3,5,0.6,1,4,5,10,4,0,4,10,31,35,2.5,1.0,2019,20,7.75,2.5,9,2,11,0.45454545454545453
2019-20,Playoffs,1629744,127,Matt Thomas,1610612761,TOR,10,84,13,21,0.619,5,12,0.417,0,0,0.0,1,13,14,7,1,1,1,6,31,45,7.0,1.0,2019,20,3.1,7.0,8,0,8,1.75
2019-20,Playoffs,203200,129,Justin Holiday,1610612754,IND,4,131,10,21,0.476,8,16,0.5,1,3,0.333,4,11,15,3,6,5,3,8,29,42,1.0,2.0,2019,20,7.25,1.0,11,2,13,1.1538461538461537
2019-20,Playoffs,201143,130,Al Horford,1610612755,PHI,4,128,12,25,0.48,0,4,0.0,4,7,0.571,9,20,29,9,1,5,3,14,28,53,3.0,0.33,2019,20,7.0,3.0,13,3,16,1.8125
2019-20,Playoffs,1629014,131,Anfernee Simons,1610612757,POR,4,82,8,26,0.308,6,14,0.429,5,6,0.833,1,10,11,10,6,0,4,7,27,31,2.5,1.5,2019,20,6.75,2.5,18,1,19,0.5789473684210527
2019-20,Playoffs,203920,132,Khem Birch,1610612753,ORL,5,89,7,14,0.5,0,0,0.0,10,11,0.909,9,16,25,7,1,0,5,11,24,44,1.4,0.2,2019,20,4.8,1.4,7,1,8,3.125
2019-20,Playoffs,1629185,133,Chris Chiozza,1610612751,BKN,4,65,8,24,0.333,5,16,0.313,2,4,0.5,1,5,6,17,5,0,3,7,23,30,5.67,1.67,2019,20,5.75,5.666666666666667,16,2,18,0.3333333333333333
2019-20,Playoffs,1626209,133,Mario Hezonja,1610612757,POR,5,68,9,22,0.409,2,7,0.286,3,4,0.75,2,14,16,6,3,0,3,8,23,31,2.0,1.0,2019,20,4.6,2.0,13,1,14,1.1428571428571428
2019-20,Playoffs,1627884,135,Derrick Jones Jr.,1610612748,MIA,15,97,8,17,0.471,4,9,0.444,2,5,0.4,6,6,12,7,6,5,2,12,22,38,3.5,3.0,2019,20,1.4666666666666666,3.5,9,3,12,1.0
2019-20,Playoffs,1629066,135,Rodions Kurucs,1610612751,BKN,4,58,11,20,0.55,0,8,0.0,0,2,0.0,3,10,13,3,1,2,3,9,22,27,1.0,0.33,2019,20,5.5,1.0,9,2,11,1.1818181818181819
2019-20,Playoffs,203457,137,Nerlens Noel,1610612760,OKC,7,97,8,17,0.471,0,1,0.0,5,10,0.5,5,24,29,3,2,5,2,15,21,44,1.5,1.0,2019,20,3.0,1.5,9,5,14,2.0714285714285716
2019-20,Playoffs,1628400,137,Semi Ojeleye,1610612738,BOS,13,122,7,28,0.25,5,23,0.217,2,2,1.0,2,10,12,1,3,0,1,9,21,15,1.0,3.0,2019,20,1.6153846153846154,1.0,21,0,21,0.5714285714285714
2019-20,Playoffs,1629117,137,Wenyen Gabriel,1610612757,POR,4,53,9,15,0.6,2,5,0.4,1,2,0.5,7,3,10,4,2,2,5,16,21,27,0.8,0.4,2019,20,5.25,0.8,6,1,7,1.4285714285714286
2019-20,Playoffs,1628411,137,Wes Iwundu,1610612753,ORL,5,76,6,20,0.3,4,7,0.571,5,8,0.625,1,10,11,4,3,2,3,5,21,21,1.33,1.0,2019,20,4.2,1.3333333333333333,14,3,17,0.6470588235294118
2019-20,Playoffs,2747,141,JR Smith,1610612747,LAL,10,75,7,26,0.269,6,22,0.273,0,0,0.0,0,3,3,3,2,0,7,11,20,2,0.43,0.29,2019,20,2.0,0.42857142857142855,19,0,19,0.15789473684210525
2019-20,Playoffs,203960,141,JaKarr Sampson,1610612754,IND,4,50,10,16,0.625,0,0,0.0,0,0,0.0,1,12,13,4,2,0,2,10,20,31,2.0,1.0,2019,20,5.0,2.0,6,0,6,2.1666666666666665
2019-20,Playoffs,1629626,143,Bol Bol,1610612743,DEN,4,21,5,9,0.556,2,3,0.667,7,8,0.875,3,2,5,0,2,2,2,1,19,21,0.0,1.0,2019,20,4.75,0.0,4,1,5,1.0
2019-20,Playoffs,1626147,143,Justin Anderson,1610612751,BKN,3,28,5,12,0.417,5,11,0.455,4,4,1.0,0,8,8,3,0,1,2,2,19,22,1.5,0.0,2019,20,6.333333333333333,1.5,7,0,7,1.1428571428571428
2019-20,Playoffs,1626153,145,Delon Wright,1610612742,DAL,4,53,6,10,0.6,1,2,0.5,3,5,0.6,1,2,3,7,5,0,5,2,16,20,1.4,1.0,2019,20,4.0,1.4,4,2,6,0.5
2019-20,Playoffs,203584,145,Troy Daniels,1610612743,DEN,6,30,6,12,0.5,3,6,0.5,1,2,0.5,1,2,3,2,0,0,0,2,16,14,0.0,0.0,2019,20,2.6666666666666665,inf,6,1,7,0.42857142857142855
2019-20,Playoffs,1629058,147,Dzanan Musa,1610612751,BKN,3,39,2,11,0.182,0,6,0.0,10,14,0.714,1,2,3,4,0,1,3,2,14,6,1.33,0.0,2019,20,4.666666666666667,1.3333333333333333,9,4,13,0.23076923076923078
2019-20,Playoffs,1629658,147,Jaylen Hoard,1610612757,POR,3,41,7,12,0.583,0,0,0.0,0,0,0.0,5,4,9,1,0,0,2,5,14,17,0.5,0.0,2019,20,4.666666666666667,0.5,5,0,5,1.8
2019-20,Playoffs,203086,147,Meyers Leonard,1610612748,MIA,3,31,5,8,0.625,2,4,0.5,2,2,1.0,0,1,1,3,1,0,0,4,14,16,0.0,0.0,2019,20,4.666666666666667,inf,3,0,3,0.3333333333333333
2019-20,Playoffs,203077,147,Michael Kidd-Gilchrist,1610612742,DAL,6,55,4,14,0.286,2,9,0.222,4,6,0.667,2,4,6,3,1,1,1,8,14,12,3.0,1.0,2019,20,2.3333333333333335,3.0,10,2,12,0.5
2019-20,Playoffs,1626178,147,Rondae Hollis-Jefferson,1610612761,TOR,5,39,4,10,0.4,0,1,0.0,6,8,0.75,5,5,10,3,2,1,1,5,14,21,3.0,2.0,2019,20,2.8,3.0,6,2,8,1.25
2019-20,Playoffs,1629659,147,Talen Horton-Tucker,1610612747,LAL,2,17,6,12,0.5,2,5,0.4,0,0,0.0,0,5,5,0,2,0,0,4,14,15,0.0,0.0,2019,20,7.0,,6,0,6,0.8333333333333334
2019-20,Playoffs,1626144,153,Emmanuel Mudiay,1610612762,UTA,3,34,5,14,0.357,2,3,0.667,1,2,0.5,1,5,6,2,0,1,1,0,13,11,2.0,0.0,2019,20,4.333333333333333,2.0,9,1,10,0.6
2019-20,Playoffs,1628977,153,Hamidou Diallo,1610612760,OKC,3,25,4,11,0.364,1,5,0.2,4,7,0.571,2,4,6,1,0,2,2,0,13,10,0.5,0.0,2019,20,4.333333333333333,0.5,7,3,10,0.6
2019-20,Playoffs,1626188,153,Quinn Cook,1610612747,LAL,6,24,5,10,0.5,2,4,0.5,1,1,1.0,0,1,1,5,0,0,1,1,13,13,5.0,0.0,2019,20,2.1666666666666665,5.0,5,0,5,0.2
2019-20,Playoffs,1626169,153,Stanley Johnson,1610612761,TOR,3,20,5,11,0.455,2,5,0.4,1,1,1.0,1,3,4,6,0,0,1,3,13,16,6.0,0.0,2019,20,4.333333333333333,6.0,6,0,6,0.6666666666666666
2019-20,Playoffs,1629725,157,Jeremiah Martin,1610612751,BKN,3,27,4,14,0.286,3,5,0.6,1,1,1.0,0,3,3,4,0,1,2,2,12,8,2.0,0.0,2019,20,4.0,2.0,10,0,10,0.3
2019-20,Playoffs,203524,157,Solomon Hill,1610612748,MIA,7,42,5,9,0.556,2,6,0.333,0,0,0.0,1,6,7,3,1,0,0,5,12,19,0.0,0.0,2019,20,1.7142857142857142,inf,4,0,4,1.75
2019-20,Playoffs,203079,159,Dion Waiters,1610612747,LAL,5,38,4,12,0.333,0,4,0.0,2,2,1.0,0,2,2,2,1,1,1,2,10,7,2.0,1.0,2019,20,2.0,2.0,8,0,8,0.25
2019-20,Playoffs,203926,159,Doug McDermott,1610612754,IND,4,54,4,15,0.267,2,10,0.2,0,0,0.0,0,3,3,1,1,0,1,3,10,3,1.0,1.0,2019,20,2.5,1.0,11,0,11,0.2727272727272727
2019-20,Playoffs,1629752,159,Juwan Morgan,1610612762,UTA,7,86,3,12,0.25,2,10,0.2,2,6,0.333,6,15,21,5,2,0,1,11,10,24,5.0,2.0,2019,20,1.4285714285714286,5.0,9,4,13,1.6153846153846154
2019-20,Playoffs,1629641,159,Romeo Langford,1610612738,BOS,7,46,4,10,0.4,1,2,0.5,1,2,0.5,0,3,3,2,1,0,2,4,10,7,1.0,0.5,2019,20,1.4285714285714286,1.0,6,1,7,0.42857142857142855
2019-20,Playoffs,101141,163,Ersan Ilyasova,1610612749,MIL,3,23,3,9,0.333,1,5,0.2,2,2,1.0,0,4,4,0,2,0,1,3,9,8,0.0,2.0,2019,20,3.0,0.0,6,0,6,0.6666666666666666
2019-20,Playoffs,202335,163,Patrick Patterson,1610612746,LAC,2,10,3,3,1.0,3,3,1.0,0,0,0.0,0,1,1,4,0,0,0,1,9,14,0.0,0.0,2019,20,4.5,inf,0,0,0,inf
2019-20,Playoffs,1628396,163,Tony Bradley,1610612762,UTA,6,48,2,9,0.222,0,0,0.0,5,7,0.714,10,13,23,1,2,2,4,4,9,24,0.25,0.5,2019,20,1.5,0.25,7,2,9,2.5555555555555554
2019-20,Playoffs,1628449,166,Chris Boucher,1610612761,TOR,7,43,3,11,0.273,2,5,0.4,0,1,0.0,3,9,12,1,0,2,1,5,8,13,1.0,0.0,2019,20,1.1428571428571428,1.0,8,1,9,1.3333333333333333
2019-20,Playoffs,203526,166,Raul Neto,1610612755,PHI,2,26,3,9,0.333,2,5,0.4,0,0,0.0,0,3,3,3,1,0,1,0,8,8,3.0,1.0,2019,20,4.0,3.0,6,0,6,0.5
2019-20,Playoffs,203585,166,Rodney McGruder,1610612746,LAC,5,16,3,5,0.6,2,3,0.667,0,0,0.0,1,3,4,2,0,0,0,0,8,12,0.0,0.0,2019,20,1.6,inf,2,0,2,2.0
2019-20,Playoffs,1629598,169,Chris Clemons,1610612745,HOU,2,8,2,5,0.4,2,5,0.4,1,2,0.5,0,2,2,0,0,0,0,0,7,5,0.0,0.0,2019,20,3.5,,3,1,4,0.5
2019-20,Playoffs,1629743,169,Donta Hall,1610612751,BKN,3,20,3,5,0.6,0,0,0.0,1,4,0.25,3,2,5,0,0,2,1,1,7,8,0.0,0.0,2019,20,2.3333333333333335,0.0,2,3,5,1.0
2019-20,Playoffs,1629680,169,Matisse Thybulle,1610612755,PHI,4,75,3,7,0.429,1,4,0.25,0,0,0.0,1,6,7,2,3,1,2,6,7,14,1.0,1.5,2019,20,1.75,1.0,4,0,4,1.75
2019-20,Playoffs,1629671,169,Miye Oni,1610612762,UTA,2,14,3,6,0.5,1,4,0.25,0,0,0.0,2,2,4,0,1,1,1,2,7,9,0.0,1.0,2019,20,3.5,0.0,3,0,3,1.3333333333333333
2019-20,Playoffs,204456,169,T.J. McConnell,1610612754,IND,3,28,3,8,0.375,0,0,0.0,1,2,0.5,0,6,6,7,0,0,2,4,7,12,3.5,0.0,2019,20,2.3333333333333335,3.5,5,1,6,1.0
2019-20,Playoffs,1628410,174,Edmond Sumner,1610612754,IND,3,41,2,7,0.286,0,3,0.0,2,2,1.0,1,5,6,0,0,0,2,5,6,5,0.0,0.0,2019,20,2.0,0.0,5,0,5,1.2
2019-20,Playoffs,1629121,174,Jaylen Adams,1610612757,POR,3,21,3,9,0.333,0,4,0.0,0,0,0.0,1,2,3,2,1,0,0,1,6,6,0.0,0.0,2019,20,2.0,inf,6,0,6,0.5
2019-20,Playoffs,203118,174,Mike Scott,1610612755,PHI,4,20,1,5,0.2,0,2,0.0,4,4,1.0,2,6,8,1,0,0,0,2,6,11,0.0,0.0,2019,20,1.5,inf,4,0,4,2.0
2019-20,Playoffs,201577,174,Robin Lopez,1610612749,MIL,3,21,3,4,0.75,0,0,0.0,0,0,0.0,0,4,4,0,0,0,0,2,6,9,0.0,0.0,2019,20,2.0,,1,0,1,4.0
2019-20,Playoffs,1628390,174,Terrance Ferguson,1610612760,OKC,4,42,2,11,0.182,2,10,0.2,0,0,0.0,1,3,4,1,1,0,1,3,6,2,1.0,1.0,2019,20,1.5,1.0,9,0,9,0.4444444444444444
2019-20,Playoffs,1629730,179,Rayjon Tucker,1610612762,UTA,2,11,2,5,0.4,1,3,0.333,0,0,0.0,0,0,0,0,0,0,1,1,5,1,0.0,0.0,2019,20,2.5,0.0,3,0,3,0.0
2019-20,Playoffs,1627846,180,Abdel Nader,1610612760,OKC,3,25,1,7,0.143,1,5,0.2,1,2,0.5,1,2,3,0,1,2,0,1,4,3,0.0,0.0,2019,20,1.3333333333333333,,6,1,7,0.42857142857142855
2019-20,Playoffs,1628499,180,Antonius Cleveland,1610612742,DAL,2,9,2,5,0.4,0,0,0.0,0,0,0.0,1,0,1,0,1,0,0,1,4,3,0.0,0.0,2019,20,2.0,,3,0,3,0.3333333333333333
2019-20,Playoffs,1629729,180,Josh Reaves,1610612742,DAL,2,9,1,3,0.333,0,1,0.0,2,2,1.0,0,2,2,1,0,1,1,1,4,5,1.0,0.0,2019,20,2.0,1.0,2,0,2,1.0
2019-20,Playoffs,1628382,180,Justin Jackson,1610612742,DAL,3,16,1,6,0.167,0,3,0.0,2,4,0.5,0,3,3,0,0,0,0,1,4,0,0.0,0.0,2019,20,1.3333333333333333,,5,2,7,0.42857142857142855
2019-20,Playoffs,202498,180,Lance Thomas,1610612751,BKN,3,17,1,5,0.2,0,2,0.0,2,4,0.5,1,2,3,0,0,1,0,2,4,2,0.0,0.0,2019,20,1.3333333333333333,,4,2,6,0.5
2019-20,Playoffs,1629611,180,Terance Mann,1610612746,LAC,13,27,2,5,0.4,0,2,0.0,0,0,0.0,0,7,7,1,1,0,2,4,4,8,0.5,0.5,2019,20,0.3076923076923077,0.5,3,0,3,2.3333333333333335
2019-20,Playoffs,1629168,186,BJ Johnson,1610612753,ORL,1,4,1,2,0.5,1,1,1.0,0,0,0.0,0,2,2,0,0,0,0,0,3,4,0.0,0.0,2019,20,3.0,,1,0,1,2.0
2019-20,Playoffs,1627788,186,Furkan Korkmaz,1610612755,PHI,4,40,0,7,0.0,0,6,0.0,3,5,0.6,0,6,6,2,1,0,2,3,3,1,1.0,0.5,2019,20,0.75,1.0,7,2,9,0.6666666666666666
2019-20,Playoffs,200826,186,J.J. Barea,1610612742,DAL,1,5,0,1,0.0,0,0,0.0,3,3,1.0,0,0,0,0,0,0,1,1,3,1,0.0,0.0,2019,20,3.0,0.0,1,0,1,0.0
2019-20,Playoffs,1629750,186,Javonte Green,1610612738,BOS,1,6,1,2,0.5,1,2,0.5,0,0,0.0,0,1,1,0,0,0,0,1,3,3,0.0,0.0,2019,20,3.0,,1,0,1,1.0
2019-20,Playoffs,1628966,186,Keita Bates-Diop,1610612743,DEN,5,24,1,5,0.2,0,0,0.0,1,2,0.5,3,3,6,1,0,0,0,0,3,5,0.0,0.0,2019,20,0.6,inf,4,1,5,1.2
2019-20,Playoffs,1626259,186,Malcolm Miller,1610612761,TOR,1,5,1,3,0.333,1,1,1.0,0,0,0.0,0,0,0,0,0,0,0,2,3,1,0.0,0.0,2019,20,3.0,,2,0,2,0.0
2019-20,Playoffs,1626187,186,Michael Frazier II,1610612745,HOU,4,12,1,4,0.25,1,2,0.5,0,0,0.0,1,3,4,2,0,0,1,0,3,5,2.0,0.0,2019,20,0.75,2.0,3,0,3,1.3333333333333333
2019-20,Playoffs,203488,186,Mike Muscala,1610612760,OKC,2,20,1,2,0.5,1,1,1.0,0,0,0.0,0,4,4,1,0,0,0,2,3,7,0.0,0.0,2019,20,1.5,inf,1,0,1,4.0
2019-20,Playoffs,1629605,186,Tacko Fall,1610612738,BOS,2,3,1,1,1.0,0,0,0.0,1,2,0.5,0,1,1,0,0,0,0,0,3,3,0.0,0.0,2019,20,1.5,,0,1,1,1.0
2019-20,Playoffs,1629724,186,Vic Law,1610612753,ORL,1,4,1,1,1.0,1,1,1.0,0,0,0.0,0,2,2,1,0,0,0,0,3,6,0.0,0.0,2019,20,3.0,inf,0,0,0,inf
2019-20,Playoffs,1629599,196,Amir Coffey,1610612746,LAC,3,7,0,3,0.0,0,1,0.0,2,2,1.0,0,0,0,4,1,0,0,0,2,4,0.0,0.0,2019,20,0.6666666666666666,inf,3,0,3,0.0
2019-20,Playoffs,203998,196,Bruno Caboclo,1610612745,HOU,2,7,1,2,0.5,0,1,0.0,0,0,0.0,0,3,3,0,1,0,0,2,2,5,0.0,0.0,2019,20,1.0,,1,0,1,3.0
2019-20,Playoffs,201960,196,DeMarre Carroll,1610612745,HOU,2,6,1,2,0.5,0,0,0.0,0,0,0.0,0,3,3,1,0,0,0,1,2,5,0.0,0.0,2019,20,1.0,inf,1,0,1,3.0
2019-20,Playoffs,1628778,196,Paul Watson,1610612761,TOR,2,9,1,2,0.5,0,0,0.0,0,0,0.0,0,0,0,1,1,0,0,0,2,3,0.0,0.0,2019,20,1.0,inf,1,0,1,0.0
2019-20,Playoffs,1629714,200,Jarrell Brantley,1610612762,UTA,2,13,0,5,0.0,0,3,0.0,1,2,0.5,3,1,4,2,0,1,1,4,1,1,2.0,0.0,2019,20,0.5,2.0,5,1,6,0.6666666666666666
2019-20,Playoffs,1628993,201,Alize Johnson,1610612754,IND,1,0,0,0,0.0,0,0,0.0,0,0,0.0,0,0,0,0,0,0,0,0,0,0,0.0,0.0,2019,20,0.0,,0,0,0,
2019-20,Playoffs,203460,201,Andre Roberson,1610612760,OKC,1,3,0,1,0.0,0,1,0.0,0,0,0.0,0,0,0,0,0,0,0,1,0,-1,0.0,0.0,2019,20,0.0,,1,0,1,0.0
2019-20,Playoffs,1629035,201,Carsen Edwards,1610612738,BOS,1,3,0,0,0.0,0,0,0.0,0,0,0.0,0,1,1,0,0,0,0,0,0,1,0.0,0.0,2019,20,0.0,,0,0,0,inf
2019-20,Playoffs,1629126,201,Deonte Burton,1610612760,OKC,1,2,0,0,0.0,0,0,0.0,0,0,0.0,0,0,0,0,0,0,0,0,0,0,0.0,0.0,2019,20,0.0,,0,0,0,
2019-20,Playoffs,1628412,201,Frank Mason III,1610612749,MIL,2,2,0,0,0.0,0,0,0.0,0,0,0.0,0,0,0,1,0,0,0,0,0,1,0.0,0.0,2019,20,0.0,inf,0,0,0,
2019-20,Playoffs,1629216,201,Gabe Vincent,1610612748,MIA,1,0,0,0,0.0,0,0,0.0,0,0,0.0,0,0,0,0,0,0,0,0,0,0,0.0,0.0,2019,20,0.0,,0,0,0,
2019-20,Playoffs,201162,201,Jared Dudley,1610612747,LAL,9,31,0,4,0.0,0,3,0.0,0,0,0.0,0,2,2,0,4,1,2,2,0,1,0.0,2.0,2019,20,0.0,0.0,4,0,4,0.5
2019-20,Playoffs,201149,201,Joakim Noah,1610612746,LAC,2,2,0,0,0.0,0,0,0.0,0,0,0.0,0,0,0,0,0,0,0,0,0,0,0.0,0.0,2019,20,0.0,,0,0,0,
2019-20,Playoffs,203124,201,Kyle O'Quinn,1610612755,PHI,1,6,0,0,0.0,0,0,0.0,0,0,0.0,0,1,1,1,0,0,2,3,0,0,0.5,0.0,2019,20,0.0,0.5,0,0,0,inf
2019-20,Playoffs,1628430,201,Nigel Williams-Goss,1610612762,UTA,1,2,0,0,0.0,0,0,0.0,0,0,0.0,0,0,0,1,0,0,0,0,0,1,0.0,0.0,2019,20,0.0,inf,0,0,0,
2019-20,Playoffs,203943,201,Noah Vonleh,1610612743,DEN,1,3,0,1,0.0,0,0,0.0,0,0,0.0,0,0,0,0,0,0,0,0,0,-1,0.0,0.0,2019,20,0.0,,1,0,1,0.0
2019-20,Playoffs,203658,201,Norvel Pelle,1610612755,PHI,1,7,0,0,0.0,0,0,0.0,0,0,0.0,0,0,0,0,1,1,0,0,0,2,0.0,0.0,2019,20,0.0,,0,0,0,
2019-20,Playoffs,1628425,201,Sterling Brown,1610612749,MIL,1,4,0,1,0.0,0,1,0.0,0,0,0.0,0,1,1,0,0,0,0,0,0,0,0.0,0.0,2019,20,0.0,,1,0,1,1.0
2019-20,Playoffs,1629682,201,Tremont Waters,1610612738,BOS,1,2,0,1,0.0,0,1,0.0,0,0,0.0,0,1,1,1,0,0,0,0,0,1,0.0,0.0,2019,20,0.0,inf,1,0,1,1.0
2019-20,Playoffs,1629076,201,Tyler Cook,1610612743,DEN,1,4,0,0,0.0,0,0,0.0,0,0,0.0,0,2,2,0,0,0,0,0,0,2,0.0,0.0,2019,20,0.0,,0,0,0,inf
2019-20,Playoffs,2199,201,Tyson Chandler,1610612745,HOU,1,0,0,0,0.0,0,0,0.0,0,2,0.0,0,0,0,0,0,0,0,0,0,-2,0.0,0.0,2019,20,0.0,,0,2,2,0.0
2019-20,Playoffs,1629738,201,Vincent Poirier,1610612738,BOS,1,2,0,0,0.0,0,0,0.0,0,0,0.0,0,0,0,1,1,0,0,0,0,2,0.0,0.0,2019,20,0.0,inf,0,0,0,
2020-21,RegularSeason,201939,1,Stephen Curry,1610612744,GSW,63,2152,658,1365,0.482,337,801,0.421,362,395,0.916,29,316,345,363,77,8,213,119,2015,1855,1.7,0.36,2020,21,31.984126984126984,1.704225352112676,707,33,740,0.46621621621621623
2020-21,RegularSeason,203081,2,Damian Lillard,1610612757,POR,67,2398,602,1334,0.451,275,704,0.391,449,484,0.928,32,251,283,505,62,17,203,102,1928,1825,2.49,0.3,2020,21,28.776119402985074,2.4876847290640396,732,35,767,0.36897001303780963
2020-21,RegularSeason,203999,3,Nikola Jokic,1610612743,DEN,72,2488,732,1293,0.566,92,237,0.388,342,394,0.868,205,575,780,599,95,48,222,192,1898,2585,2.7,0.43,2020,21,26.36111111111111,2.6981981981981984,561,52,613,1.272430668841762
2020-21,RegularSeason,203078,4,Bradley Beal,1610612764,WAS,60,2147,670,1382,0.485,130,373,0.349,408,459,0.889,72,211,283,265,69,22,187,140,1878,1567,1.42,0.37,2020,21,31.3,1.4171122994652405,712,51,763,0.3709043250327654
2020-21,RegularSeason,1629029,5,Luka Doncic,1610612742,DAL,66,2262,647,1351,0.479,192,548,0.35,344,471,0.73,54,473,527,567,64,36,281,152,1830,1912,2.02,0.23,2020,21,27.727272727272727,2.01779359430605,704,127,831,0.6341756919374247
2020-21,RegularSeason,203507,6,Giannis Antetokounmpo,1610612749,MIL,61,2013,626,1100,0.569,67,221,0.303,398,581,0.685,97,574,671,357,72,73,207,168,1717,2026,1.73,0.35,2020,21,28.147540983606557,1.7246376811594204,474,183,657,1.02130898021309
2020-21,RegularSeason,1626164,7,Devin Booker,1610612756,PHX,67,2270,623,1287,0.484,126,371,0.34,340,392,0.867,34,247,281,289,53,16,207,181,1712,1428,1.4,0.26,2020,21,25.55223880597015,1.396135265700483,664,52,716,0.3924581005586592
2020-21,RegularSeason,203944,7,Julius Randle,1610612752,NYK,71,2667,602,1321,0.456,160,389,0.411,348,429,0.811,84,640,724,427,64,18,241,225,1712,1904,1.77,0.27,2020,21,24.112676056338028,1.7717842323651452,719,81,800,0.905
2020-21,RegularSeason,1628369,9,Jayson Tatum,1610612738,BOS,64,2290,605,1318,0.459,187,485,0.386,295,340,0.868,50,422,472,276,75,31,171,122,1692,1617,1.61,0.44,2020,21,26.4375,1.6140350877192982,713,45,758,0.6226912928759895
2020-21,RegularSeason,1629627,10,Zion Williamson,1610612740,NOP,61,2026,634,1037,0.611,10,34,0.294,369,529,0.698,167,274,441,226,57,39,167,135,1647,1680,1.35,0.34,2020,21,27.0,1.3532934131736527,403,160,563,0.783303730017762
2020-21,RegularSeason,202696,11,Nikola Vucevic,1610612741,CHI,70,2348,666,1396,0.477,176,440,0.4,131,156,0.84,146,671,817,269,65,48,126,137,1639,1957,2.13,0.52,2020,21,23.414285714285715,2.134920634920635,730,25,755,1.0821192052980133
2020-21,RegularSeason,1629027,12,Trae Young,1610612737,ATL,63,2125,487,1112,0.438,136,397,0.343,484,546,0.886,38,207,245,594,53,12,261,111,1594,1550,2.28,0.2,2020,21,25.3015873015873,2.2758620689655173,625,62,687,0.35662299854439594
2020-21,RegularSeason,203897,13,Zach LaVine,1610612741,CHI,58,2034,569,1123,0.507,200,477,0.419,253,298,0.849,36,253,289,282,46,27,203,138,1591,1433,1.39,0.23,2020,21,27.43103448275862,1.3891625615763548,554,45,599,0.48247078464106846
2020-21,RegularSeason,1628368,14,De'Aaron Fox,1610612758,SAC,58,2036,529,1110,0.477,103,320,0.322,300,417,0.719,33,170,203,417,87,27,174,170,1461,1323,2.4,0.5,2020,21,25.189655172413794,2.396551724137931,581,117,698,0.29083094555873923
2020-21,RegularSeason,1629012,15,Collin Sexton,1610612739,CLE,60,2115,525,1105,0.475,98,264,0.371,312,383,0.815,58,129,187,262,62,10,167,157,1460,1163,1.57,0.37,2020,21,24.333333333333332,1.5688622754491017,580,71,651,0.2872503840245776
2020-21,RegularSeason,203954,16,Joel Embiid,1610612755,PHI,51,1585,461,899,0.513,58,154,0.377,471,548,0.859,113,426,539,145,50,69,159,123,1451,1580,0.91,0.31,2020,21,28.45098039215686,0.9119496855345912,438,77,515,1.0466019417475727
2020-21,RegularSeason,202681,16,Kyrie Irving,1610612751,BKN,54,1886,549,1086,0.506,152,378,0.402,201,218,0.922,52,205,257,324,76,37,130,140,1451,1461,2.49,0.58,2020,21,26.87037037037037,2.4923076923076923,537,17,554,0.463898916967509
2020-21,RegularSeason,1627742,18,Brandon Ingram,1610612740,NOP,61,2092,513,1101,0.466,143,375,0.381,281,320,0.878,34,265,299,296,42,36,154,124,1450,1342,1.92,0.27,2020,21,23.770491803278688,1.922077922077922,588,39,627,0.4768740031897927
2020-21,RegularSeason,201566,19,Russell Westbrook,1610612764,WAS,65,2369,544,1238,0.439,86,273,0.315,271,413,0.656,109,641,750,763,89,23,312,190,1445,1922,2.45,0.28,2020,21,22.23076923076923,2.4455128205128207,694,142,836,0.8971291866028708
2020-21,RegularSeason,1627759,20,Jaylen Brown,1610612738,BOS,58,1999,538,1111,0.484,163,411,0.397,191,250,0.764,71,276,347,195,72,32,158,168,1430,1286,1.23,0.46,2020,21,24.655172413793103,1.2341772151898733,573,59,632,0.5490506329113924
2020-21,RegularSeason,1626179,21,Terry Rozier,1610612766,CHA,69,2383,510,1134,0.45,222,571,0.389,165,202,0.817,47,255,302,293,87,26,128,119,1407,1326,2.29,0.68,2020,21,20.391304347826086,2.2890625,624,37,661,0.4568835098335855
2020-21,RegularSeason,1628378,22,Donovan Mitchell,1610612762,UTA,53,1771,478,1091,0.438,178,461,0.386,267,316,0.845,50,185,235,277,52,15,147,117,1401,1171,1.88,0.35,2020,21,26.433962264150942,1.8843537414965987,613,49,662,0.3549848942598187
2020-21,RegularSeason,1630162,23,Anthony Edwards,1610612750,MIN,72,2314,505,1211,0.417,171,520,0.329,211,272,0.776,59,277,336,211,82,36,160,129,1392,1130,1.32,0.51,2020,21,19.333333333333332,1.31875,706,61,767,0.4380704041720991
2020-21,RegularSeason,203114,24,Khris Middleton,1610612749,MIL,68,2269,511,1074,0.476,151,365,0.414,212,236,0.898,54,352,406,370,74,9,178,160,1385,1479,2.08,0.42,2020,21,20.36764705882353,2.0786516853932584,563,24,587,0.6916524701873935
2020-21,RegularSeason,203952,25,Andrew Wiggins,1610612744,GSW,71,2364,505,1058,0.477,140,368,0.38,170,238,0.714,82,265,347,167,67,70,126,159,1320,1224,1.32,0.53,2020,21,18.591549295774648,1.3253968253968254,553,68,621,0.5587761674718197
2020-21,RegularSeason,201942,26,DeMar DeRozan,1610612759,SAS,61,2056,455,920,0.495,19,74,0.257,387,440,0.88,40,219,259,422,56,15,119,128,1316,1431,3.55,0.47,2020,21,21.57377049180328,3.546218487394958,465,53,518,0.5
2020-21,RegularSeason,202695,27,Kawhi Leonard,1610612746,LAC,52,1772,465,908,0.512,101,254,0.398,261,295,0.885,55,282,337,269,81,21,105,82,1292,1418,2.56,0.77,2020,21,24.846153846153847,2.5619047619047617,443,34,477,0.7064989517819706
2020-21,RegularSeason,1626181,28,Norman Powell,1610612757,POR,69,2206,438,918,0.477,171,416,0.411,236,271,0.871,42,173,215,129,82,18,119,160,1283,1093,1.08,0.69,2020,21,18.594202898550726,1.084033613445378,480,35,515,0.4174757281553398
2020-21,RegularSeason,1629628,29,RJ Barrett,1610612752,NYK,72,2511,467,1060,0.441,124,309,0.401,206,276,0.746,68,346,414,217,53,20,139,188,1264,1166,1.56,0.38,2020,21,17.555555555555557,1.5611510791366907,593,70,663,0.6244343891402715
2020-21,RegularSeason,1627734,30,Domantas Sabonis,1610612754,IND,62,2231,484,904,0.535,52,162,0.321,240,328,0.732,150,592,742,415,76,33,213,203,1260,1805,1.95,0.36,2020,21,20.322580645161292,1.948356807511737,420,88,508,1.4606299212598426
2020-21,RegularSeason,202331,31,Paul George,1610612746,LAC,54,1821,445,953,0.467,171,416,0.411,198,228,0.868,45,314,359,280,62,24,179,132,1259,1267,1.56,0.35,2020,21,23.314814814814813,1.5642458100558658,508,30,538,0.6672862453531598
2020-21,RegularSeason,203903,32,Jordan Clarkson,1610612762,UTA,68,1818,457,1075,0.425,208,599,0.347,129,144,0.896,47,227,274,168,61,10,115,110,1251,1016,1.46,0.53,2020,21,18.397058823529413,1.4608695652173913,618,15,633,0.43285939968404424
2020-21,RegularSeason,1626157,33,Karl-Anthony Towns,1610612750,MIN,50,1689,425,875,0.486,122,315,0.387,267,311,0.859,133,396,529,225,39,57,160,186,1239,1435,1.41,0.24,2020,21,24.78,1.40625,450,44,494,1.0708502024291497
2020-21,RegularSeason,202711,34,Bojan Bogdanovic,1610612762,UTA,72,2216,406,925,0.439,180,461,0.39,233,265,0.879,40,241,281,136,45,4,128,115,1225,1012,1.06,0.35,2020,21,17.01388888888889,1.0625,519,32,551,0.5099818511796733
2020-21,RegularSeason,202699,35,Tobias Harris,1610612755,PHI,62,2014,473,924,0.512,82,208,0.394,182,204,0.892,62,357,419,220,55,51,107,119,1210,1375,2.06,0.51,2020,21,19.516129032258064,2.05607476635514,451,22,473,0.8858350951374208
2020-21,RegularSeason,203924,36,Jerami Grant,1610612765,DET,54,1829,400,932,0.429,115,329,0.35,290,343,0.845,35,215,250,152,35,58,109,125,1205,1006,1.39,0.32,2020,21,22.314814814814813,1.3944954128440368,532,53,585,0.42735042735042733
2020-21,RegularSeason,1629630,37,Ja Morant,1610612763,MEM,63,2053,430,957,0.449,73,241,0.303,271,372,0.728,59,193,252,465,57,13,203,87,1204,1160,2.29,0.28,2020,21,19.11111111111111,2.29064039408867,527,101,628,0.4012738853503185
2020-21,RegularSeason,1628389,38,Bam Adebayo,1610612748,MIA,64,2143,456,800,0.57,2,8,0.25,283,354,0.799,142,431,573,346,75,66,169,145,1197,1673,2.05,0.44,2020,21,18.703125,2.0473372781065087,344,71,415,1.380722891566265
2020-21,RegularSeason,1627783,39,Pascal Siakam,1610612761,TOR,56,2006,437,961,0.455,73,246,0.297,249,301,0.827,95,310,405,250,64,37,130,174,1196,1246,1.92,0.49,2020,21,21.357142857142858,1.9230769230769231,524,52,576,0.703125
2020-21,RegularSeason,1627763,40,Malcolm Brogdon,1610612754,IND,56,1930,444,980,0.453,145,374,0.388,153,177,0.864,58,236,294,329,49,15,115,110,1186,1198,2.86,0.43,2020,21,21.178571428571427,2.860869565217391,536,24,560,0.525
2020-21,RegularSeason,1627741,41,Buddy Hield,1610612758,SAC,71,2433,403,992,0.406,282,721,0.391,88,104,0.846,29,305,334,257,63,30,130,175,1176,1125,1.98,0.48,2020,21,16.56338028169014,1.976923076923077,589,16,605,0.5520661157024793
2020-21,RegularSeason,203501,42,Tim Hardaway Jr.,1610612742,DAL,70,1985,407,911,0.447,207,529,0.391,142,174,0.816,20,209,229,126,31,11,64,111,1163,960,1.97,0.48,2020,21,16.614285714285714,1.96875,504,32,536,0.42723880597014924
2020-21,RegularSeason,1629008,43,Michael Porter Jr.,1610612743,DEN,61,1912,443,817,0.542,170,382,0.445,106,134,0.791,91,354,445,70,40,54,77,126,1162,1292,0.91,0.52,2020,21,19.049180327868854,0.9090909090909091,374,28,402,1.1069651741293531
2020-21,RegularSeason,1628415,44,Dillon Brooks,1610612763,MEM,67,1997,432,1031,0.419,128,372,0.344,159,195,0.815,53,143,196,157,78,26,119,237,1151,854,1.32,0.66,2020,21,17.17910447761194,1.319327731092437,599,36,635,0.30866141732283464
2020-21,RegularSeason,101108,45,Chris Paul,1610612756,PHX,70,2200,439,879,0.499,102,258,0.395,169,181,0.934,25,287,312,622,99,19,156,166,1149,1593,3.99,0.64,2020,21,16.414285714285715,3.9871794871794872,440,12,452,0.6902654867256637
2020-21,RegularSeason,2544,46,LeBron James,1610612747,LAL,45,1504,422,823,0.513,104,285,0.365,178,255,0.698,29,317,346,350,48,25,168,70,1126,1249,2.08,0.29,2020,21,25.022222222222222,2.0833333333333335,401,77,478,0.7238493723849372
2020-21,RegularSeason,202710,47,Jimmy Butler,1610612748,MIA,52,1745,366,736,0.497,25,102,0.245,359,416,0.863,94,265,359,369,108,18,109,71,1116,1434,3.38,0.99,2020,21,21.46153846153846,3.385321100917431,370,57,427,0.8407494145199064
2020-21,RegularSeason,1628381,48,John Collins,1610612737,ATL,63,1848,429,771,0.556,83,208,0.399,170,204,0.833,118,349,467,78,34,63,84,193,1111,1293,0.93,0.41,2020,21,17.634920634920636,0.9285714285714286,342,34,376,1.2420212765957446
2020-21,RegularSeason,203468,49,CJ McCollum,1610612757,POR,47,1600,405,884,0.458,169,420,0.402,108,133,0.812,30,155,185,223,44,21,65,87,1087,991,3.43,0.68,2020,21,23.127659574468087,3.4307692307692306,479,25,504,0.36706349206349204
2020-21,RegularSeason,201935,50,James Harden,1610612751,BKN,44,1609,342,734,0.466,121,334,0.362,278,323,0.861,35,313,348,475,53,33,177,99,1083,1378,2.68,0.3,2020,21,24.613636363636363,2.6836158192090394,392,45,437,0.7963386727688787
2020-21,RegularSeason,202685,51,Jonas Valanciunas,1610612763,MEM,62,1755,440,743,0.592,21,57,0.368,157,203,0.773,253,523,776,112,35,57,100,179,1058,1589,1.12,0.35,2020,21,17.06451612903226,1.12,303,46,349,2.2234957020057307
2020-21,RegularSeason,1627749,52,Dejounte Murray,1610612759,SAS,67,2139,441,974,0.453,63,199,0.317,106,134,0.791,58,415,473,363,101,7,117,135,1051,1317,3.1,0.86,2020,21,15.686567164179104,3.1025641025641026,533,28,561,0.8431372549019608
2020-21,RegularSeason,201950,53,Jrue Holiday,1610612749,MIL,59,1907,414,823,0.503,111,283,0.392,107,136,0.787,73,195,268,357,96,37,127,98,1046,1239,2.81,0.76,2020,21,17.728813559322035,2.811023622047244,409,29,438,0.6118721461187214
2020-21,RegularSeason,1629632,54,Coby White,1610612741,CHI,69,2156,375,902,0.416,163,454,0.359,128,142,0.901,28,256,284,328,38,15,156,179,1041,1009,2.1,0.24,2020,21,15.08695652173913,2.1025641025641026,527,14,541,0.5249537892791127
2020-21,RegularSeason,1627832,55,Fred VanVleet,1610612761,TOR,52,1899,338,870,0.389,174,476,0.366,169,191,0.885,32,188,220,328,87,37,95,119,1019,1042,3.45,0.92,2020,21,19.596153846153847,3.4526315789473685,532,22,554,0.3971119133574007
2020-21,RegularSeason,1627750,56,Jamal Murray,1610612743,DEN,48,1704,378,792,0.477,129,316,0.408,133,153,0.869,37,157,194,231,64,13,108,95,1018,978,2.14,0.59,2020,21,21.208333333333332,2.138888888888889,414,20,434,0.4470046082949309
2020-21,RegularSeason,203497,57,Rudy Gobert,1610612762,UTA,71,2187,391,579,0.675,0,4,0.0,233,374,0.623,240,720,960,89,40,190,118,163,1015,1847,0.75,0.34,2020,21,14.295774647887324,0.7542372881355932,188,141,329,2.917933130699088
2020-21,RegularSeason,1629028,58,Deandre Ayton,1610612756,PHX,69,2115,430,687,0.626,4,20,0.2,133,173,0.769,228,499,727,99,41,81,103,196,997,1545,0.96,0.4,2020,21,14.44927536231884,0.9611650485436893,257,40,297,2.4478114478114477
2020-21,RegularSeason,203925,59,Joe Harris,1610612751,BKN,69,2142,357,707,0.505,211,444,0.475,49,63,0.778,43,205,248,130,46,14,62,141,974,986,2.1,0.74,2020,21,14.115942028985508,2.096774193548387,350,14,364,0.6813186813186813
2020-21,RegularSeason,1628969,60,Mikal Bridges,1610612756,PHX,72,2348,363,669,0.543,134,315,0.425,110,131,0.84,76,233,309,152,76,63,57,116,970,1186,2.67,1.33,2020,21,13.472222222222221,2.6666666666666665,306,21,327,0.944954128440367
2020-21,RegularSeason,203991,61,Clint Capela,1610612737,ATL,63,1898,413,695,0.594,0,0,0.0,130,227,0.573,297,606,903,49,44,129,73,145,956,1629,0.67,0.6,2020,21,15.174603174603174,0.6712328767123288,282,97,379,2.3825857519788918
2020-21,RegularSeason,1627747,62,Caris LeVert,1610612754,IND,47,1485,359,814,0.441,84,258,0.326,146,180,0.811,33,181,214,245,66,30,102,105,948,912,2.4,0.65,2020,21,20.170212765957448,2.4019607843137254,455,34,489,0.4376278118609407
2020-21,RegularSeason,203482,63,Kelly Olynyk,1610612745,HOU,70,1997,337,697,0.484,126,368,0.342,145,175,0.829,87,402,489,203,79,42,126,207,945,1242,1.61,0.63,2020,21,13.5,1.6111111111111112,360,30,390,1.2538461538461538
2020-21,RegularSeason,201142,64,Kevin Durant,1610612751,BKN,35,1157,324,603,0.537,85,189,0.45,210,238,0.882,13,234,247,195,25,45,120,70,943,1028,1.63,0.21,2020,21,26.942857142857143,1.625,279,28,307,0.8045602605863192
2020-21,RegularSeason,1629130,65,Duncan Robinson,1610612748,MIA,72,2262,315,717,0.439,250,613,0.408,62,75,0.827,7,243,250,127,43,20,81,181,942,886,1.57,0.53,2020,21,13.083333333333334,1.5679012345679013,402,13,415,0.6024096385542169
2020-21,RegularSeason,1629636,66,Darius Garland,1610612739,CLE,54,1790,362,802,0.451,105,266,0.395,112,132,0.848,23,106,129,329,66,6,164,110,941,847,2.01,0.4,2020,21,17.425925925925927,2.0060975609756095,440,20,460,0.28043478260869564
2020-21,RegularSeason,203471,66,Dennis Schroder,1610612747,LAL,61,1956,332,760,0.437,71,212,0.335,206,243,0.848,30,181,211,351,70,13,163,159,941,958,2.15,0.43,2020,21,15.426229508196721,2.1533742331288344,428,37,465,0.45376344086021503
2020-21,RegularSeason,203084,68,Harrison Barnes,1610612758,SAC,58,2102,319,642,0.497,100,256,0.391,195,235,0.83,64,321,385,201,43,11,93,75,933,1117,2.16,0.46,2020,21,16.086206896551722,2.161290322580645,323,40,363,1.0606060606060606
2020-21,RegularSeason,1626149,69,Montrezl Harrell,1610612747,LAL,69,1580,375,603,0.622,0,10,0.0,181,256,0.707,158,270,428,73,46,49,74,128,931,1150,0.99,0.62,2020,21,13.492753623188406,0.9864864864864865,228,75,303,1.4125412541254125
2020-21,RegularSeason,2546,70,Carmelo Anthony,1610612757,POR,69,1690,327,777,0.421,133,325,0.409,137,154,0.89,32,182,214,104,46,38,61,144,924,798,1.71,0.75,2020,21,13.391304347826088,1.7049180327868851,450,17,467,0.4582441113490364
2020-21,RegularSeason,203926,71,Doug McDermott,1610612754,IND,66,1619,354,665,0.532,111,286,0.388,80,98,0.816,60,161,221,85,20,6,53,117,899,849,1.6,0.38,2020,21,13.621212121212121,1.6037735849056605,311,18,329,0.6717325227963525
2020-21,RegularSeason,1629018,72,Gary Trent Jr.,1610612761,TOR,58,1802,320,785,0.408,165,429,0.385,83,106,0.783,27,125,152,80,56,10,43,92,888,655,1.86,1.3,2020,21,15.310344827586206,1.8604651162790697,465,23,488,0.3114754098360656
2020-21,RegularSeason,1629640,73,Keldon Johnson,1610612759,SAS,69,1968,338,705,0.479,60,181,0.331,145,196,0.74,93,319,412,121,40,24,78,142,881,982,1.55,0.51,2020,21,12.768115942028986,1.5512820512820513,367,51,418,0.9856459330143541
2020-21,RegularSeason,1628398,74,Kyle Kuzma,1610612747,LAL,68,1954,335,757,0.443,137,380,0.361,67,97,0.691,108,309,417,127,35,41,113,121,874,929,1.12,0.31,2020,21,12.852941176470589,1.1238938053097345,422,30,452,0.922566371681416
2020-21,RegularSeason,202339,75,Eric Bledsoe,1610612740,NOP,71,2112,307,730,0.421,121,355,0.341,134,195,0.687,29,215,244,268,55,24,114,112,869,862,2.35,0.48,2020,21,12.23943661971831,2.3508771929824563,423,61,484,0.5041322314049587
2020-21,RegularSeason,1626158,75,Richaun Holmes,1610612758,SAC,61,1781,366,575,0.637,2,11,0.182,135,170,0.794,144,360,504,101,39,96,75,213,869,1290,1.35,0.52,2020,21,14.245901639344263,1.3466666666666667,209,35,244,2.0655737704918034
2020-21,RegularSeason,204001,77,Kristaps Porzingis,1610612742,DAL,43,1327,325,683,0.476,97,258,0.376,118,138,0.855,82,299,381,68,20,58,51,115,865,963,1.33,0.39,2020,21,20.11627906976744,1.3333333333333333,358,20,378,1.007936507936508
2020-21,RegularSeason,202330,78,Gordon Hayward,1610612766,CHA,44,1496,311,658,0.473,85,205,0.415,156,185,0.843,37,221,258,181,52,14,91,74,863,901,1.99,0.57,2020,21,19.613636363636363,1.989010989010989,347,29,376,0.6861702127659575
2020-21,RegularSeason,1626174,79,Christian Wood,1610612745,HOU,41,1326,329,640,0.514,77,206,0.374,125,198,0.631,76,319,395,71,34,48,80,88,860,944,0.89,0.42,2020,21,20.975609756097562,0.8875,311,73,384,1.0286458333333333
2020-21,RegularSeason,201572,80,Brook Lopez,1610612749,MIL,70,1902,322,640,0.503,95,281,0.338,120,142,0.845,104,243,347,50,40,103,64,149,859,995,0.78,0.63,2020,21,12.271428571428572,0.78125,318,22,340,1.0205882352941176
2020-21,RegularSeason,1628973,81,Jalen Brunson,1610612742,DAL,68,1697,328,627,0.523,81,200,0.405,120,151,0.795,27,204,231,239,35,1,80,109,857,953,2.99,0.44,2020,21,12.602941176470589,2.9875,299,31,330,0.7
2020-21,RegularSeason,1630180,81,Saddiq Bey,1610612765,DET,70,1909,279,691,0.404,175,460,0.38,124,147,0.844,43,275,318,95,52,14,60,110,857,841,1.58,0.87,2020,21,12.242857142857142,1.5833333333333333,412,23,435,0.7310344827586207
2020-21,RegularSeason,203937,83,Kyle Anderson,1610612763,MEM,69,1887,308,658,0.468,94,261,0.36,144,184,0.783,52,344,396,250,84,57,86,120,854,1165,2.91,0.98,2020,21,12.376811594202898,2.9069767441860463,350,40,390,1.0153846153846153
2020-21,RegularSeason,1626162,84,Kelly Oubre Jr.,1610612744,GSW,55,1688,318,724,0.439,90,285,0.316,123,177,0.695,82,247,329,73,57,42,70,121,849,820,1.04,0.81,2020,21,15.436363636363636,1.042857142857143,406,54,460,0.7152173913043478
2020-21,RegularSeason,1628970,85,Miles Bridges,1610612766,CHA,66,1932,313,622,0.503,116,290,0.4,98,113,0.867,81,316,397,147,44,52,106,143,840,1050,1.39,0.41,2020,21,12.727272727272727,1.3867924528301887,309,15,324,1.2253086419753085
2020-21,RegularSeason,1628983,86,Shai Gilgeous-Alexander,1610612760,OKC,35,1180,287,565,0.508,71,170,0.418,185,229,0.808,19,147,166,207,27,23,106,70,830,825,1.95,0.26,2020,21,23.714285714285715,1.9528301886792452,278,44,322,0.515527950310559
2020-21,RegularSeason,1627732,87,Ben Simmons,1610612755,PHI,58,1877,325,583,0.557,3,10,0.3,176,287,0.613,93,324,417,401,93,35,173,171,829,1233,2.32,0.54,2020,21,14.293103448275861,2.3179190751445087,258,111,369,1.1300813008130082
2020-21,RegularSeason,202689,87,Kemba Walker,1610612760,OKC,43,1369,284,676,0.42,127,353,0.36,134,149,0.899,16,154,170,212,48,12,88,61,829,776,2.41,0.55,2020,21,19.27906976744186,2.409090909090909,392,15,407,0.4176904176904177
2020-21,RegularSeason,1628367,89,Josh Jackson,1610612765,DET,62,1560,296,707,0.419,77,257,0.3,159,218,0.729,57,197,254,143,53,47,142,178,828,713,1.01,0.37,2020,21,13.35483870967742,1.0070422535211268,411,59,470,0.5404255319148936
2020-21,RegularSeason,201144,90,Mike Conley,1610612762,UTA,51,1498,284,640,0.444,138,335,0.412,121,142,0.852,36,141,177,305,70,9,99,98,827,912,3.08,0.71,2020,21,16.215686274509803,3.080808080808081,356,21,377,0.46949602122015915
2020-21,RegularSeason,1629023,91,P.J. Washington,1610612766,CHA,64,1954,302,686,0.44,112,290,0.386,108,145,0.745,93,325,418,161,69,79,128,171,824,1002,1.26,0.54,2020,21,12.875,1.2578125,384,37,421,0.9928741092636579
2020-21,RegularSeason,202322,92,John Wall,1610612745,HOU,40,1288,293,726,0.404,79,249,0.317,158,211,0.749,17,112,129,275,42,31,141,46,823,673,1.95,0.3,2020,21,20.575,1.950354609929078,433,53,486,0.2654320987654321
2020-21,RegularSeason,201152,92,Thaddeus Young,1610612741,CHI,68,1652,370,662,0.559,12,45,0.267,71,113,0.628,168,255,423,291,74,40,137,152,823,1180,2.12,0.54,2020,21,12.102941176470589,2.124087591240876,292,42,334,1.2664670658682635
2020-21,RegularSeason,1628989,94,Kevin Huerter,1610612737,ATL,69,2126,316,731,0.432,140,386,0.363,50,64,0.781,38,193,231,241,82,18,79,165,822,886,3.05,1.04,2020,21,11.91304347826087,3.050632911392405,415,14,429,0.5384615384615384
2020-21,RegularSeason,1628449,95,Chris Boucher,1610612761,TOR,60,1453,288,560,0.514,90,235,0.383,152,193,0.788,117,287,404,63,35,111,46,166,818,1072,1.37,0.76,2020,21,13.633333333333333,1.3695652173913044,272,41,313,1.29073482428115
2020-21,RegularSeason,1629003,96,Shake Milton,1610612755,PHI,63,1461,300,667,0.45,71,203,0.35,146,176,0.83,33,115,148,193,39,18,103,130,817,715,1.87,0.38,2020,21,12.968253968253968,1.8737864077669903,367,30,397,0.37279596977329976
2020-21,RegularSeason,1628984,97,Devonte' Graham,1610612766,CHA,55,1659,252,669,0.377,179,477,0.375,133,158,0.842,22,126,148,295,48,6,84,77,816,787,3.51,0.57,2020,21,14.836363636363636,3.511904761904762,417,25,442,0.334841628959276
2020-21,RegularSeason,1629134,97,Kendrick Nunn,1610612748,MIA,56,1650,319,658,0.485,122,320,0.381,56,60,0.933,21,158,179,148,52,14,80,108,816,786,1.85,0.65,2020,21,14.571428571428571,1.85,339,4,343,0.521865889212828
2020-21,RegularSeason,1629639,99,Tyler Herro,1610612748,MIA,54,1635,307,699,0.439,107,297,0.36,94,117,0.803,25,243,268,184,35,17,101,71,815,803,1.82,0.35,2020,21,15.092592592592593,1.8217821782178218,392,23,415,0.6457831325301204
2020-21,RegularSeason,204060,100,Joe Ingles,1610612762,UTA,67,1867,275,562,0.489,183,406,0.451,76,90,0.844,27,217,244,318,45,12,117,120,809,1010,2.72,0.39,2020,21,12.074626865671641,2.717948717948718,287,14,301,0.8106312292358804
2020-21,RegularSeason,202683,101,Enes Freedom,1610612757,POR,72,1757,339,561,0.604,1,4,0.25,127,164,0.774,284,511,795,84,33,48,78,168,806,1429,1.08,0.42,2020,21,11.194444444444445,1.0769230769230769,222,37,259,3.0694980694980694
2020-21,RegularSeason,1628386,101,Jarrett Allen,1610612739,CLE,63,1864,298,482,0.618,6,19,0.316,204,290,0.703,196,435,631,106,32,90,100,96,806,1295,1.06,0.32,2020,21,12.793650793650794,1.06,184,86,270,2.337037037037037
2020-21,RegularSeason,1630163,103,LaMelo Ball,1610612766,CHA,51,1469,293,672,0.436,92,261,0.352,125,165,0.758,63,239,302,313,81,18,145,136,803,953,2.16,0.56,2020,21,15.745098039215685,2.1586206896551725,379,40,419,0.720763723150358
2020-21,RegularSeason,1628366,104,Lonzo Ball,1610612740,NOP,55,1747,290,700,0.414,172,455,0.378,50,64,0.781,33,230,263,316,82,31,123,103,802,947,2.57,0.67,2020,21,14.581818181818182,2.569105691056911,410,14,424,0.6202830188679245
2020-21,RegularSeason,1626156,105,D'Angelo Russell,1610612750,MIN,42,1196,281,652,0.431,120,310,0.387,114,149,0.765,16,95,111,244,45,18,112,68,796,696,2.18,0.4,2020,21,18.952380952380953,2.1785714285714284,371,35,406,0.2733990147783251
2020-21,RegularSeason,1630256,106,Jae'Sean Tate,1610612745,HOU,70,2043,316,625,0.506,60,195,0.308,102,147,0.694,132,242,374,178,85,36,98,222,794,1015,1.82,0.87,2020,21,11.342857142857143,1.816326530612245,309,45,354,1.0564971751412429
2020-21,RegularSeason,200768,107,Kyle Lowry,1610612761,TOR,46,1602,260,596,0.436,131,331,0.396,140,160,0.875,35,212,247,338,45,14,126,143,791,953,2.68,0.36,2020,21,17.195652173913043,2.6825396825396823,336,20,356,0.6938202247191011
2020-21,RegularSeason,1629060,108,Rui Hachimura,1610612764,WAS,57,1797,310,648,0.478,45,137,0.328,124,161,0.77,49,263,312,82,44,7,68,120,789,791,1.21,0.65,2020,21,13.842105263157896,1.2058823529411764,338,37,375,0.832
2020-21,RegularSeason,1628407,109,Dwayne Bacon,1610612753,ORL,72,1853,292,726,0.402,59,207,0.285,145,176,0.824,31,193,224,93,45,5,46,103,788,644,2.02,0.98,2020,21,10.944444444444445,2.0217391304347827,434,31,465,0.4817204301075269
2020-21,RegularSeason,203076,110,Anthony Davis,1610612747,LAL,36,1162,301,613,0.491,26,100,0.26,158,214,0.738,62,224,286,110,45,59,74,60,786,844,1.49,0.61,2020,21,21.833333333333332,1.4864864864864864,312,56,368,0.7771739130434783
2020-21,RegularSeason,1629675,111,Naz Reid,1610612750,MIN,70,1347,304,581,0.523,61,174,0.351,115,166,0.693,82,240,322,72,34,76,69,179,784,891,1.04,0.49,2020,21,11.2,1.0434782608695652,277,51,328,0.9817073170731707
2020-21,RegularSeason,202694,112,Marcus Morris Sr.,1610612746,LAC,57,1502,276,584,0.473,140,296,0.473,73,89,0.82,35,199,234,58,34,15,57,117,765,725,1.02,0.6,2020,21,13.421052631578947,1.0175438596491229,308,16,324,0.7222222222222222
2020-21,RegularSeason,203200,113,Justin Holiday,1610612754,IND,72,2183,258,625,0.413,173,453,0.382,67,85,0.788,32,224,256,119,74,41,54,135,756,807,2.2,1.37,2020,21,10.5,2.2037037037037037,367,18,385,0.6649350649350649
2020-21,RegularSeason,1626171,114,Bobby Portis,1610612749,MIL,66,1372,313,598,0.523,74,157,0.471,54,73,0.74,124,342,466,71,52,26,56,115,754,1009,1.27,0.93,2020,21,11.424242424242424,1.2678571428571428,285,19,304,1.5328947368421053
2020-21,RegularSeason,1629647,114,Darius Bazley,1610612760,OKC,55,1714,273,690,0.396,83,286,0.29,125,178,0.702,51,345,396,99,29,25,122,60,754,711,0.81,0.24,2020,21,13.709090909090909,0.8114754098360656,417,53,470,0.8425531914893617
2020-21,RegularSeason,1630169,116,Tyrese Haliburton,1610612758,SAC,58,1746,292,619,0.472,121,296,0.409,48,56,0.857,39,134,173,309,77,28,92,83,753,913,3.36,0.84,2020,21,12.982758620689655,3.358695652173913,327,8,335,0.5164179104477612
2020-21,RegularSeason,201145,117,Jeff Green,1610612751,BKN,68,1835,261,530,0.492,103,250,0.412,125,161,0.776,34,229,263,108,36,27,54,122,750,825,2.0,0.67,2020,21,11.029411764705882,2.0,269,36,305,0.8622950819672132
2020-21,RegularSeason,101150,118,Lou Williams,1610612737,ATL,66,1423,265,646,0.41,69,173,0.399,150,173,0.867,21,117,138,225,47,6,108,62,749,653,2.08,0.43,2020,21,11.348484848484848,2.0833333333333335,381,23,404,0.3415841584158416
2020-21,RegularSeason,201988,119,Patty Mills,1610612759,SAS,68,1685,252,611,0.412,161,429,0.375,71,78,0.91,18,98,116,162,42,3,66,81,736,627,2.46,0.64,2020,21,10.823529411764707,2.4545454545454546,359,7,366,0.31693989071038253
2020-21,RegularSeason,201565,120,Derrick Rose,1610612752,NYK,50,1279,287,611,0.47,50,129,0.388,110,127,0.866,20,110,130,209,49,19,78,56,734,722,2.68,0.63,2020,21,14.68,2.6794871794871793,324,17,341,0.3812316715542522
2020-21,RegularSeason,1630193,121,Immanuel Quickley,1610612752,NYK,64,1244,229,580,0.395,118,303,0.389,155,174,0.891,25,112,137,127,30,12,58,114,731,609,2.19,0.52,2020,21,11.421875,2.189655172413793,351,19,370,0.37027027027027026
2020-21,RegularSeason,1629652,122,Luguentz Dort,1610612760,OKC,52,1543,247,639,0.387,113,329,0.343,122,164,0.744,38,151,189,88,45,19,79,134,729,557,1.11,0.57,2020,21,14.01923076923077,1.1139240506329113,392,42,434,0.43548387096774194
2020-21,RegularSeason,1627736,123,Malik Beasley,1610612750,MIN,37,1214,264,600,0.44,128,321,0.399,68,80,0.85,28,134,162,88,30,7,60,62,724,603,1.47,0.5,2020,21,19.56756756756757,1.4666666666666666,336,12,348,0.46551724137931033
2020-21,RegularSeason,203992,124,Bogdan Bogdanovic,1610612737,ATL,44,1305,267,565,0.473,146,333,0.438,40,44,0.909,20,140,160,147,49,13,54,99,720,733,2.72,0.91,2020,21,16.363636363636363,2.7222222222222223,298,4,302,0.5298013245033113
2020-21,RegularSeason,203095,125,Evan Fournier,1610612738,BOS,42,1259,247,541,0.457,117,283,0.413,108,137,0.788,10,118,128,144,47,19,73,96,719,661,1.97,0.64,2020,21,17.11904761904762,1.9726027397260273,294,29,323,0.39628482972136225
2020-21,RegularSeason,203082,126,Terrence Ross,1610612753,ORL,46,1347,254,616,0.412,89,264,0.337,120,138,0.87,15,143,158,108,47,21,74,88,717,597,1.46,0.64,2020,21,15.58695652173913,1.4594594594594594,362,18,380,0.41578947368421054
2020-21,RegularSeason,200752,127,Rudy Gay,1610612759,SAS,63,1358,264,628,0.42,106,278,0.381,82,102,0.804,42,261,303,88,45,40,65,115,716,743,1.35,0.69,2020,21,11.365079365079366,1.353846153846154,364,20,384,0.7890625
2020-21,RegularSeason,1626196,128,Josh Richardson,1610612742,DAL,59,1790,264,618,0.427,88,267,0.33,99,108,0.917,51,144,195,153,61,24,79,130,715,706,1.94,0.77,2020,21,12.11864406779661,1.9367088607594938,354,9,363,0.5371900826446281
2020-21,RegularSeason,202704,128,Reggie Jackson,1610612746,LAC,67,1544,263,585,0.45,122,282,0.433,67,82,0.817,24,168,192,205,41,7,74,127,715,749,2.77,0.55,2020,21,10.671641791044776,2.77027027027027,322,15,337,0.56973293768546
2020-21,RegularSeason,203552,130,Seth Curry,1610612755,PHI,57,1638,258,552,0.467,126,280,0.45,69,77,0.896,10,126,136,155,44,8,65,96,711,687,2.38,0.68,2020,21,12.473684210526315,2.3846153846153846,294,8,302,0.4503311258278146
2020-21,RegularSeason,203115,130,Will Barton,1610612743,DEN,56,1736,259,608,0.426,98,257,0.381,95,121,0.785,39,187,226,181,50,23,96,95,711,720,1.89,0.52,2020,21,12.696428571428571,1.8854166666666667,349,26,375,0.6026666666666667
2020-21,RegularSeason,203493,132,Reggie Bullock Jr.,1610612752,NYK,65,1949,248,561,0.442,163,398,0.41,50,55,0.909,16,207,223,99,52,11,45,146,709,731,2.2,1.16,2020,21,10.907692307692308,2.2,313,5,318,0.7012578616352201
2020-21,RegularSeason,1627854,133,Bryn Forbes,1610612749,MIL,70,1354,250,529,0.473,154,341,0.452,47,61,0.77,11,101,112,45,24,1,44,77,701,546,1.02,0.55,2020,21,10.014285714285714,1.0227272727272727,279,14,293,0.3822525597269625
2020-21,RegularSeason,1628374,134,Lauri Markkanen,1610612741,CHI,51,1317,250,521,0.48,119,296,0.402,76,92,0.826,35,233,268,45,26,15,52,75,695,710,0.86,0.5,2020,21,13.627450980392156,0.8653846153846154,271,16,287,0.9337979094076655
2020-21,RegularSeason,1628978,135,Donte DiVincenzo,1610612749,MIL,66,1815,253,603,0.42,131,346,0.379,51,71,0.718,81,299,380,203,72,15,91,112,688,897,2.23,0.79,2020,21,10.424242424242424,2.230769230769231,350,20,370,1.027027027027027
2020-21,RegularSeason,203083,136,Andre Drummond,1610612747,LAL,46,1242,282,572,0.493,0,8,0.0,123,205,0.6,166,385,551,94,63,49,124,149,687,948,0.76,0.51,2020,21,14.934782608695652,0.7580645161290323,290,82,372,1.4811827956989247
2020-21,RegularSeason,1628384,137,OG Anunoby,1610612761,TOR,43,1433,249,519,0.48,104,261,0.398,80,102,0.784,54,183,237,94,66,32,75,114,682,744,1.25,0.88,2020,21,15.86046511627907,1.2533333333333334,270,22,292,0.8116438356164384
2020-21,RegularSeason,201568,138,Danilo Gallinari,1610612737,ATL,51,1222,206,475,0.434,103,254,0.406,161,174,0.925,17,194,211,76,30,10,43,105,676,678,1.77,0.7,2020,21,13.254901960784315,1.7674418604651163,269,13,282,0.74822695035461
2020-21,RegularSeason,201609,139,Goran Dragic,1610612748,MIA,50,1337,240,555,0.432,91,244,0.373,101,122,0.828,25,144,169,219,33,8,118,113,672,647,1.86,0.28,2020,21,13.44,1.8559322033898304,315,21,336,0.5029761904761905
2020-21,RegularSeason,1629022,140,Lonnie Walker IV,1610612759,SAS,60,1522,256,609,0.42,100,282,0.355,57,70,0.814,14,141,155,101,29,15,65,101,669,538,1.55,0.45,2020,21,11.15,1.5538461538461539,353,13,366,0.42349726775956287
2020-21,RegularSeason,1630177,141,Theo Maledon,1610612760,OKC,65,1778,226,614,0.368,105,313,0.335,101,135,0.748,25,186,211,227,56,11,141,126,658,600,1.61,0.4,2020,21,10.123076923076923,1.6099290780141844,388,34,422,0.5
2020-21,RegularSeason,202722,142,Dāvis Bertāns,1610612764,WAS,57,1464,193,478,0.404,169,428,0.395,100,115,0.87,18,150,168,49,33,13,33,136,655,585,1.49,1.0,2020,21,11.491228070175438,1.4848484848484849,285,15,300,0.56
2020-21,RegularSeason,1630172,142,Patrick Williams,1610612741,CHI,71,1983,255,528,0.483,54,138,0.391,91,125,0.728,66,261,327,99,64,46,98,126,655,786,1.01,0.65,2020,21,9.225352112676056,1.010204081632653,273,34,307,1.0651465798045603
2020-21,RegularSeason,201980,144,Danny Green,1610612755,PHI,69,1934,224,544,0.412,175,432,0.405,31,40,0.775,55,205,260,118,92,56,67,125,654,784,1.76,1.37,2020,21,9.478260869565217,1.7611940298507462,320,9,329,0.790273556231003
2020-21,RegularSeason,203484,145,Kentavious Caldwell-Pope,1610612747,LAL,67,1902,218,506,0.431,120,293,0.41,97,112,0.866,27,152,179,127,62,26,66,114,653,678,1.92,0.94,2020,21,9.746268656716419,1.9242424242424243,288,15,303,0.5907590759075908
2020-21,RegularSeason,203506,146,Victor Oladipo,1610612748,MIA,33,1080,235,576,0.408,78,239,0.326,104,138,0.754,12,148,160,151,46,14,83,81,652,565,1.82,0.55,2020,21,19.757575757575758,1.819277108433735,341,34,375,0.4266666666666667
2020-21,RegularSeason,1627826,147,Ivica Zubac,1610612746,LAC,72,1609,257,394,0.652,1,4,0.25,135,171,0.789,189,330,519,90,24,62,81,187,650,1091,1.11,0.3,2020,21,9.027777777777779,1.1111111111111112,137,36,173,3.0
2020-21,RegularSeason,1630171,148,Isaac Okoro,1610612739,CLE,67,2173,235,559,0.42,62,214,0.29,114,157,0.726,68,138,206,128,62,24,86,185,646,613,1.49,0.72,2020,21,9.64179104477612,1.4883720930232558,324,43,367,0.5613079019073569
2020-21,RegularSeason,1626153,149,Delon Wright,1610612758,SAC,63,1748,240,518,0.463,64,172,0.372,101,126,0.802,65,204,269,278,101,30,83,75,645,937,3.35,1.22,2020,21,10.238095238095237,3.3493975903614457,278,25,303,0.8877887788778878
2020-21,RegularSeason,201577,150,Robin Lopez,1610612764,WAS,71,1354,269,425,0.633,5,18,0.278,99,137,0.723,141,131,272,55,15,44,75,109,642,759,0.73,0.2,2020,21,9.04225352112676,0.7333333333333333,156,38,194,1.402061855670103
2020-21,RegularSeason,203901,151,Elfrid Payton,1610612752,NYK,63,1484,269,622,0.432,28,98,0.286,73,107,0.682,64,152,216,203,47,9,103,116,639,624,1.97,0.46,2020,21,10.142857142857142,1.970873786407767,353,34,387,0.5581395348837209
2020-21,RegularSeason,1628464,152,Daniel Theis,1610612741,CHI,65,1601,252,466,0.541,49,152,0.322,74,110,0.673,93,263,356,108,41,57,66,167,627,873,1.64,0.62,2020,21,9.646153846153846,1.6363636363636365,214,36,250,1.424
2020-21,RegularSeason,203935,152,Marcus Smart,1610612738,BOS,48,1581,203,510,0.398,93,282,0.33,128,162,0.79,36,131,167,273,72,23,96,126,627,725,2.84,0.75,2020,21,13.0625,2.84375,307,34,341,0.4897360703812317
2020-21,RegularSeason,1630217,154,Desmond Bane,1610612763,MEM,68,1519,234,499,0.469,117,271,0.432,40,49,0.816,31,179,210,118,41,16,59,125,625,677,2.0,0.69,2020,21,9.191176470588236,2.0,265,9,274,0.7664233576642335
2020-21,RegularSeason,202692,155,Alec Burks,1610612752,NYK,49,1255,210,500,0.42,102,246,0.415,101,118,0.856,21,206,227,107,31,14,49,102,623,646,2.18,0.63,2020,21,12.714285714285714,2.183673469387755,290,17,307,0.739413680781759
2020-21,RegularSeason,203932,156,Aaron Gordon,1610612743,DEN,50,1384,231,499,0.463,59,176,0.335,97,149,0.651,77,207,284,161,33,34,97,89,618,713,1.66,0.34,2020,21,12.36,1.6597938144329898,268,52,320,0.8875
2020-21,RegularSeason,1626224,157,Cedi Osman,1610612739,CLE,59,1511,219,586,0.374,99,324,0.306,76,95,0.8,38,163,201,174,53,9,80,119,613,584,2.17,0.66,2020,21,10.389830508474576,2.175,367,19,386,0.5207253886010362
2020-21,RegularSeason,1629673,158,Jordan Poole,1610612744,GSW,51,988,205,474,0.432,97,276,0.351,105,119,0.882,15,77,92,99,26,9,51,86,612,504,1.94,0.51,2020,21,12.0,1.9411764705882353,269,14,283,0.3250883392226148
2020-21,RegularSeason,1629634,159,Brandon Clarke,1610612763,MEM,59,1415,256,495,0.517,20,77,0.26,78,113,0.69,97,231,328,95,60,51,33,84,610,837,2.88,1.82,2020,21,10.338983050847459,2.878787878787879,239,35,274,1.197080291970803
2020-21,RegularSeason,1628963,160,Marvin Bagley III,1610612758,SAC,43,1112,247,490,0.504,37,108,0.343,77,134,0.575,106,212,318,43,21,21,59,100,608,652,0.73,0.36,2020,21,14.13953488372093,0.7288135593220338,243,57,300,1.06
2020-21,RegularSeason,1628976,161,Wendell Carter Jr.,1610612753,ORL,54,1375,230,457,0.503,15,51,0.294,131,179,0.732,132,311,443,104,35,42,78,146,606,877,1.33,0.45,2020,21,11.222222222222221,1.3333333333333333,227,48,275,1.6109090909090908
2020-21,RegularSeason,1630175,162,Cole Anthony,1610612753,ORL,47,1273,219,552,0.397,58,172,0.337,109,131,0.832,38,183,221,192,30,18,106,98,605,605,1.81,0.28,2020,21,12.872340425531915,1.8113207547169812,333,22,355,0.6225352112676056
2020-21,RegularSeason,1628977,163,Hamidou Diallo,1610612765,DET,52,1226,224,470,0.477,28,82,0.341,128,200,0.64,59,213,272,101,41,24,76,134,604,648,1.33,0.54,2020,21,11.615384615384615,1.3289473684210527,246,72,318,0.8553459119496856
2020-21,RegularSeason,203109,164,Jae Crowder,1610612756,PHX,60,1648,199,492,0.404,148,380,0.389,57,75,0.76,32,250,282,127,48,27,55,125,603,721,2.31,0.87,2020,21,10.05,2.309090909090909,293,18,311,0.9067524115755627
2020-21,RegularSeason,204456,165,T.J. McConnell,1610612754,IND,69,1796,274,490,0.559,15,48,0.313,33,48,0.688,55,201,256,456,128,23,135,113,596,1093,3.38,0.95,2020,21,8.63768115942029,3.3777777777777778,216,15,231,1.1082251082251082
2020-21,RegularSeason,1627751,166,Jakob Poeltl,1610612759,SAS,69,1845,265,430,0.616,0,0,0.0,63,124,0.508,219,328,547,134,47,123,83,172,593,1135,1.61,0.57,2020,21,8.594202898550725,1.6144578313253013,165,61,226,2.420353982300885
2020-21,RegularSeason,203496,166,Robert Covington,1610612757,POR,70,2243,204,509,0.401,135,356,0.379,50,62,0.806,61,405,466,117,101,84,64,195,593,980,1.83,1.58,2020,21,8.471428571428572,1.828125,305,12,317,1.4700315457413249
2020-21,RegularSeason,1626167,168,Myles Turner,1610612754,IND,47,1455,206,432,0.477,69,206,0.335,111,142,0.782,63,243,306,48,40,159,67,165,592,821,0.72,0.6,2020,21,12.595744680851064,0.7164179104477612,226,31,257,1.1906614785992218
2020-21,RegularSeason,1627827,169,Dorian Finney-Smith,1610612742,DAL,60,1921,220,466,0.472,119,302,0.394,31,41,0.756,98,228,326,102,52,25,48,138,590,791,2.13,1.08,2020,21,9.833333333333334,2.125,246,10,256,1.2734375
2020-21,RegularSeason,1629659,170,Talen Horton-Tucker,1610612747,LAL,65,1304,224,489,0.458,37,131,0.282,100,129,0.775,25,144,169,181,63,21,105,127,585,620,1.72,0.6,2020,21,9.0,1.723809523809524,265,29,294,0.5748299319727891
2020-21,RegularSeason,201937,171,Ricky Rubio,1610612750,MIN,68,1772,193,498,0.388,66,214,0.308,130,150,0.867,28,195,223,433,98,4,111,139,582,904,3.9,0.88,2020,21,8.558823529411764,3.900900900900901,305,20,325,0.6861538461538461
2020-21,RegularSeason,203486,172,Mason Plumlee,1610612765,DET,56,1499,234,381,0.614,0,7,0.0,113,169,0.669,145,374,519,202,43,50,105,186,581,1087,1.92,0.41,2020,21,10.375,1.9238095238095239,147,56,203,2.5566502463054186
2020-21,RegularSeason,1628971,173,Bruce Brown,1610612751,BKN,65,1451,235,423,0.556,17,59,0.288,86,117,0.735,111,238,349,104,58,28,54,145,573,839,1.93,1.07,2020,21,8.815384615384616,1.9259259259259258,188,31,219,1.5936073059360731
2020-21,RegularSeason,1629661,173,Cameron Johnson,1610612756,PHX,60,1437,203,483,0.42,117,335,0.349,50,59,0.847,33,166,199,86,37,16,40,85,573,582,2.15,0.93,2020,21,9.55,2.15,280,9,289,0.6885813148788927
2020-21,RegularSeason,1629013,175,Landry Shamet,1610612751,BKN,61,1403,186,456,0.408,129,333,0.387,66,78,0.846,11,101,112,99,31,10,48,93,567,489,2.06,0.65,2020,21,9.295081967213115,2.0625,270,12,282,0.3971631205673759
2020-21,RegularSeason,1629004,176,Svi Mykhailiuk,1610612760,OKC,66,1324,208,506,0.411,105,314,0.334,38,50,0.76,24,139,163,110,51,12,88,63,559,497,1.25,0.58,2020,21,8.469696969696969,1.25,298,12,310,0.5258064516129032
2020-21,RegularSeason,203526,177,Raul Neto,1610612764,WAS,64,1403,209,447,0.468,64,164,0.39,75,85,0.882,28,128,156,146,73,6,53,109,557,637,2.75,1.38,2020,21,8.703125,2.7547169811320753,238,10,248,0.6290322580645161
2020-21,RegularSeason,1628401,178,Derrick White,1610612759,SAS,36,1064,186,453,0.411,84,243,0.346,97,114,0.851,13,94,107,127,26,36,45,91,553,520,2.82,0.58,2020,21,15.36111111111111,2.8222222222222224,267,17,284,0.3767605633802817
2020-21,RegularSeason,201587,179,Nicolas Batum,1610612746,LAC,67,1835,191,412,0.464,110,272,0.404,48,58,0.828,50,266,316,148,69,37,53,102,540,826,2.79,1.3,2020,21,8.059701492537313,2.792452830188679,221,10,231,1.367965367965368
2020-21,RegularSeason,1630191,180,Isaiah Stewart,1610612765,DET,68,1455,226,409,0.553,21,63,0.333,64,92,0.696,159,294,453,59,39,86,67,184,537,896,0.88,0.58,2020,21,7.897058823529412,0.8805970149253731,183,28,211,2.146919431279621
2020-21,RegularSeason,1629676,181,Isaiah Roby,1610612760,OKC,61,1425,207,429,0.483,32,109,0.294,87,117,0.744,89,252,341,107,52,37,113,162,533,705,0.95,0.46,2020,21,8.737704918032787,0.9469026548672567,222,30,252,1.3531746031746033
2020-21,RegularSeason,1629056,181,Terence Davis,1610612758,SAC,61,1074,195,456,0.428,98,267,0.367,45,55,0.818,20,134,154,83,44,14,63,97,533,494,1.32,0.7,2020,21,8.737704918032787,1.3174603174603174,261,10,271,0.5682656826568265
2020-21,RegularSeason,1628960,183,Grayson Allen,1610612763,MEM,50,1260,173,414,0.418,107,274,0.391,79,91,0.868,19,141,160,108,46,8,48,71,532,553,2.25,0.96,2020,21,10.64,2.25,241,12,253,0.6324110671936759
2020-21,RegularSeason,1629026,184,Kenrich Williams,1610612760,OKC,66,1426,219,411,0.533,52,117,0.444,36,63,0.571,84,189,273,152,55,17,76,143,526,728,2.0,0.72,2020,21,7.96969696969697,2.0,192,27,219,1.2465753424657535
2020-21,RegularSeason,1628379,185,Luke Kennard,1610612746,LAC,63,1232,197,414,0.476,100,224,0.446,26,31,0.839,15,146,161,104,23,9,48,91,520,547,2.17,0.48,2020,21,8.253968253968255,2.1666666666666665,217,5,222,0.7252252252252253
2020-21,RegularSeason,202709,186,Cory Joseph,1610612765,DET,63,1446,200,426,0.469,45,132,0.341,72,88,0.818,35,124,159,213,61,18,79,139,517,647,2.7,0.77,2020,21,8.206349206349206,2.6962025316455698,226,16,242,0.6570247933884298
2020-21,RegularSeason,1630202,187,Payton Pritchard,1610612738,BOS,66,1268,184,418,0.44,102,248,0.411,40,45,0.889,33,125,158,120,37,9,53,104,510,542,2.26,0.7,2020,21,7.7272727272727275,2.2641509433962264,234,5,239,0.6610878661087866
2020-21,RegularSeason,1629638,188,Nickeil Alexander-Walker,1610612740,NOP,46,1007,192,458,0.419,76,219,0.347,48,66,0.727,13,131,144,102,47,22,69,88,508,470,1.48,0.68,2020,21,11.043478260869565,1.4782608695652173,266,18,284,0.5070422535211268
2020-21,RegularSeason,201933,189,Blake Griffin,1610612751,BKN,46,1187,174,411,0.423,70,205,0.341,87,117,0.744,35,190,225,140,32,15,62,111,505,588,2.26,0.52,2020,21,10.978260869565217,2.2580645161290325,237,30,267,0.8426966292134831
2020-21,RegularSeason,1626166,189,Cameron Payne,1610612756,PHX,60,1079,191,395,0.484,73,166,0.44,50,56,0.893,16,128,144,217,36,16,60,97,505,648,3.62,0.6,2020,21,8.416666666666666,3.6166666666666667,204,6,210,0.6857142857142857
2020-21,RegularSeason,1629014,191,Anfernee Simons,1610612757,POR,64,1104,168,401,0.419,120,282,0.426,46,57,0.807,14,126,140,89,18,8,43,96,502,470,2.07,0.42,2020,21,7.84375,2.0697674418604652,233,11,244,0.5737704918032787
2020-21,RegularSeason,200794,191,Paul Millsap,1610612743,DEN,56,1162,191,401,0.476,49,143,0.343,71,98,0.724,76,186,262,98,51,36,51,111,502,661,1.92,1.0,2020,21,8.964285714285714,1.9215686274509804,210,27,237,1.1054852320675106
2020-21,RegularSeason,1627788,193,Furkan Korkmaz,1610612755,PHI,55,1062,170,424,0.401,101,269,0.375,60,82,0.732,17,96,113,82,49,9,46,64,501,432,1.78,1.06,2020,21,9.10909090909091,1.7826086956521738,254,22,276,0.40942028985507245
2020-21,RegularSeason,1627777,194,Georges Niang,1610612762,UTA,72,1154,177,405,0.437,124,292,0.425,22,23,0.957,28,148,176,59,25,8,51,116,500,488,1.16,0.49,2020,21,6.944444444444445,1.1568627450980393,228,1,229,0.7685589519650655
2020-21,RegularSeason,1626220,195,Royce O'Neale,1610612762,UTA,71,2240,175,394,0.444,107,278,0.385,39,46,0.848,88,397,485,181,57,32,83,182,496,942,2.18,0.69,2020,21,6.985915492957746,2.180722891566265,219,7,226,2.146017699115044
2020-21,RegularSeason,1628370,196,Malik Monk,1610612766,CHA,42,878,173,399,0.434,85,212,0.401,59,72,0.819,14,87,101,87,19,4,55,47,490,407,1.58,0.34,2020,21,11.666666666666666,1.5818181818181818,226,13,239,0.4225941422594142
2020-21,RegularSeason,1630178,197,Tyrese Maxey,1610612755,PHI,61,936,198,429,0.462,31,103,0.301,61,70,0.871,11,93,104,120,26,13,41,79,488,470,2.93,0.63,2020,21,8.0,2.926829268292683,231,9,240,0.43333333333333335
2020-21,RegularSeason,2730,198,Dwight Howard,1610612755,PHI,69,1196,178,303,0.587,5,20,0.25,121,210,0.576,190,390,580,61,30,62,112,200,482,889,0.55,0.27,2020,21,6.9855072463768115,0.5446428571428571,125,89,214,2.710280373831776
2020-21,RegularSeason,203920,198,Khem Birch,1610612761,TOR,67,1529,189,380,0.497,13,52,0.25,91,129,0.705,174,213,387,89,48,50,44,113,482,783,2.02,1.09,2020,21,7.1940298507462686,2.022727272727273,191,38,229,1.6899563318777293
2020-21,RegularSeason,201569,200,Eric Gordon,1610612745,HOU,27,789,159,367,0.433,69,210,0.329,94,114,0.825,8,50,58,71,14,13,51,44,481,358,1.39,0.28,2020,21,17.814814814814813,1.392156862745098,208,20,228,0.2543859649122807
2020-21,RegularSeason,203145,200,Kent Bazemore,1610612744,GSW,67,1334,176,392,0.449,75,184,0.408,54,78,0.692,26,203,229,108,69,33,82,158,481,598,1.32,0.84,2020,21,7.17910447761194,1.3170731707317074,216,24,240,0.9541666666666667
2020-21,RegularSeason,1628420,200,Monte Morris,1610612743,DEN,47,1196,186,387,0.481,51,134,0.381,58,73,0.795,11,85,96,150,34,13,34,48,481,524,4.41,1.0,2020,21,10.23404255319149,4.411764705882353,201,15,216,0.4444444444444444
2020-21,RegularSeason,1628988,203,Aaron Holiday,1610612754,IND,66,1176,170,436,0.39,67,182,0.368,68,83,0.819,15,74,89,123,46,13,66,94,475,399,1.86,0.7,2020,21,7.196969696969697,1.8636363636363635,266,15,281,0.3167259786476868
2020-21,RegularSeason,1629001,204,De'Anthony Melton,1610612763,MEM,52,1045,172,393,0.438,87,211,0.412,41,51,0.804,30,131,161,132,60,31,66,85,472,559,2.0,0.91,2020,21,9.076923076923077,2.0,221,10,231,0.696969696969697
2020-21,RegularSeason,1629611,204,Terance Mann,1610612746,LAC,67,1263,178,350,0.509,38,91,0.418,78,94,0.83,56,186,242,104,29,13,40,126,472,632,2.6,0.72,2020,21,7.044776119402985,2.6,172,16,188,1.2872340425531914
2020-21,RegularSeason,203210,206,JaMychal Green,1610612743,DEN,58,1120,173,374,0.463,79,198,0.399,46,57,0.807,85,192,277,53,26,22,53,144,471,584,1.0,0.49,2020,21,8.120689655172415,1.0,201,11,212,1.3066037735849056
2020-21,RegularSeason,1626192,207,Pat Connaughton,1610612749,MIL,69,1575,168,387,0.434,101,272,0.371,31,40,0.775,63,269,332,81,49,23,33,99,468,692,2.46,1.49,2020,21,6.782608695652174,2.4545454545454546,219,9,228,1.456140350877193
2020-21,RegularSeason,201586,208,Serge Ibaka,1610612746,LAC,41,955,186,365,0.51,39,115,0.339,43,53,0.811,73,202,275,74,9,47,44,76,454,626,1.68,0.2,2020,21,11.073170731707316,1.6818181818181819,179,10,189,1.4550264550264551
2020-21,RegularSeason,203469,209,Cody Zeller,1610612766,CHA,48,1005,181,324,0.559,4,28,0.143,85,119,0.714,119,209,328,86,27,17,51,121,451,681,1.69,0.53,2020,21,9.395833333333334,1.6862745098039216,143,34,177,1.8531073446327684
2020-21,RegularSeason,1629637,210,Jaxson Hayes,1610612740,NOP,60,964,175,280,0.625,6,14,0.429,93,120,0.775,92,165,257,35,25,38,39,101,449,633,0.9,0.64,2020,21,7.483333333333333,0.8974358974358975,105,27,132,1.946969696969697
2020-21,RegularSeason,1630164,211,James Wiseman,1610612744,GSW,39,836,191,368,0.519,12,38,0.316,54,86,0.628,55,171,226,26,11,36,60,121,448,478,0.43,0.18,2020,21,11.487179487179487,0.43333333333333335,177,32,209,1.0813397129186604
2020-21,RegularSeason,203107,212,Tomas Satoransky,1610612741,CHI,58,1307,169,329,0.514,42,118,0.356,67,79,0.848,30,112,142,271,40,14,96,89,447,646,2.82,0.42,2020,21,7.706896551724138,2.8229166666666665,160,12,172,0.8255813953488372
2020-21,RegularSeason,203110,213,Draymond Green,1610612744,GSW,63,1982,170,380,0.447,34,126,0.27,70,88,0.795,55,393,448,558,105,52,188,194,444,1191,2.97,0.56,2020,21,7.0476190476190474,2.9680851063829787,210,18,228,1.9649122807017543
2020-21,RegularSeason,1626145,214,Tyus Jones,1610612763,MEM,70,1223,178,413,0.431,45,140,0.321,41,45,0.911,21,119,140,259,64,6,48,31,442,624,5.4,1.33,2020,21,6.314285714285714,5.395833333333333,235,4,239,0.5857740585774058
2020-21,RegularSeason,201961,214,Wayne Ellington,1610612765,DET,46,1012,149,338,0.441,116,275,0.422,28,35,0.8,12,73,85,67,18,9,33,59,442,392,2.03,0.55,2020,21,9.608695652173912,2.0303030303030303,189,7,196,0.4336734693877551
2020-21,RegularSeason,201571,216,D.J. Augustin,1610612745,HOU,57,1129,135,343,0.394,83,217,0.382,85,94,0.904,20,74,94,188,28,1,65,56,438,467,2.89,0.43,2020,21,7.684210526315789,2.8923076923076922,208,9,217,0.43317972350230416
2020-21,RegularSeason,203500,216,Steven Adams,1610612740,NOP,58,1605,189,308,0.614,0,3,0.0,60,135,0.444,213,301,514,111,54,38,78,113,438,883,1.42,0.69,2020,21,7.551724137931035,1.4230769230769231,119,75,194,2.649484536082474
2020-21,RegularSeason,203967,218,Dario Saric,1610612756,PHX,50,871,153,342,0.447,47,135,0.348,84,99,0.848,46,144,190,65,30,4,57,95,437,465,1.14,0.53,2020,21,8.74,1.1403508771929824,189,15,204,0.9313725490196079
2020-21,RegularSeason,1628404,219,Josh Hart,1610612740,NOP,47,1350,151,344,0.439,63,193,0.326,69,89,0.775,53,324,377,109,38,12,49,111,434,708,2.22,0.78,2020,21,9.23404255319149,2.2244897959183674,193,20,213,1.7699530516431925
2020-21,RegularSeason,1629645,220,Kevin Porter Jr.,1610612745,HOU,26,836,156,367,0.425,50,161,0.311,69,94,0.734,20,79,99,164,19,8,91,61,431,394,1.8,0.21,2020,21,16.576923076923077,1.8021978021978022,211,25,236,0.4194915254237288
2020-21,RegularSeason,1630183,221,Jaden McDaniels,1610612750,MIN,63,1511,164,367,0.447,72,198,0.364,27,45,0.6,52,180,232,71,35,60,47,172,427,557,1.51,0.74,2020,21,6.777777777777778,1.5106382978723405,203,18,221,1.0497737556561086
2020-21,RegularSeason,201599,222,DeAndre Jordan,1610612751,BKN,57,1246,190,249,0.763,0,1,0.0,46,92,0.5,117,310,427,93,17,65,85,116,426,838,1.09,0.2,2020,21,7.473684210526316,1.0941176470588236,59,46,105,4.066666666666666
2020-21,RegularSeason,203994,223,Jusuf Nurkic,1610612757,POR,37,880,171,333,0.514,12,30,0.4,70,113,0.619,86,246,332,125,38,39,73,103,424,680,1.71,0.52,2020,21,11.45945945945946,1.7123287671232876,162,43,205,1.6195121951219513
2020-21,RegularSeason,203458,224,Alex Len,1610612764,WAS,64,979,171,278,0.615,8,25,0.32,73,116,0.629,78,182,260,49,20,64,55,127,423,611,0.89,0.36,2020,21,6.609375,0.8909090909090909,107,43,150,1.7333333333333334
2020-21,RegularSeason,202066,224,Garrett Temple,1610612741,CHI,56,1528,158,381,0.415,67,200,0.335,40,50,0.8,29,131,160,124,43,30,58,126,423,489,2.14,0.74,2020,21,7.553571428571429,2.1379310344827585,223,10,233,0.6866952789699571
2020-21,RegularSeason,1630231,226,KJ Martin,1610612745,HOU,45,1068,162,318,0.509,35,96,0.365,60,84,0.714,73,169,242,48,30,41,38,89,419,562,1.26,0.79,2020,21,9.311111111111112,1.263157894736842,156,24,180,1.3444444444444446
2020-21,RegularSeason,1629057,227,Robert Williams III,1610612738,BOS,52,985,186,258,0.721,0,2,0.0,45,73,0.616,133,225,358,94,43,91,52,105,417,851,1.81,0.83,2020,21,8.01923076923077,1.8076923076923077,72,28,100,3.58
2020-21,RegularSeason,1628425,228,Sterling Brown,1610612745,HOU,51,1229,150,335,0.448,91,215,0.423,25,31,0.806,38,186,224,72,38,12,41,97,416,530,1.76,0.93,2020,21,8.156862745098039,1.7560975609756098,185,6,191,1.1727748691099475
2020-21,RegularSeason,203504,229,Trey Burke,1610612742,DAL,62,911,151,353,0.428,58,164,0.354,51,57,0.895,10,44,54,81,36,7,33,64,411,348,2.46,1.09,2020,21,6.629032258064516,2.4545454545454546,202,6,208,0.25961538461538464
2020-21,RegularSeason,202684,230,Tristan Thompson,1610612738,BOS,54,1287,169,326,0.518,0,3,0.0,71,120,0.592,169,270,439,67,24,33,62,119,409,704,1.08,0.39,2020,21,7.574074074074074,1.0806451612903225,157,49,206,2.1310679611650487
2020-21,RegularSeason,202693,231,Markieff Morris,1610612747,LAL,61,1200,153,378,0.405,65,209,0.311,36,50,0.72,48,218,266,73,22,19,54,105,407,494,1.35,0.41,2020,21,6.672131147540983,1.3518518518518519,225,14,239,1.112970711297071
2020-21,RegularSeason,203463,232,Ben McLemore,1610612747,LAL,53,905,135,365,0.37,97,280,0.346,39,53,0.736,15,85,100,39,23,9,42,88,406,291,0.93,0.55,2020,21,7.660377358490566,0.9285714285714286,230,14,244,0.4098360655737705
2020-21,RegularSeason,1627756,232,Denzel Valentine,1610612741,CHI,62,1036,155,416,0.373,80,242,0.331,16,17,0.941,24,173,197,105,30,7,42,70,406,441,2.5,0.71,2020,21,6.548387096774194,2.5,261,1,262,0.7519083969465649
2020-21,RegularSeason,1628410,234,Edmond Sumner,1610612754,IND,53,861,148,282,0.525,35,88,0.398,68,83,0.819,18,76,94,49,33,10,51,88,399,385,0.96,0.65,2020,21,7.528301886792453,0.9607843137254902,134,15,149,0.6308724832214765
2020-21,RegularSeason,201143,235,Al Horford,1610612738,BOS,28,782,162,360,0.45,56,152,0.368,18,22,0.818,29,159,188,94,25,26,29,48,398,500,3.24,0.86,2020,21,14.214285714285714,3.2413793103448274,198,4,202,0.9306930693069307
2020-21,RegularSeason,1627884,236,Derrick Jones Jr.,1610612757,POR,58,1318,147,304,0.484,43,136,0.316,59,91,0.648,77,128,205,47,37,54,32,127,396,518,1.47,1.16,2020,21,6.827586206896552,1.46875,157,32,189,1.0846560846560847
2020-21,RegularSeason,1630267,236,Facundo Campazzo,1610612743,DEN,65,1425,120,315,0.381,76,216,0.352,80,91,0.879,22,112,134,232,79,14,73,132,396,576,3.18,1.08,2020,21,6.092307692307692,3.1780821917808217,195,11,206,0.6504854368932039
2020-21,RegularSeason,1628402,238,Frank Jackson,1610612765,DET,40,738,134,293,0.457,61,150,0.407,61,75,0.813,15,71,86,36,15,1,34,53,390,321,1.06,0.44,2020,21,9.75,1.0588235294117647,159,14,173,0.49710982658959535
2020-21,RegularSeason,1630214,238,Xavier Tillman,1610612763,MEM,59,1085,167,299,0.559,22,65,0.338,34,53,0.642,74,182,256,75,44,33,45,116,390,602,1.67,0.98,2020,21,6.610169491525424,1.6666666666666667,132,19,151,1.695364238410596
2020-21,RegularSeason,1627752,240,Taurean Prince,1610612739,CLE,41,905,131,327,0.401,62,155,0.4,65,76,0.855,19,123,142,76,28,23,47,75,389,404,1.62,0.6,2020,21,9.487804878048781,1.6170212765957446,196,11,207,0.6859903381642513
2020-21,RegularSeason,203914,241,Gary Harris,1610612753,ORL,39,1080,138,345,0.4,48,141,0.34,64,78,0.821,21,58,79,78,28,11,37,71,388,326,2.11,0.76,2020,21,9.948717948717949,2.108108108108108,207,14,221,0.3574660633484163
2020-21,RegularSeason,1628408,242,PJ Dozier,1610612743,DEN,50,1088,148,355,0.417,47,149,0.315,42,66,0.636,35,147,182,92,31,22,46,86,385,435,2.0,0.67,2020,21,7.7,2.0,207,24,231,0.7878787878787878
2020-21,RegularSeason,1629672,243,Eric Paschall,1610612744,GSW,40,695,148,298,0.497,18,54,0.333,67,94,0.713,28,100,128,51,12,7,43,68,381,359,1.19,0.28,2020,21,9.525,1.186046511627907,150,27,177,0.7231638418079096
2020-21,RegularSeason,1629655,244,Daniel Gafford,1610612764,WAS,54,791,154,225,0.684,0,0,0.0,72,108,0.667,94,137,231,29,26,75,41,98,380,593,0.71,0.63,2020,21,7.037037037037037,0.7073170731707317,71,36,107,2.1588785046728973
2020-21,RegularSeason,1629669,245,Jaylen Nowell,1610612750,MIN,42,759,142,335,0.424,50,150,0.333,45,55,0.818,19,76,95,62,22,12,28,72,379,339,2.21,0.79,2020,21,9.023809523809524,2.2142857142857144,193,10,203,0.46798029556650245
2020-21,RegularSeason,1629731,246,Dean Wade,1610612739,CLE,63,1212,134,311,0.431,78,213,0.366,30,39,0.769,38,177,215,74,35,21,30,78,376,505,2.47,1.17,2020,21,5.968253968253968,2.466666666666667,177,9,186,1.1559139784946237
2020-21,RegularSeason,1627823,247,Juancho Hernangomez,1610612750,MIN,52,900,130,299,0.435,55,168,0.327,60,97,0.619,45,160,205,35,19,7,27,52,375,408,1.3,0.7,2020,21,7.211538461538462,1.2962962962962963,169,37,206,0.9951456310679612
2020-21,RegularSeason,1627814,248,Damion Lee,1610612744,GSW,57,1079,128,274,0.467,77,194,0.397,40,44,0.909,22,158,180,73,38,8,30,89,373,492,2.43,1.27,2020,21,6.543859649122807,2.433333333333333,146,4,150,1.2
2020-21,RegularSeason,201952,249,Jeff Teague,1610612749,MIL,55,950,123,284,0.433,36,82,0.439,89,105,0.848,15,73,88,132,34,12,64,56,371,396,2.06,0.53,2020,21,6.745454545454545,2.0625,161,16,177,0.4971751412429379
2020-21,RegularSeason,1627936,250,Alex Caruso,1610612747,LAL,58,1216,133,305,0.436,55,137,0.401,49,76,0.645,31,139,170,160,64,15,76,108,370,504,2.1,0.84,2020,21,6.379310344827586,2.1052631578947367,172,27,199,0.8542713567839196
2020-21,RegularSeason,1629650,250,Moses Brown,1610612738,BOS,43,920,146,268,0.545,0,0,0.0,78,126,0.619,154,229,383,10,31,47,43,93,370,628,0.23,0.72,2020,21,8.604651162790697,0.23255813953488372,122,48,170,2.2529411764705882
2020-21,RegularSeason,1627789,250,Timothe Luwawu-Cabarrot,1610612751,BKN,58,1050,130,356,0.365,75,239,0.314,35,43,0.814,28,101,129,69,33,6,43,99,370,330,1.6,0.77,2020,21,6.379310344827586,1.6046511627906976,226,8,234,0.5512820512820513
2020-21,RegularSeason,202324,253,Derrick Favors,1610612762,UTA,68,1039,155,243,0.638,0,2,0.0,59,80,0.738,138,238,376,44,32,68,36,143,369,744,1.22,0.89,2020,21,5.426470588235294,1.2222222222222223,88,21,109,3.44954128440367
2020-21,RegularSeason,201949,254,James Johnson,1610612740,NOP,51,1043,146,327,0.446,31,120,0.258,45,76,0.592,32,145,177,98,42,42,55,120,368,460,1.78,0.76,2020,21,7.215686274509804,1.7818181818181817,181,31,212,0.8349056603773585
2020-21,RegularSeason,1630197,255,Aleksej Pokusevski,1610612760,OKC,45,1090,139,408,0.341,58,207,0.28,31,42,0.738,30,182,212,97,20,42,99,58,367,359,0.98,0.2,2020,21,8.155555555555555,0.9797979797979798,269,11,280,0.7571428571428571
2020-21,RegularSeason,1628964,255,Mo Bamba,1610612753,ORL,46,725,142,301,0.472,38,118,0.322,45,66,0.682,76,189,265,35,14,58,36,87,367,523,0.97,0.39,2020,21,7.978260869565218,0.9722222222222222,159,21,180,1.4722222222222223
2020-21,RegularSeason,202326,257,DeMarcus Cousins,1610612746,LAC,41,713,130,305,0.426,47,135,0.348,59,81,0.728,53,210,263,76,34,24,64,107,366,502,1.19,0.53,2020,21,8.926829268292684,1.1875,175,22,197,1.3350253807106598
2020-21,RegularSeason,1626195,258,Willy Hernangomez,1610612740,NOP,47,846,151,268,0.563,1,10,0.1,62,93,0.667,117,217,334,50,22,23,34,68,365,612,1.47,0.65,2020,21,7.76595744680851,1.4705882352941178,117,31,148,2.2567567567567566
2020-21,RegularSeason,203087,259,Jeremy Lamb,1610612754,IND,36,765,120,276,0.435,52,128,0.406,71,75,0.947,25,106,131,53,34,23,22,72,363,422,2.41,1.54,2020,21,10.083333333333334,2.409090909090909,156,4,160,0.81875
2020-21,RegularSeason,1629726,260,Garrison Mathews,1610612764,WAS,64,1038,97,237,0.409,76,198,0.384,84,95,0.884,16,71,87,26,29,7,10,106,354,342,2.6,2.9,2020,21,5.53125,2.6,140,11,151,0.5761589403973509
2020-21,RegularSeason,1630181,260,R.J. Hampton,1610612753,ORL,51,888,136,313,0.435,27,87,0.31,55,82,0.671,29,150,179,87,21,10,53,61,354,394,1.64,0.4,2020,21,6.9411764705882355,1.6415094339622642,177,27,204,0.8774509803921569
2020-21,RegularSeason,1630201,262,Malachi Flynn,1610612761,TOR,47,928,127,340,0.374,54,168,0.321,45,56,0.804,10,106,116,137,38,7,43,68,353,384,3.19,0.88,2020,21,7.51063829787234,3.186046511627907,213,11,224,0.5178571428571429
2020-21,RegularSeason,1628467,262,Maxi Kleber,1610612742,DAL,50,1341,116,275,0.422,87,212,0.41,34,37,0.919,47,213,260,68,24,35,30,105,353,548,2.27,0.8,2020,21,7.06,2.2666666666666666,159,3,162,1.6049382716049383
2020-21,RegularSeason,1629660,262,Ty Jerome,1610612760,OKC,33,788,128,287,0.446,71,168,0.423,26,34,0.765,10,81,91,120,20,6,47,61,353,376,2.55,0.43,2020,21,10.696969696969697,2.5531914893617023,159,8,167,0.5449101796407185
2020-21,RegularSeason,200746,265,LaMarcus Aldridge,1610612751,BKN,26,674,140,296,0.473,31,80,0.388,41,47,0.872,19,99,118,49,11,29,27,47,352,370,1.81,0.41,2020,21,13.538461538461538,1.8148148148148149,156,6,162,0.7283950617283951
2020-21,RegularSeason,1629643,266,Chuma Okeke,1610612753,ORL,45,1133,135,324,0.417,49,141,0.348,30,40,0.75,42,139,181,101,48,22,38,48,349,464,2.66,1.26,2020,21,7.7555555555555555,2.6578947368421053,189,10,199,0.9095477386934674
2020-21,RegularSeason,1629667,267,Jalen McDaniels,1610612766,CHA,47,904,133,284,0.468,35,105,0.333,45,64,0.703,45,124,169,53,28,19,45,95,346,400,1.18,0.62,2020,21,7.361702127659575,1.1777777777777778,151,19,170,0.9941176470588236
2020-21,RegularSeason,203516,268,James Ennis III,1610612753,ORL,41,986,115,243,0.473,45,104,0.433,70,87,0.805,43,123,166,62,32,7,36,84,345,431,1.72,0.89,2020,21,8.414634146341463,1.7222222222222223,128,17,145,1.1448275862068966
2020-21,RegularSeason,1629631,269,De'Andre Hunter,1610612737,ATL,23,678,120,248,0.484,31,95,0.326,73,85,0.859,17,93,110,44,19,12,29,59,344,360,1.52,0.66,2020,21,14.956521739130435,1.5172413793103448,128,12,140,0.7857142857142857
2020-21,RegularSeason,1629020,269,Jarred Vanderbilt,1610612750,MIN,64,1139,143,236,0.606,1,5,0.2,57,102,0.559,118,250,368,76,64,46,53,123,344,707,1.43,1.21,2020,21,5.375,1.4339622641509433,93,45,138,2.6666666666666665
2020-21,RegularSeason,1630184,271,Kira Lewis Jr.,1610612740,NOP,54,904,130,337,0.386,40,120,0.333,43,51,0.843,12,59,71,124,38,10,34,88,343,337,3.65,1.12,2020,21,6.351851851851852,3.6470588235294117,207,8,215,0.3302325581395349
2020-21,RegularSeason,1630166,272,Deni Avdija,1610612764,WAS,54,1257,130,312,0.417,53,168,0.315,29,45,0.644,22,240,262,63,32,15,33,140,342,483,1.91,0.97,2020,21,6.333333333333333,1.9090909090909092,182,16,198,1.3232323232323233
2020-21,RegularSeason,203939,272,Dwight Powell,1610612742,DAL,58,966,120,194,0.619,5,21,0.238,97,124,0.782,80,154,234,63,36,30,40,135,342,564,1.57,0.9,2020,21,5.896551724137931,1.575,74,27,101,2.3168316831683167
2020-21,RegularSeason,1630170,274,Devin Vassell,1610612759,SAS,62,1056,123,303,0.406,52,150,0.347,43,51,0.843,24,150,174,56,43,18,22,88,341,422,2.54,1.96,2020,21,5.5,2.5454545454545454,180,8,188,0.925531914893617
2020-21,RegularSeason,203488,275,Mike Muscala,1610612760,OKC,35,645,119,267,0.446,68,184,0.37,33,36,0.917,19,113,132,28,8,11,21,54,339,346,1.33,0.38,2020,21,9.685714285714285,1.3333333333333333,148,3,151,0.8741721854304636
2020-21,RegularSeason,201580,276,JaVale McGee,1610612743,DEN,46,678,144,282,0.511,5,24,0.208,44,67,0.657,77,162,239,39,19,54,60,121,337,467,0.65,0.32,2020,21,7.326086956521739,0.65,138,23,161,1.484472049689441
2020-21,RegularSeason,1628539,276,Mychal Mulder,1610612744,GSW,60,766,119,265,0.449,85,214,0.397,14,22,0.636,8,52,60,26,12,12,16,56,337,277,1.63,0.75,2020,21,5.616666666666666,1.625,146,8,154,0.38961038961038963
2020-21,RegularSeason,202954,278,Brad Wanamaker,1610612766,CHA,61,1053,115,299,0.385,16,85,0.188,90,101,0.891,18,87,105,174,43,11,71,94,336,403,2.45,0.61,2020,21,5.508196721311475,2.4507042253521125,184,11,195,0.5384615384615384
2020-21,RegularSeason,202687,279,Bismack Biyombo,1610612766,CHA,66,1349,142,242,0.587,0,1,0.0,47,105,0.448,137,210,347,81,17,74,71,141,331,621,1.14,0.24,2020,21,5.015151515151516,1.1408450704225352,100,58,158,2.1962025316455698
2020-21,RegularSeason,200755,280,JJ Redick,1610612742,DAL,44,723,106,267,0.397,66,178,0.371,49,52,0.942,4,60,64,51,11,3,36,50,327,256,1.42,0.31,2020,21,7.431818181818182,1.4166666666666667,161,3,164,0.3902439024390244
2020-21,RegularSeason,1626204,280,Larry Nance Jr.,1610612739,CLE,35,1091,128,272,0.471,41,114,0.36,30,49,0.612,54,181,235,107,61,17,55,72,327,529,1.95,1.11,2020,21,9.342857142857143,1.9454545454545455,144,19,163,1.4417177914110428
2020-21,RegularSeason,203382,282,Aron Baynes,1610612761,TOR,53,980,134,304,0.441,27,103,0.262,29,41,0.707,87,186,273,47,17,22,46,119,324,455,1.02,0.37,2020,21,6.113207547169812,1.0217391304347827,170,12,182,1.5
2020-21,RegularSeason,203457,282,Nerlens Noel,1610612752,NYK,64,1547,137,223,0.614,0,3,0.0,50,70,0.714,142,265,407,46,70,141,65,176,324,817,0.71,1.08,2020,21,5.0625,0.7076923076923077,86,20,106,3.839622641509434
2020-21,RegularSeason,203524,284,Solomon Hill,1610612737,ATL,71,1514,107,298,0.359,68,212,0.321,35,46,0.761,42,172,214,75,50,11,42,116,317,423,1.79,1.19,2020,21,4.464788732394366,1.7857142857142858,191,11,202,1.0594059405940595
2020-21,RegularSeason,1629006,285,Josh Okogie,1610612750,MIN,59,1197,102,254,0.402,29,108,0.269,83,108,0.769,63,93,156,63,54,28,43,123,316,397,1.47,1.26,2020,21,5.3559322033898304,1.4651162790697674,152,25,177,0.8813559322033898
2020-21,RegularSeason,1627863,286,Danuel House Jr.,1610612745,HOU,36,932,110,272,0.404,54,156,0.346,41,63,0.651,18,114,132,69,20,16,36,67,315,332,1.92,0.56,2020,21,8.75,1.9166666666666667,162,22,184,0.717391304347826
2020-21,RegularSeason,1629234,287,Drew Eubanks,1610612759,SAS,54,755,116,205,0.566,2,2,1.0,77,106,0.726,74,167,241,42,18,49,45,88,311,498,0.93,0.4,2020,21,5.7592592592592595,0.9333333333333333,89,29,118,2.042372881355932
2020-21,RegularSeason,1626163,288,Frank Kaminsky,1610612756,PHX,47,715,121,257,0.471,31,85,0.365,37,60,0.617,36,152,188,79,14,17,22,70,310,427,3.59,0.64,2020,21,6.595744680851064,3.590909090909091,136,23,159,1.1823899371069182
2020-21,RegularSeason,1629021,288,Moritz Wagner,1610612753,ORL,45,722,104,229,0.454,31,91,0.341,71,87,0.816,27,119,146,50,26,18,43,108,310,366,1.16,0.6,2020,21,6.888888888888889,1.1627906976744187,125,16,141,1.0354609929078014
2020-21,RegularSeason,1628422,290,Damyean Dotson,1610612739,CLE,46,907,119,293,0.406,46,159,0.289,24,36,0.667,5,88,93,91,16,4,42,42,308,284,2.17,0.38,2020,21,6.695652173913044,2.1666666666666665,174,12,186,0.5
2020-21,RegularSeason,201567,291,Kevin Love,1610612739,CLE,25,622,103,252,0.409,57,156,0.365,42,51,0.824,17,169,186,63,16,2,38,26,305,376,1.66,0.42,2020,21,12.2,1.6578947368421053,149,9,158,1.1772151898734178
2020-21,RegularSeason,1630173,292,Precious Achiuwa,1610612748,MIA,61,737,124,228,0.544,0,1,0.0,56,110,0.509,73,135,208,29,20,28,43,91,304,388,0.67,0.47,2020,21,4.983606557377049,0.6744186046511628,104,54,158,1.3164556962025316
2020-21,RegularSeason,1629308,293,Juan Toscano-Anderson,1610612744,GSW,53,1108,121,209,0.579,37,92,0.402,22,31,0.71,29,206,235,150,41,26,61,111,301,595,2.46,0.67,2020,21,5.679245283018868,2.459016393442623,88,9,97,2.422680412371134
2020-21,RegularSeason,1628396,294,Tony Bradley,1610612760,OKC,42,684,131,197,0.665,0,3,0.0,38,55,0.691,85,154,239,37,15,30,33,61,300,505,1.12,0.46,2020,21,7.142857142857143,1.121212121212121,66,17,83,2.8795180722891565
2020-21,RegularSeason,202397,295,Ish Smith,1610612764,WAS,44,924,129,297,0.434,18,49,0.367,19,33,0.576,22,128,150,172,32,13,41,62,295,439,4.2,0.78,2020,21,6.704545454545454,4.195121951219512,168,14,182,0.8241758241758241
2020-21,RegularSeason,1629684,296,Grant Williams,1610612738,BOS,63,1138,108,247,0.437,48,129,0.372,30,51,0.588,48,130,178,64,32,24,56,161,294,376,1.14,0.57,2020,21,4.666666666666667,1.1428571428571428,139,21,160,1.1125
2020-21,RegularSeason,1627761,297,DeAndre' Bembry,1610612761,TOR,51,972,117,228,0.513,14,53,0.264,45,66,0.682,33,113,146,107,53,18,71,87,293,414,1.51,0.75,2020,21,5.745098039215686,1.5070422535211268,111,21,132,1.106060606060606
2020-21,RegularSeason,202355,297,Hassan Whiteside,1610612758,SAC,36,546,126,224,0.563,0,1,0.0,41,79,0.519,61,154,215,20,9,46,40,73,293,407,0.5,0.23,2020,21,8.13888888888889,0.5,98,38,136,1.5808823529411764
2020-21,RegularSeason,1629629,299,Cam Reddish,1610612737,ATL,26,750,96,263,0.365,33,126,0.262,67,82,0.817,22,82,104,35,33,9,34,68,292,257,1.03,0.97,2020,21,11.23076923076923,1.0294117647058822,167,15,182,0.5714285714285714
2020-21,RegularSeason,203085,300,Austin Rivers,1610612743,DEN,36,845,104,245,0.424,55,149,0.369,22,31,0.71,8,74,82,81,30,2,36,64,285,294,2.25,0.83,2020,21,7.916666666666667,2.25,141,9,150,0.5466666666666666
2020-21,RegularSeason,1629635,300,Sekou Doumbouya,1610612765,DET,56,869,107,282,0.379,26,115,0.226,45,64,0.703,39,104,143,47,24,9,44,94,285,270,1.07,0.55,2020,21,5.089285714285714,1.0681818181818181,175,19,194,0.7371134020618557
2020-21,RegularSeason,2772,302,Trevor Ariza,1610612748,MIA,30,841,99,241,0.411,50,143,0.35,34,44,0.773,27,117,144,55,31,18,21,55,282,357,2.62,1.48,2020,21,9.4,2.619047619047619,142,10,152,0.9473684210526315
2020-21,RegularSeason,1626161,303,Willie Cauley-Stein,1610612742,DAL,53,906,115,182,0.632,1,11,0.091,49,78,0.628,66,170,236,35,21,43,29,129,280,490,1.21,0.72,2020,21,5.283018867924528,1.206896551724138,67,29,96,2.4583333333333335
2020-21,RegularSeason,202083,304,Wesley Matthews,1610612747,LAL,58,1130,89,252,0.353,66,197,0.335,35,41,0.854,20,73,93,54,38,17,26,80,279,286,2.08,1.46,2020,21,4.810344827586207,2.076923076923077,163,6,169,0.5502958579881657
2020-21,RegularSeason,201976,305,Patrick Beverley,1610612746,LAC,37,833,93,220,0.423,56,141,0.397,36,45,0.8,29,90,119,76,29,28,34,108,278,360,2.23,0.85,2020,21,7.513513513513513,2.235294117647059,127,9,136,0.875
2020-21,RegularSeason,1628021,306,David Nwaba,1610612745,HOU,30,679,106,218,0.486,17,63,0.27,47,68,0.691,40,78,118,31,30,21,17,60,276,326,1.82,1.76,2020,21,9.2,1.8235294117647058,112,21,133,0.8872180451127819
2020-21,RegularSeason,2738,307,Andre Iguodala,1610612748,MIA,63,1339,95,248,0.383,60,182,0.33,25,38,0.658,38,183,221,142,57,35,67,90,275,497,2.12,0.85,2020,21,4.365079365079365,2.1194029850746268,153,13,166,1.3313253012048192
2020-21,RegularSeason,203487,308,Michael Carter-Williams,1610612753,ORL,31,800,105,270,0.389,15,61,0.246,49,80,0.613,39,100,139,129,25,17,69,81,274,319,1.87,0.36,2020,21,8.838709677419354,1.8695652173913044,165,31,196,0.7091836734693877
2020-21,RegularSeason,1628470,308,Torrey Craig,1610612756,PHX,50,803,109,227,0.48,39,106,0.368,17,22,0.773,57,140,197,49,28,27,25,83,274,427,1.96,1.12,2020,21,5.48,1.96,118,5,123,1.6016260162601625
2020-21,RegularSeason,203490,310,Otto Porter Jr.,1610612753,ORL,28,607,98,227,0.432,39,104,0.375,36,42,0.857,28,124,152,55,16,4,25,41,271,338,2.2,0.64,2020,21,9.678571428571429,2.2,129,6,135,1.125925925925926
2020-21,RegularSeason,1630240,311,Saben Lee,1610612765,DET,48,781,99,210,0.471,8,23,0.348,61,89,0.685,20,77,97,174,32,13,55,76,267,389,3.16,0.58,2020,21,5.5625,3.1636363636363636,111,28,139,0.697841726618705
2020-21,RegularSeason,1626169,311,Stanley Johnson,1610612761,TOR,61,1006,89,233,0.382,45,137,0.328,44,55,0.8,29,124,153,89,52,18,54,116,267,370,1.65,0.96,2020,21,4.377049180327869,1.6481481481481481,144,11,155,0.9870967741935484
2020-21,RegularSeason,1626184,313,Chasson Randle,1610612753,ORL,41,837,92,237,0.388,44,130,0.338,38,48,0.792,7,75,82,74,22,5,46,64,266,248,1.61,0.48,2020,21,6.487804878048781,1.608695652173913,145,10,155,0.5290322580645161
2020-21,RegularSeason,1628997,314,Caleb Martin,1610612766,CHA,53,818,96,256,0.375,31,125,0.248,41,64,0.641,31,110,141,67,37,12,33,62,264,305,2.03,1.12,2020,21,4.981132075471698,2.0303030303030303,160,23,183,0.7704918032786885
2020-21,RegularSeason,201188,315,Marc Gasol,1610612747,LAL,52,993,88,194,0.454,50,122,0.41,36,50,0.72,38,177,215,109,26,58,53,115,262,497,2.06,0.49,2020,21,5.038461538461538,2.056603773584906,106,14,120,1.7916666666666667
2020-21,RegularSeason,201588,316,George Hill,1610612755,PHI,30,672,95,197,0.482,31,80,0.388,40,50,0.8,16,45,61,73,23,5,31,31,261,280,2.35,0.74,2020,21,8.7,2.3548387096774195,102,10,112,0.5446428571428571
2020-21,RegularSeason,1628400,317,Semi Ojeleye,1610612738,BOS,56,950,89,221,0.403,58,158,0.367,24,32,0.75,31,116,147,37,17,0,21,56,260,300,1.76,0.81,2020,21,4.642857142857143,1.7619047619047619,132,8,140,1.05
2020-21,RegularSeason,203476,318,Gorgui Dieng,1610612759,SAS,38,553,85,163,0.521,30,70,0.429,58,67,0.866,40,100,140,48,26,16,32,56,258,369,1.5,0.81,2020,21,6.7894736842105265,1.5,78,9,87,1.6091954022988506
2020-21,RegularSeason,1629162,319,Jordan McLaughlin,1610612750,MIN,51,938,100,242,0.413,33,92,0.359,23,30,0.767,21,87,108,193,51,6,51,44,256,414,3.78,1.0,2020,21,5.019607843137255,3.784313725490196,142,7,149,0.7248322147651006
2020-21,RegularSeason,1629011,319,Mitchell Robinson,1610612752,NYK,31,853,115,176,0.653,0,0,0.0,26,53,0.491,113,139,252,17,35,45,26,86,256,491,0.65,1.35,2020,21,8.258064516129032,0.6538461538461539,61,27,88,2.8636363636363638
2020-21,RegularSeason,1629680,321,Matisse Thybulle,1610612755,PHI,65,1298,102,243,0.42,43,143,0.301,8,18,0.444,30,94,124,63,105,71,32,127,255,435,1.97,3.28,2020,21,3.923076923076923,1.96875,141,10,151,0.8211920529801324
2020-21,RegularSeason,1630167,322,Obi Toppin,1610612752,NYK,62,683,104,209,0.498,26,85,0.306,19,26,0.731,26,112,138,29,17,15,23,55,253,317,1.26,0.74,2020,21,4.080645161290323,1.2608695652173914,105,7,112,1.2321428571428572
2020-21,RegularSeason,1626172,323,Kevon Looney,1610612744,GSW,61,1161,108,197,0.548,4,17,0.235,31,48,0.646,117,205,322,119,21,22,37,136,251,592,3.22,0.57,2020,21,4.114754098360656,3.2162162162162162,89,17,106,3.0377358490566038
2020-21,RegularSeason,203503,324,Tony Snell,1610612737,ATL,47,992,88,171,0.515,62,109,0.569,11,11,1.0,18,94,112,59,13,11,21,75,249,340,2.81,0.62,2020,21,5.297872340425532,2.8095238095238093,83,0,83,1.3493975903614457
2020-21,RegularSeason,1628975,325,Jevon Carter,1610612756,PHX,60,717,94,223,0.422,56,151,0.371,4,7,0.571,16,76,92,71,29,9,16,56,248,301,4.44,1.81,2020,21,4.133333333333334,4.4375,129,3,132,0.696969696969697
2020-21,RegularSeason,1630230,326,Naji Marshall,1610612740,NOP,32,700,82,209,0.392,29,83,0.349,53,75,0.707,15,133,148,88,26,10,38,58,246,331,2.32,0.68,2020,21,7.6875,2.3157894736842106,127,22,149,0.9932885906040269
2020-21,RegularSeason,203918,326,Rodney Hood,1610612761,TOR,55,943,94,260,0.362,34,113,0.301,24,28,0.857,23,80,103,53,24,7,36,74,246,227,1.47,0.67,2020,21,4.472727272727273,1.4722222222222223,166,4,170,0.6058823529411764
2020-21,RegularSeason,1628382,328,Justin Jackson,1610612749,MIL,34,577,89,221,0.403,36,117,0.308,31,37,0.838,16,61,77,52,15,2,32,32,245,221,1.63,0.47,2020,21,7.205882352941177,1.625,132,6,138,0.5579710144927537
2020-21,RegularSeason,1629216,329,Gabe Vincent,1610612748,MIA,50,655,88,233,0.378,46,149,0.309,20,23,0.87,10,46,56,67,21,2,34,79,242,206,1.97,0.62,2020,21,4.84,1.9705882352941178,145,3,148,0.3783783783783784
2020-21,RegularSeason,202357,329,Nemanja Bjelica,1610612748,MIA,37,595,89,196,0.454,27,85,0.318,37,51,0.725,29,98,127,69,15,5,33,68,242,304,2.09,0.46,2020,21,6.54054054054054,2.090909090909091,107,14,121,1.0495867768595042
2020-21,RegularSeason,200765,329,Rajon Rondo,1610612746,LAC,45,769,95,215,0.442,36,89,0.404,16,17,0.941,18,92,110,199,37,4,79,53,242,392,2.52,0.47,2020,21,5.377777777777778,2.518987341772152,120,1,121,0.9090909090909091
2020-21,RegularSeason,201959,332,Taj Gibson,1610612752,NYK,45,936,99,158,0.627,3,15,0.2,40,55,0.727,99,151,250,36,31,49,22,99,241,511,1.64,1.41,2020,21,5.355555555555555,1.6363636363636365,59,15,74,3.3783783783783785
2020-21,RegularSeason,1628392,333,Isaiah Hartenstein,1610612739,CLE,46,559,94,171,0.55,2,6,0.333,46,71,0.648,65,116,181,55,19,39,44,104,236,384,1.25,0.43,2020,21,5.130434782608695,1.25,77,25,102,1.7745098039215685
2020-21,RegularSeason,1629622,333,Max Strus,1610612748,MIA,39,507,85,187,0.455,50,148,0.338,16,24,0.667,5,36,41,24,11,2,8,43,236,196,3.0,1.38,2020,21,6.051282051282051,3.0,102,8,110,0.37272727272727274
2020-21,RegularSeason,1629048,335,Goga Bitadze,1610612754,IND,45,561,83,194,0.428,20,79,0.253,45,61,0.738,60,90,150,37,9,60,17,94,231,343,2.18,0.53,2020,21,5.133333333333334,2.176470588235294,111,16,127,1.1811023622047243
2020-21,RegularSeason,1627774,335,Jake Layman,1610612750,MIN,45,627,91,184,0.495,23,78,0.295,26,37,0.703,13,54,67,28,29,19,26,44,231,244,1.08,1.11,2020,21,5.133333333333334,1.0769230769230769,93,11,104,0.6442307692307693
2020-21,RegularSeason,1629052,337,Oshae Brissett,1610612754,IND,21,519,73,151,0.483,33,78,0.423,50,65,0.769,29,86,115,18,19,20,10,32,229,298,1.8,1.9,2020,21,10.904761904761905,1.8,78,15,93,1.2365591397849462
2020-21,RegularSeason,1629164,338,Brandon Goodwin,1610612737,ATL,47,620,84,223,0.377,32,103,0.311,28,43,0.651,8,61,69,95,17,0,36,41,228,219,2.64,0.47,2020,21,4.851063829787234,2.638888888888889,139,15,154,0.44805194805194803
2020-21,RegularSeason,1630168,338,Onyeka Okongwu,1610612737,ATL,50,601,96,149,0.644,0,3,0.0,36,57,0.632,62,101,163,18,23,33,29,100,228,362,0.62,0.79,2020,21,4.56,0.6206896551724138,53,21,74,2.2027027027027026
2020-21,RegularSeason,1629002,340,Chimezie Metu,1610612758,SAC,36,488,91,179,0.508,13,37,0.351,31,43,0.721,31,81,112,28,14,18,29,59,226,269,0.97,0.48,2020,21,6.277777777777778,0.9655172413793104,88,12,100,1.12
2020-21,RegularSeason,1629717,341,Armoni Brooks,1610612745,HOU,20,520,78,192,0.406,60,157,0.382,7,12,0.583,10,58,68,30,12,5,22,34,223,197,1.36,0.55,2020,21,11.15,1.3636363636363635,114,5,119,0.5714285714285714
2020-21,RegularSeason,1629642,342,Nassir Little,1610612757,POR,48,640,78,167,0.467,28,80,0.35,36,45,0.8,32,96,128,23,5,13,18,51,220,273,1.28,0.28,2020,21,4.583333333333333,1.2777777777777777,89,9,98,1.3061224489795917
2020-21,RegularSeason,1630174,343,Aaron Nesmith,1610612738,BOS,46,669,78,178,0.438,40,108,0.37,22,28,0.786,28,99,127,23,15,9,23,87,218,263,1.0,0.65,2020,21,4.739130434782608,1.0,100,6,106,1.1981132075471699
2020-21,RegularSeason,1629139,343,Yuta Watanabe,1610612761,TOR,50,723,79,180,0.439,36,90,0.4,24,29,0.828,36,123,159,40,26,19,19,57,218,337,2.1,1.37,2020,21,4.36,2.1052631578947367,101,5,106,1.5
2020-21,RegularSeason,203118,345,Mike Scott,1610612755,PHI,51,852,76,211,0.36,53,155,0.342,8,12,0.667,11,109,120,40,24,14,19,72,213,253,2.1,1.26,2020,21,4.176470588235294,2.1052631578947367,135,4,139,0.8633093525179856
2020-21,RegularSeason,1629651,346,Nic Claxton,1610612751,BKN,32,594,90,145,0.621,1,5,0.2,31,64,0.484,43,123,166,28,23,40,18,68,212,363,1.56,1.28,2020,21,6.625,1.5555555555555556,55,33,88,1.8863636363636365
2020-21,RegularSeason,204020,347,Tyler Johnson,1610612751,BKN,39,684,72,183,0.393,48,132,0.364,18,21,0.857,6,71,77,47,14,0,17,43,210,217,2.77,0.82,2020,21,5.384615384615385,2.764705882352941,111,3,114,0.6754385964912281
2020-21,RegularSeason,1628998,348,Cody Martin,1610612766,CHA,52,849,83,188,0.441,16,58,0.276,25,43,0.581,52,109,161,86,37,12,40,52,207,340,2.15,0.93,2020,21,3.980769230769231,2.15,105,18,123,1.3089430894308942
2020-21,RegularSeason,202335,349,Patrick Patterson,1610612746,LAC,38,582,72,165,0.436,40,112,0.357,13,17,0.765,19,56,75,29,14,8,11,45,197,215,2.64,1.27,2020,21,5.184210526315789,2.6363636363636362,93,4,97,0.7731958762886598
2020-21,RegularSeason,203090,350,Maurice Harkless,1610612758,SAC,37,772,69,165,0.418,23,84,0.274,33,43,0.767,13,76,89,44,30,20,22,86,194,249,2.0,1.36,2020,21,5.243243243243243,2.0,96,10,106,0.839622641509434
2020-21,RegularSeason,200782,351,P.J. Tucker,1610612749,MIL,52,1356,66,177,0.373,40,119,0.336,21,28,0.75,51,153,204,61,39,20,40,125,193,359,1.52,0.97,2020,21,3.7115384615384617,1.525,111,7,118,1.728813559322034
2020-21,RegularSeason,204038,352,Langston Galloway,1610612756,PHX,40,438,66,147,0.449,36,85,0.424,22,23,0.957,7,35,42,26,8,0,13,25,190,171,2.0,0.61,2020,21,4.75,2.0,81,1,82,0.5121951219512195
2020-21,RegularSeason,1629723,353,John Konchar,1610612763,MEM,43,575,69,138,0.5,21,56,0.375,25,30,0.833,35,93,128,47,30,9,18,40,184,306,2.61,1.67,2020,21,4.27906976744186,2.611111111111111,69,5,74,1.7297297297297298
2020-21,RegularSeason,1628391,354,D.J. Wilson,1610612745,HOU,35,433,68,168,0.405,30,87,0.345,17,25,0.68,20,92,112,23,11,16,22,44,183,215,1.04,0.5,2020,21,5.228571428571429,1.0454545454545454,100,8,108,1.037037037037037
2020-21,RegularSeason,1627745,354,Damian Jones,1610612758,SAC,39,546,70,103,0.68,1,5,0.2,42,58,0.724,36,85,121,29,11,29,26,77,183,298,1.11,0.42,2020,21,4.6923076923076925,1.1153846153846154,33,16,49,2.4693877551020407
2020-21,RegularSeason,1629633,356,Jarrett Culver,1610612750,MIN,34,499,69,168,0.411,13,53,0.245,29,48,0.604,34,70,104,24,17,9,28,58,180,188,0.86,0.61,2020,21,5.294117647058823,0.8571428571428571,99,19,118,0.8813559322033898
2020-21,RegularSeason,1626159,357,Justise Winslow,1610612763,MEM,26,507,74,210,0.352,10,54,0.185,20,35,0.571,18,100,118,50,15,12,37,47,178,185,1.35,0.41,2020,21,6.846153846153846,1.3513513513513513,136,15,151,0.7814569536423841
2020-21,RegularSeason,1630165,358,Killian Hayes,1610612765,DET,26,670,71,201,0.353,20,72,0.278,14,17,0.824,6,63,69,138,27,10,83,57,176,204,1.66,0.33,2020,21,6.769230769230769,1.6626506024096386,130,3,133,0.518796992481203
2020-21,RegularSeason,202340,359,Avery Bradley,1610612745,HOU,27,602,64,171,0.374,33,101,0.327,12,15,0.8,8,49,57,46,21,3,28,55,173,162,1.64,0.75,2020,21,6.407407407407407,1.6428571428571428,107,3,110,0.5181818181818182
2020-21,RegularSeason,1629670,360,Jordan Nwora,1610612749,MIL,30,274,62,135,0.459,28,62,0.452,19,25,0.76,9,51,60,7,17,8,24,22,171,160,0.29,0.71,2020,21,5.7,0.2916666666666667,73,6,79,0.759493670886076
2020-21,RegularSeason,1630222,361,Mason Jones,1610612755,PHI,32,334,52,123,0.423,24,66,0.364,40,64,0.625,7,48,55,42,7,1,29,24,168,149,1.45,0.24,2020,21,5.25,1.4482758620689655,71,24,95,0.5789473684210527
2020-21,RegularSeason,203648,362,Thanasis Antetokounmpo,1610612749,MIL,57,551,67,137,0.489,7,29,0.241,25,49,0.51,54,70,124,46,22,10,43,74,166,231,1.07,0.51,2020,21,2.912280701754386,1.069767441860465,70,24,94,1.3191489361702127
2020-21,RegularSeason,1630205,363,Lamar Stevens,1610612739,CLE,40,499,62,136,0.456,4,25,0.16,37,51,0.725,24,72,96,25,17,13,23,53,165,205,1.09,0.74,2020,21,4.125,1.0869565217391304,74,14,88,1.0909090909090908
2020-21,RegularSeason,1628995,364,Kevin Knox II,1610612752,NYK,42,464,56,143,0.392,35,89,0.393,16,20,0.8,10,51,61,19,12,6,17,37,163,153,1.12,0.71,2020,21,3.880952380952381,1.1176470588235294,87,4,91,0.6703296703296703
2020-21,RegularSeason,1629685,365,Dylan Windler,1610612739,CLE,31,513,57,130,0.438,26,77,0.338,21,27,0.778,20,87,107,33,19,12,32,37,161,221,1.03,0.59,2020,21,5.193548387096774,1.03125,73,6,79,1.3544303797468353
2020-21,RegularSeason,1628972,365,Troy Brown Jr.,1610612741,CHI,34,523,62,144,0.431,22,70,0.314,15,21,0.714,20,85,105,29,10,6,21,49,161,202,1.38,0.48,2020,21,4.735294117647059,1.380952380952381,82,6,88,1.1931818181818181
2020-21,RegularSeason,1627846,367,Abdel Nader,1610612756,PHX,24,355,57,116,0.491,18,43,0.419,28,37,0.757,7,55,62,19,10,9,19,34,160,173,1.0,0.53,2020,21,6.666666666666667,1.0,59,9,68,0.9117647058823529
2020-21,RegularSeason,1628991,368,Jaren Jackson Jr.,1610612763,MEM,11,258,53,125,0.424,17,60,0.283,35,42,0.833,17,45,62,12,12,18,15,42,158,168,0.8,0.8,2020,21,14.363636363636363,0.8,72,7,79,0.7848101265822784
2020-21,RegularSeason,1629103,369,Kelan Martin,1610612754,IND,35,323,62,138,0.449,24,60,0.4,9,10,0.9,18,60,78,17,10,10,16,35,157,179,1.06,0.63,2020,21,4.485714285714286,1.0625,76,1,77,1.0129870129870129
2020-21,RegularSeason,1626246,370,Boban Marjanovic,1610612742,DAL,33,271,62,122,0.508,1,8,0.125,31,38,0.816,47,81,128,10,2,6,12,29,156,223,0.83,0.17,2020,21,4.7272727272727275,0.8333333333333334,60,7,67,1.9104477611940298
2020-21,RegularSeason,1629076,370,Tyler Cook,1610612765,DET,32,437,69,103,0.67,1,2,0.5,17,35,0.486,28,67,95,17,8,2,21,35,156,205,0.81,0.38,2020,21,4.875,0.8095238095238095,34,18,52,1.8269230769230769
2020-21,RegularSeason,1628372,372,Dennis Smith Jr.,1610612765,DET,23,420,58,145,0.4,19,58,0.328,19,26,0.731,12,43,55,77,23,14,26,37,154,203,2.96,0.89,2020,21,6.695652173913044,2.9615384615384617,87,7,94,0.5851063829787234
2020-21,RegularSeason,1630198,373,Isaiah Joe,1610612755,PHI,41,383,48,133,0.361,39,106,0.368,18,24,0.75,6,30,36,20,12,4,11,34,153,123,1.82,1.09,2020,21,3.731707317073171,1.8181818181818181,85,6,91,0.3956043956043956
2020-21,RegularSeason,1629750,374,Javonte Green,1610612741,CHI,41,474,53,102,0.52,10,30,0.333,30,40,0.75,26,45,71,17,28,6,19,45,146,190,0.9,1.47,2020,21,3.5609756097560976,0.8947368421052632,49,10,59,1.2033898305084745
2020-21,RegularSeason,1626143,375,Jahlil Okafor,1610612765,DET,27,347,63,102,0.618,2,9,0.222,17,24,0.708,23,43,66,13,6,5,21,39,145,168,0.62,0.29,2020,21,5.37037037037037,0.6190476190476191,39,7,46,1.434782608695652
2020-21,RegularSeason,1628418,376,Thomas Bryant,1610612764,WAS,10,271,59,91,0.648,9,21,0.429,16,24,0.667,18,43,61,15,4,8,11,31,143,180,1.36,0.36,2020,21,14.3,1.3636363636363635,32,8,40,1.525
2020-21,RegularSeason,1629599,377,Amir Coffey,1610612746,LAC,44,395,45,103,0.437,23,56,0.411,27,38,0.711,10,34,44,22,10,0,15,30,140,132,1.47,0.67,2020,21,3.1818181818181817,1.4666666666666666,58,11,69,0.6376811594202898
2020-21,RegularSeason,1629713,378,Justin James,1610612758,SAC,36,310,52,111,0.468,14,38,0.368,21,36,0.583,9,21,30,22,8,3,15,23,139,113,1.47,0.53,2020,21,3.861111111111111,1.4666666666666666,59,15,74,0.40540540540540543
2020-21,RegularSeason,1629744,378,Matt Thomas,1610612762,UTA,45,327,50,127,0.394,27,80,0.338,12,14,0.857,7,37,44,19,4,0,14,18,139,113,1.36,0.29,2020,21,3.088888888888889,1.3571428571428572,77,2,79,0.5569620253164557
2020-21,RegularSeason,1627853,380,Ryan Arcidiacono,1610612741,CHI,44,450,49,117,0.419,25,67,0.373,13,20,0.65,5,62,67,56,9,0,10,47,136,183,5.6,0.9,2020,21,3.090909090909091,5.6,68,7,75,0.8933333333333333
2020-21,RegularSeason,1630192,380,Zeke Nnaji,1610612743,DEN,42,397,50,104,0.481,24,59,0.407,12,15,0.8,14,51,65,10,8,4,7,29,136,159,1.43,1.14,2020,21,3.238095238095238,1.4285714285714286,54,3,57,1.1403508771929824
2020-21,RegularSeason,203960,382,JaKarr Sampson,1610612754,IND,29,316,56,113,0.496,3,15,0.2,19,29,0.655,27,50,77,4,2,14,15,52,134,149,0.27,0.13,2020,21,4.620689655172414,0.26666666666666666,57,10,67,1.1492537313432836
2020-21,RegularSeason,1629740,382,Nicolo Melli,1610612742,DAL,45,566,46,141,0.326,23,85,0.271,19,25,0.76,29,93,122,44,14,3,12,58,134,204,3.67,1.17,2020,21,2.977777777777778,3.6666666666666665,95,6,101,1.2079207920792079
2020-21,RegularSeason,1630237,384,Anthony Lamb,1610612745,HOU,24,415,46,118,0.39,23,71,0.324,18,21,0.857,27,43,70,23,6,5,19,34,133,143,1.21,0.32,2020,21,5.541666666666667,1.2105263157894737,72,3,75,0.9333333333333333
2020-21,RegularSeason,202734,384,E'Twaun Moore,1610612756,PHX,27,389,55,121,0.455,11,35,0.314,12,14,0.857,14,31,45,40,15,5,23,32,133,147,1.74,0.65,2020,21,4.925925925925926,1.7391304347826086,66,2,68,0.6617647058823529
2020-21,RegularSeason,1629610,386,DaQuan Jeffries,1610612759,SAS,31,493,50,120,0.417,20,67,0.299,7,8,0.875,19,52,71,22,15,10,14,48,127,160,1.57,1.07,2020,21,4.096774193548387,1.5714285714285714,70,1,71,1.0
2020-21,RegularSeason,1630271,387,Brodric Thomas,1610612739,CLE,32,399,39,108,0.361,16,59,0.271,31,46,0.674,8,45,53,30,15,10,22,40,125,127,1.36,0.68,2020,21,3.90625,1.3636363636363635,69,15,84,0.6309523809523809
2020-21,RegularSeason,1630233,388,Nathan Knight,1610612737,ATL,33,279,37,100,0.37,6,33,0.182,44,55,0.8,27,45,72,8,9,10,15,22,124,134,0.53,0.6,2020,21,3.757575757575758,0.5333333333333333,63,11,74,0.972972972972973
2020-21,RegularSeason,1630219,388,Skylar Mays,1610612737,ATL,33,269,44,98,0.449,14,40,0.35,22,25,0.88,10,25,35,30,14,2,9,15,124,139,3.33,1.56,2020,21,3.757575757575758,3.3333333333333335,54,3,57,0.6140350877192983
2020-21,RegularSeason,1629035,390,Carsen Edwards,1610612738,BOS,31,276,47,111,0.423,18,63,0.286,11,13,0.846,3,23,26,14,7,1,7,25,123,98,2.0,1.0,2020,21,3.967741935483871,2.0,64,2,66,0.3939393939393939
2020-21,RegularSeason,1630185,390,Nico Mannion,1610612744,GSW,30,364,39,114,0.342,22,60,0.367,23,28,0.821,6,40,46,70,16,1,31,29,123,145,2.26,0.52,2020,21,4.1,2.2580645161290325,75,5,80,0.575
2020-21,RegularSeason,1628035,392,Alfonzo McKinnie,1610612747,LAL,39,258,48,93,0.516,16,39,0.41,10,18,0.556,22,32,54,6,7,0,5,26,122,131,1.2,1.4,2020,21,3.128205128205128,1.2,45,8,53,1.0188679245283019
2020-21,RegularSeason,1629677,392,Luka Samanic,1610612759,SAS,33,308,47,105,0.448,12,43,0.279,16,29,0.552,16,52,68,15,8,8,20,43,122,130,0.75,0.4,2020,21,3.696969696969697,0.75,58,13,71,0.9577464788732394
2020-21,RegularSeason,203922,394,Glenn Robinson III,1610612758,SAC,23,369,42,99,0.424,16,44,0.364,21,23,0.913,11,34,45,20,4,3,11,23,121,123,1.82,0.36,2020,21,5.260869565217392,1.8181818181818181,57,2,59,0.7627118644067796
2020-21,RegularSeason,1629109,395,Gary Clark,1610612755,PHI,39,654,40,132,0.303,31,108,0.287,8,10,0.8,33,82,115,31,13,7,17,35,119,174,1.82,0.77,2020,21,3.051282051282051,1.8235294117647058,92,2,94,1.2234042553191489
2020-21,RegularSeason,1629658,396,Jaylen Hoard,1610612760,OKC,19,320,44,88,0.5,0,11,0.0,28,41,0.683,21,44,65,24,13,5,17,19,116,149,1.41,0.77,2020,21,6.105263157894737,1.411764705882353,44,13,57,1.1403508771929824
2020-21,RegularSeason,1626168,397,Trey Lyles,1610612759,SAS,23,358,43,90,0.478,14,40,0.35,15,23,0.652,9,77,86,14,6,1,6,13,115,161,2.33,1.0,2020,21,5.0,2.3333333333333335,47,8,55,1.5636363636363637
2020-21,RegularSeason,203473,398,Dewayne Dedmon,1610612748,MIA,16,210,46,65,0.708,1,5,0.2,20,27,0.741,28,58,86,12,9,6,13,36,113,187,0.92,0.69,2020,21,7.0625,0.9230769230769231,19,7,26,3.3076923076923075
2020-21,RegularSeason,1630273,399,Freddie Gillespie,1610612761,TOR,20,392,44,84,0.524,0,0,0.0,23,33,0.697,42,55,97,9,13,20,12,43,111,188,0.75,1.08,2020,21,5.55,0.75,40,10,50,1.94
2020-21,RegularSeason,1628778,399,Paul Watson,1610612761,TOR,27,297,38,82,0.463,30,64,0.469,5,8,0.625,4,41,45,17,6,3,9,36,111,126,1.89,0.67,2020,21,4.111111111111111,1.8888888888888888,44,3,47,0.9574468085106383
2020-21,RegularSeason,1628385,401,Harry Giles III,1610612757,POR,38,348,42,97,0.433,8,23,0.348,16,27,0.593,31,102,133,29,8,13,20,54,108,205,1.45,0.4,2020,21,2.8421052631578947,1.45,55,11,66,2.015151515151515
2020-21,RegularSeason,1628990,402,Chandler Hutchison,1610612764,WAS,25,346,39,103,0.379,8,22,0.364,21,25,0.84,6,72,78,17,12,5,20,33,107,131,0.85,0.6,2020,21,4.28,0.85,64,4,68,1.1470588235294117
2020-21,RegularSeason,1628436,403,Luke Kornet,1610612738,BOS,31,347,44,101,0.436,15,59,0.254,3,6,0.5,14,53,67,24,4,32,7,20,106,166,3.43,0.57,2020,21,3.4193548387096775,3.4285714285714284,57,3,60,1.1166666666666667
2020-21,RegularSeason,1630210,404,Markus Howard,1610612743,DEN,37,205,40,106,0.377,18,65,0.277,7,9,0.778,1,20,21,18,4,1,18,23,105,63,1.0,0.22,2020,21,2.8378378378378377,1.0,66,2,68,0.3088235294117647
2020-21,RegularSeason,1629671,404,Miye Oni,1610612762,UTA,54,519,35,99,0.354,30,88,0.341,5,6,0.833,23,61,84,28,11,8,16,61,105,155,1.75,0.69,2020,21,1.9444444444444444,1.75,64,1,65,1.2923076923076924
2020-21,RegularSeason,1628365,406,Markelle Fultz,1610612753,ORL,8,215,41,104,0.394,4,16,0.25,17,19,0.895,5,20,25,43,8,2,18,18,103,98,2.39,0.44,2020,21,12.875,2.388888888888889,63,2,65,0.38461538461538464
2020-21,RegularSeason,202329,407,Al-Farouq Aminu,1610612741,CHI,23,434,38,99,0.384,8,37,0.216,18,22,0.818,22,88,110,31,19,9,28,29,102,178,1.11,0.68,2020,21,4.434782608695652,1.1071428571428572,61,4,65,1.6923076923076923
2020-21,RegularSeason,1630182,408,Josh Green,1610612742,DAL,39,445,42,93,0.452,4,25,0.16,13,23,0.565,28,50,78,28,16,3,17,35,101,148,1.65,0.94,2020,21,2.58974358974359,1.6470588235294117,51,10,61,1.278688524590164
2020-21,RegularSeason,1628455,409,Mike James,1610612751,BKN,13,236,34,92,0.37,11,31,0.355,21,27,0.778,3,29,32,54,6,1,20,10,100,109,2.7,0.3,2020,21,7.6923076923076925,2.7,58,6,64,0.5
2020-21,RegularSeason,1629682,410,Tremont Waters,1610612738,BOS,26,238,34,84,0.405,15,38,0.395,16,17,0.941,5,16,21,62,15,1,27,17,99,120,2.3,0.56,2020,21,3.8076923076923075,2.2962962962962963,50,1,51,0.4117647058823529
2020-21,RegularSeason,1628411,410,Wes Iwundu,1610612740,NOP,41,539,34,102,0.333,5,41,0.122,26,31,0.839,15,75,90,18,15,4,19,49,99,134,0.95,0.79,2020,21,2.4146341463414633,0.9473684210526315,68,5,73,1.2328767123287672
2020-21,RegularSeason,1630223,412,Jalen Harris,1610612761,TOR,13,172,36,72,0.5,17,36,0.472,7,9,0.778,3,15,18,17,8,0,14,15,96,87,1.21,0.57,2020,21,7.384615384615385,1.2142857142857142,36,2,38,0.47368421052631576
2020-21,RegularSeason,1629662,413,Mfiondu Kabengele,1610612739,CLE,39,280,33,89,0.371,13,50,0.26,16,20,0.8,12,48,60,17,8,13,15,36,95,118,1.13,0.53,2020,21,2.4358974358974357,1.1333333333333333,56,4,60,1.0
2020-21,RegularSeason,1628993,414,Alize Johnson,1610612751,BKN,18,189,40,68,0.588,1,6,0.167,13,13,1.0,27,63,90,14,5,5,9,16,94,171,1.56,0.56,2020,21,5.222222222222222,1.5555555555555556,28,0,28,3.2142857142857144
2020-21,RegularSeason,1630200,414,Tre Jones,1610612759,SAS,37,269,37,78,0.474,3,5,0.6,17,19,0.895,8,13,21,39,8,0,13,13,94,106,3.0,0.61,2020,21,2.5405405405405403,3.0,41,2,43,0.4883720930232558
2020-21,RegularSeason,1629644,416,KZ Okpala,1610612748,MIA,37,447,36,96,0.375,12,50,0.24,8,15,0.533,21,47,68,19,10,11,15,59,92,118,1.27,0.67,2020,21,2.4864864864864864,1.2666666666666666,60,7,67,1.0149253731343284
2020-21,RegularSeason,1629649,417,Ignas Brazdeikis,1610612753,ORL,13,249,35,83,0.422,11,28,0.393,10,14,0.714,11,34,45,17,4,3,12,22,91,96,1.42,0.33,2020,21,7.0,1.4166666666666667,48,4,52,0.8653846153846154
2020-21,RegularSeason,203585,417,Rodney McGruder,1610612765,DET,16,194,37,70,0.529,11,24,0.458,6,8,0.75,8,14,22,16,8,1,7,12,91,96,2.29,1.14,2020,21,5.6875,2.2857142857142856,33,2,35,0.6285714285714286
2020-21,RegularSeason,1628373,419,Frank Ntilikina,1610612752,NYK,33,322,29,79,0.367,23,48,0.479,8,18,0.444,6,25,31,19,18,4,11,45,89,90,1.73,1.64,2020,21,2.696969696969697,1.7272727272727273,50,10,60,0.5166666666666667
2020-21,RegularSeason,1630241,419,Sam Merrill,1610612749,MIL,30,233,32,72,0.444,21,47,0.447,4,4,1.0,6,24,30,21,8,1,10,17,89,99,2.1,0.8,2020,21,2.966666666666667,2.1,40,0,40,0.75
2020-21,RegularSeason,1629185,421,Chris Chiozza,1610612751,BKN,22,232,31,88,0.352,13,42,0.31,13,17,0.765,3,21,24,65,7,6,16,19,88,113,4.06,0.44,2020,21,4.0,4.0625,57,4,61,0.39344262295081966
2020-21,RegularSeason,1630194,421,Paul Reed,1610612755,PHI,26,177,42,78,0.538,0,6,0.0,4,8,0.5,30,31,61,12,10,13,12,29,88,132,1.0,0.83,2020,21,3.3846153846153846,1.0,36,4,40,1.525
2020-21,RegularSeason,1630235,421,Trent Forrest,1610612762,UTA,30,302,32,71,0.451,5,26,0.192,19,19,1.0,11,33,44,45,9,4,21,22,88,130,2.14,0.43,2020,21,2.933333333333333,2.142857142857143,39,0,39,1.1282051282051282
2020-21,RegularSeason,1629657,424,Kyle Guy,1610612758,SAC,31,235,29,88,0.33,13,46,0.283,16,20,0.8,5,30,35,32,6,0,11,20,87,86,2.91,0.55,2020,21,2.806451612903226,2.909090909090909,59,4,63,0.5555555555555556
2020-21,RegularSeason,1630221,425,Josh Hall,1610612760,OKC,21,336,30,99,0.303,4,37,0.108,22,44,0.5,6,53,59,28,4,1,25,37,86,62,1.12,0.16,2020,21,4.095238095238095,1.12,69,22,91,0.6483516483516484
2020-21,RegularSeason,1628427,426,Vlatko Cancar,1610612743,DEN,41,281,33,72,0.458,9,33,0.273,10,13,0.769,11,39,50,14,11,2,14,18,85,106,1.0,0.79,2020,21,2.073170731707317,1.0,39,3,42,1.1904761904761905
2020-21,RegularSeason,1630466,427,Gabriel Deck,1610612760,OKC,10,212,32,67,0.478,2,15,0.133,18,22,0.818,16,24,40,24,8,0,6,9,84,111,4.0,1.33,2020,21,8.4,4.0,35,4,39,1.0256410256410255
2020-21,RegularSeason,1629010,428,Jerome Robinson,1610612764,WAS,17,305,28,95,0.295,11,42,0.262,16,20,0.8,4,34,38,25,12,6,19,31,83,74,1.32,0.63,2020,21,4.882352941176471,1.3157894736842106,67,4,71,0.5352112676056338
2020-21,RegularSeason,1629017,429,Khyri Thomas,1610612745,HOU,5,153,32,66,0.485,9,27,0.333,9,9,1.0,7,11,18,25,9,6,6,8,82,100,4.17,1.5,2020,21,16.4,4.166666666666667,34,0,34,0.5294117647058824
2020-21,RegularSeason,1630264,430,Anthony Gill,1610612764,WAS,26,218,30,60,0.5,7,24,0.292,13,16,0.813,16,35,51,11,10,4,8,27,80,115,1.38,1.25,2020,21,3.076923076923077,1.375,30,3,33,1.5454545454545454
2020-21,RegularSeason,1628966,431,Keita Bates-Diop,1610612759,SAS,30,245,30,67,0.448,5,17,0.294,14,21,0.667,9,40,49,12,11,5,7,11,79,105,1.71,1.57,2020,21,2.6333333333333333,1.7142857142857142,37,7,44,1.1136363636363635
2020-21,RegularSeason,1629067,432,Isaac Bonga,1610612764,WAS,40,432,30,81,0.37,13,47,0.277,5,8,0.625,18,48,66,23,11,9,22,63,78,111,1.04,0.5,2020,21,1.95,1.0454545454545454,51,3,54,1.2222222222222223
2020-21,RegularSeason,1629617,432,Reggie Perry,1610612751,BKN,26,211,32,78,0.41,4,21,0.19,10,13,0.769,27,46,73,14,6,6,15,40,78,113,0.93,0.4,2020,21,3.0,0.9333333333333333,46,3,49,1.489795918367347
2020-21,RegularSeason,1626188,434,Quinn Cook,1610612739,CLE,23,157,29,68,0.426,11,26,0.423,7,8,0.875,2,15,17,18,4,1,7,10,76,69,2.57,0.57,2020,21,3.3043478260869565,2.5714285714285716,39,1,40,0.425
2020-21,RegularSeason,203121,435,Darius Miller,1610612760,OKC,18,197,22,48,0.458,17,42,0.405,12,12,1.0,2,22,24,21,13,5,8,13,73,102,2.63,1.63,2020,21,4.055555555555555,2.625,26,0,26,0.9230769230769231
2020-21,RegularSeason,1629743,435,Donta Hall,1610612753,ORL,13,179,25,35,0.714,0,0,0.0,23,34,0.676,24,38,62,11,5,10,8,18,73,132,1.38,0.63,2020,21,5.615384615384615,1.375,10,11,21,2.9523809523809526
2020-21,RegularSeason,1627885,435,Shaquille Harrison,1610612743,DEN,34,332,26,78,0.333,3,16,0.188,18,22,0.818,7,41,48,25,17,5,11,33,73,101,2.27,1.54,2020,21,2.1470588235294117,2.272727272727273,52,4,56,0.8571428571428571
2020-21,RegularSeason,203953,438,Jabari Parker,1610612738,BOS,13,165,30,55,0.545,2,11,0.182,10,13,0.769,10,32,42,11,1,5,10,13,72,93,1.1,0.1,2020,21,5.538461538461538,1.1,25,3,28,1.5
2020-21,RegularSeason,1629117,438,Wenyen Gabriel,1610612740,NOP,21,241,24,60,0.4,13,32,0.406,11,17,0.647,20,34,54,11,9,8,15,32,72,97,0.73,0.6,2020,21,3.4285714285714284,0.7333333333333333,36,6,42,1.2857142857142858
2020-21,RegularSeason,1628383,440,Justin Patton,1610612745,HOU,13,247,29,70,0.414,9,34,0.265,3,4,0.75,14,35,49,14,12,14,4,34,70,113,3.5,3.0,2020,21,5.384615384615385,3.5,41,1,42,1.1666666666666667
2020-21,RegularSeason,1629626,441,Bol Bol,1610612743,DEN,32,160,25,58,0.431,9,24,0.375,10,15,0.667,0,24,24,7,3,10,13,14,69,62,0.54,0.23,2020,21,2.15625,0.5384615384615384,33,5,38,0.631578947368421
2020-21,RegularSeason,1629604,442,CJ Elleby,1610612757,POR,30,192,25,66,0.379,7,34,0.206,11,15,0.733,11,21,32,10,6,3,5,27,68,69,2.0,1.2,2020,21,2.2666666666666666,2.0,41,4,45,0.7111111111111111
2020-21,RegularSeason,101141,443,Ersan Ilyasova,1610612762,UTA,17,148,21,54,0.389,18,41,0.439,5,5,1.0,7,22,29,4,10,3,8,29,65,70,0.5,1.25,2020,21,3.823529411764706,0.5,33,0,33,0.8787878787878788
2020-21,RegularSeason,1629714,444,Jarrell Brantley,1610612762,UTA,28,138,25,52,0.481,12,28,0.429,2,2,1.0,9,18,27,15,7,2,8,17,64,80,1.88,0.88,2020,21,2.2857142857142856,1.875,27,0,27,1.0
2020-21,RegularSeason,203933,445,T.J. Warren,1610612754,IND,4,117,27,51,0.529,0,7,0.0,8,10,0.8,2,12,14,5,2,0,4,16,62,53,1.25,0.5,2020,21,15.5,1.25,24,2,26,0.5384615384615384
2020-21,RegularSeason,1629681,446,Killian Tillie,1610612763,MEM,18,182,19,57,0.333,10,33,0.303,9,11,0.818,6,18,24,8,5,8,2,20,57,60,4.0,2.5,2020,21,3.1666666666666665,4.0,38,2,40,0.6
2020-21,RegularSeason,1629648,447,Jordan Bone,1610612753,ORL,14,196,23,54,0.426,10,32,0.313,0,0,0.0,4,20,24,18,2,0,3,11,56,66,6.0,0.67,2020,21,4.0,6.0,31,0,31,0.7741935483870968
2020-21,RegularSeason,1629641,447,Romeo Langford,1610612738,BOS,18,283,21,59,0.356,5,18,0.278,9,12,0.75,12,23,35,13,6,5,10,24,56,64,1.3,0.6,2020,21,3.111111111111111,1.3,38,3,41,0.8536585365853658
2020-21,RegularSeason,1627812,447,Yogi Ferrell,1610612746,LAC,10,137,20,57,0.351,9,28,0.321,7,9,0.778,5,14,19,22,7,3,3,11,56,65,7.33,2.33,2020,21,5.6,7.333333333333333,37,2,39,0.48717948717948717
2020-21,RegularSeason,1630187,450,Daniel Oturu,1610612746,LAC,30,161,22,52,0.423,1,5,0.2,9,12,0.75,21,27,48,10,4,7,9,24,54,81,1.11,0.44,2020,21,1.8,1.1111111111111112,30,3,33,1.4545454545454546
2020-21,RegularSeason,1630188,451,Jalen Smith,1610612756,PHX,27,156,22,50,0.44,4,17,0.235,5,7,0.714,7,30,37,4,1,4,7,16,53,62,0.57,0.14,2020,21,1.962962962962963,0.5714285714285714,28,2,30,1.2333333333333334
2020-21,RegularSeason,1628981,452,Bruno Fernando,1610612737,ATL,33,226,18,44,0.409,0,2,0.0,15,22,0.682,16,62,78,10,4,3,21,23,51,92,0.48,0.19,2020,21,1.5454545454545454,0.47619047619047616,26,7,33,2.3636363636363638
2020-21,RegularSeason,1629751,453,Dakota Mathias,1610612755,PHI,8,123,19,48,0.396,8,26,0.308,2,6,0.333,1,6,7,13,1,3,1,7,48,38,13.0,1.0,2020,21,6.0,13.0,29,4,33,0.21212121212121213
2020-21,RegularSeason,202334,453,Ed Davis,1610612750,MIN,23,299,19,44,0.432,0,0,0.0,10,12,0.833,46,69,115,21,13,13,7,56,48,176,3.0,1.86,2020,21,2.0869565217391304,3.0,25,2,27,4.2592592592592595
2020-21,RegularSeason,1629605,455,Tacko Fall,1610612738,BOS,19,136,21,29,0.724,0,0,0.0,5,15,0.333,16,36,52,3,1,20,6,22,47,99,0.5,0.17,2020,21,2.473684210526316,0.5,8,10,18,2.888888888888889
2020-21,RegularSeason,1629683,456,Quinndary Weatherspoon,1610612759,SAS,20,121,16,35,0.457,1,6,0.167,13,16,0.813,3,8,11,8,8,2,10,18,46,43,0.8,0.8,2020,21,2.3,0.8,19,3,22,0.5
2020-21,RegularSeason,1630176,456,Vernon Carey Jr.,1610612766,CHA,19,115,18,36,0.5,1,7,0.143,9,11,0.818,6,21,27,2,1,5,5,13,46,56,0.4,0.2,2020,21,2.4210526315789473,0.4,18,2,20,1.35
2020-21,RegularSeason,1629663,458,Louis King,1610612758,SAC,6,85,17,34,0.5,4,11,0.364,6,6,1.0,5,13,18,9,7,3,4,9,44,60,2.25,1.75,2020,21,7.333333333333333,2.25,17,0,17,1.0588235294117647
2020-21,RegularSeason,1629603,458,Mamadi Diakite,1610612749,MIL,14,141,16,40,0.4,1,8,0.125,11,14,0.786,8,26,34,8,6,5,3,16,44,67,2.67,2.0,2020,21,3.142857142857143,2.6666666666666665,24,3,27,1.2592592592592593
2020-21,RegularSeason,1628419,460,Cameron Oliver,1610612745,HOU,4,87,19,33,0.576,4,13,0.308,1,4,0.25,5,16,21,5,2,4,3,11,43,55,1.67,0.67,2020,21,10.75,1.6666666666666667,14,3,17,1.2352941176470589
2020-21,RegularSeason,1629606,460,Robert Franks,1610612753,ORL,7,101,13,28,0.464,5,15,0.333,12,13,0.923,6,8,14,5,3,3,2,8,43,50,2.5,1.5,2020,21,6.142857142857143,2.5,15,1,16,0.875
2020-21,RegularSeason,1630216,462,Cassius Winston,1610612764,WAS,22,98,14,33,0.424,8,17,0.471,5,6,0.833,0,9,9,12,2,1,5,8,41,40,2.4,0.4,2020,21,1.8636363636363635,2.4,19,1,20,0.45
2020-21,RegularSeason,1629686,462,Deividas Sirvydis,1610612765,DET,20,133,14,40,0.35,10,28,0.357,3,6,0.5,0,29,29,5,2,0,5,9,41,43,1.0,0.4,2020,21,2.05,1.0,26,3,29,1.0
2020-21,RegularSeason,1630207,462,Nate Hinton,1610612742,DAL,21,93,15,42,0.357,4,19,0.211,7,10,0.7,1,8,9,8,7,2,5,8,41,32,1.6,1.4,2020,21,1.9523809523809523,1.6,27,3,30,0.3
2020-21,RegularSeason,1628414,462,Sindarius Thornwell,1610612753,ORL,21,217,15,46,0.326,7,23,0.304,4,8,0.5,3,15,18,21,13,2,7,15,41,53,3.0,1.86,2020,21,1.9523809523809523,3.0,31,4,35,0.5142857142857142
2020-21,RegularSeason,1629718,466,Charlie Brown Jr.,1610612760,OKC,9,152,13,43,0.302,5,21,0.238,9,10,0.9,3,14,17,9,4,2,6,19,40,35,1.5,0.67,2020,21,4.444444444444445,1.5,30,1,31,0.5483870967741935
2020-21,RegularSeason,1630186,466,Jahmi'us Ramsey,1610612758,SAC,13,94,15,38,0.395,5,19,0.263,5,5,1.0,2,8,10,6,4,1,3,8,40,35,2.0,1.33,2020,21,3.076923076923077,2.0,23,0,23,0.43478260869565216
2020-21,RegularSeason,1629719,468,Devontae Cacok,1610612747,LAL,20,98,17,29,0.586,0,0,0.0,5,11,0.455,12,20,32,1,5,4,5,8,39,58,0.2,1.0,2020,21,1.95,0.2,12,6,18,1.7777777777777777
2020-21,RegularSeason,1630253,468,Sean McDermott,1610612763,MEM,18,158,13,33,0.394,5,22,0.227,8,8,1.0,6,13,19,4,2,3,4,8,39,43,1.0,0.5,2020,21,2.1666666666666665,1.0,20,0,20,0.95
2020-21,RegularSeason,1630199,470,Cassius Stanley,1610612754,IND,24,93,13,43,0.302,3,13,0.231,7,9,0.778,8,12,20,1,1,2,1,14,36,27,1.0,1.0,2020,21,1.5,1.0,30,2,32,0.625
2020-21,RegularSeason,203521,470,Matthew Dellavedova,1610612739,CLE,13,224,14,56,0.25,4,25,0.16,4,4,1.0,6,18,24,58,4,1,6,21,36,75,9.67,0.67,2020,21,2.769230769230769,9.666666666666666,42,0,42,0.5714285714285714
2020-21,RegularSeason,1630206,472,Jay Scrubb,1610612746,LAC,4,84,14,36,0.389,2,9,0.222,5,5,1.0,2,12,14,1,4,0,7,5,35,25,0.14,0.57,2020,21,8.75,0.14285714285714285,22,0,22,0.6363636363636364
2020-21,RegularSeason,1629752,472,Juwan Morgan,1610612762,UTA,29,147,14,30,0.467,4,13,0.308,3,7,0.429,9,19,28,9,4,1,4,21,35,53,2.25,1.0,2020,21,1.206896551724138,2.25,16,4,20,1.4
2020-21,RegularSeason,1629962,474,Devin Cannady,1610612753,ORL,8,74,11,28,0.393,6,16,0.375,6,7,0.857,0,5,5,1,5,1,2,9,34,26,0.5,2.5,2020,21,4.25,0.5,17,1,18,0.2777777777777778
2020-21,RegularSeason,1629730,474,Rayjon Tucker,1610612755,PHI,14,68,9,18,0.5,2,7,0.286,14,19,0.737,1,10,11,6,2,0,4,8,34,35,1.5,0.5,2020,21,2.4285714285714284,1.5,9,5,14,0.7857142857142857
2020-21,RegularSeason,1629735,476,Chris Silva,1610612758,SAC,15,92,10,16,0.625,1,1,1.0,11,15,0.733,7,20,27,6,1,6,10,24,32,52,0.6,0.1,2020,21,2.1333333333333333,0.6,6,4,10,2.7
2020-21,RegularSeason,1630190,477,Elijah Hughes,1610612762,UTA,18,64,10,30,0.333,8,23,0.348,3,4,0.75,1,8,9,6,1,1,6,1,31,21,1.0,0.17,2020,21,1.7222222222222223,1.0,20,1,21,0.42857142857142855
2020-21,RegularSeason,1629066,477,Rodions Kurucs,1610612749,MIL,21,125,11,32,0.344,6,21,0.286,3,4,0.75,5,18,23,10,9,4,13,16,31,42,0.77,0.69,2020,21,1.4761904761904763,0.7692307692307693,21,1,22,1.0454545454545454
2020-21,RegularSeason,1627748,479,Thon Maker,1610612739,CLE,8,76,10,18,0.556,0,2,0.0,10,11,0.909,8,10,18,4,2,4,3,7,30,46,1.33,0.67,2020,21,3.75,1.3333333333333333,8,1,9,2.0
2020-21,RegularSeason,1629346,480,Alen Smailagic,1610612744,GSW,15,84,11,27,0.407,4,10,0.4,2,6,0.333,6,10,16,4,3,5,5,11,28,31,0.8,0.6,2020,21,1.8666666666666667,0.8,16,4,20,0.8
2020-21,RegularSeason,1626178,481,Rondae Hollis-Jefferson,1610612757,POR,11,107,9,18,0.5,0,1,0.0,9,16,0.563,11,15,26,13,2,4,2,15,27,54,6.5,1.0,2020,21,2.4545454545454546,6.5,9,7,16,1.625
2020-21,RegularSeason,1628412,482,Frank Mason III,1610612753,ORL,4,79,9,24,0.375,2,5,0.4,5,7,0.714,3,9,12,12,0,0,5,7,25,27,2.4,0.0,2020,21,6.25,2.4,15,2,17,0.7058823529411765
2020-21,RegularSeason,1627780,482,Gary Payton II,1610612744,GSW,10,40,10,13,0.769,2,4,0.5,3,4,0.75,2,9,11,1,6,1,1,8,25,39,1.0,6.0,2020,21,2.5,1.0,3,1,4,2.75
2020-21,RegularSeason,1626245,484,Cristiano Felicio,1610612741,CHI,18,84,7,13,0.538,0,2,0.0,9,16,0.563,10,16,26,9,4,0,4,10,23,45,2.25,1.0,2020,21,1.2777777777777777,2.25,6,7,13,2.0
2020-21,RegularSeason,203957,484,Dante Exum,1610612745,HOU,6,116,10,26,0.385,2,11,0.182,1,2,0.5,2,15,17,13,4,2,7,9,23,35,1.86,0.57,2020,21,3.8333333333333335,1.8571428571428572,16,1,17,1.0
2020-21,RegularSeason,1629653,484,Devon Dotson,1610612741,CHI,11,50,11,21,0.524,1,7,0.143,0,0,0.0,2,3,5,7,4,0,0,3,23,29,0.0,0.0,2020,21,2.090909090909091,inf,10,0,10,0.5
2020-21,RegularSeason,202738,484,Isaiah Thomas,1610612740,NOP,3,48,9,27,0.333,3,12,0.25,2,2,1.0,1,3,4,5,1,0,6,3,23,9,0.83,0.17,2020,21,7.666666666666667,0.8333333333333334,18,0,18,0.2222222222222222
2020-21,RegularSeason,1629725,488,Jeremiah Martin,1610612739,CLE,9,75,9,33,0.273,3,12,0.25,1,5,0.2,2,5,7,4,5,2,6,1,22,6,0.67,0.83,2020,21,2.4444444444444446,0.6666666666666666,24,4,28,0.25
2020-21,RegularSeason,1629007,488,Jontay Porter,1610612763,MEM,11,54,8,15,0.533,3,8,0.375,3,5,0.6,4,10,14,1,3,1,7,12,22,25,0.14,0.43,2020,21,2.0,0.14285714285714285,7,2,9,1.5555555555555556
2020-21,RegularSeason,1629620,490,Justin Robinson,1610612760,OKC,9,88,7,21,0.333,4,14,0.286,3,5,0.6,1,6,7,9,3,0,2,10,21,22,4.5,1.5,2020,21,2.3333333333333335,4.5,14,2,16,0.4375
2020-21,RegularSeason,203658,491,Norvel Pelle,1610612752,NYK,13,83,8,15,0.533,0,0,0.0,4,6,0.667,6,13,19,2,1,9,3,14,20,39,0.67,0.33,2020,21,1.5384615384615385,0.6666666666666666,7,2,9,2.111111111111111
2020-21,RegularSeason,1630218,491,Robert Woodard II,1610612758,SAC,13,45,8,20,0.4,1,6,0.167,3,8,0.375,4,12,16,2,0,3,1,4,20,23,2.0,0.0,2020,21,1.5384615384615385,2.0,12,5,17,0.9411764705882353
2020-21,RegularSeason,203915,491,Spencer Dinwiddie,1610612751,BKN,3,64,6,16,0.375,2,7,0.286,6,6,1.0,0,13,13,9,2,1,5,4,20,30,1.8,0.4,2020,21,6.666666666666667,1.8,10,0,10,1.3
2020-21,RegularSeason,1630203,494,Grant Riller,1610612766,CHA,7,27,8,12,0.667,2,4,0.5,0,0,0.0,0,1,1,3,1,0,1,0,18,18,3.0,1.0,2020,21,2.5714285714285716,3.0,4,0,4,0.25
2020-21,RegularSeason,1630189,494,Tyler Bey,1610612742,DAL,18,71,7,22,0.318,1,4,0.25,3,5,0.6,8,11,19,3,0,1,3,6,18,21,1.0,0.0,2020,21,1.0,1.0,15,2,17,1.1176470588235294
2020-21,RegularSeason,201229,496,Anthony Tolliver,1610612755,PHI,11,99,4,17,0.235,4,14,0.286,5,6,0.833,3,7,10,2,3,2,3,7,17,17,0.67,1.0,2020,21,1.5454545454545454,0.6666666666666666,13,1,14,0.7142857142857143
2020-21,RegularSeason,203998,496,Bruno Caboclo,1610612745,HOU,6,36,8,17,0.471,0,5,0.0,1,2,0.5,3,11,14,1,0,2,4,6,17,20,0.25,0.0,2020,21,2.8333333333333335,0.25,9,1,10,1.4
2020-21,RegularSeason,1629091,498,Elijah Bryant,1610612749,MIL,1,32,6,13,0.462,1,5,0.2,3,3,1.0,2,4,6,3,0,1,4,4,16,15,0.75,0.0,2020,21,16.0,0.75,7,0,7,0.8571428571428571
2020-21,RegularSeason,1628962,498,Udoka Azubuike,1610612762,UTA,15,57,4,9,0.444,0,0,0.0,8,10,0.8,4,9,13,0,1,4,3,9,16,24,0.0,0.33,2020,21,1.0666666666666667,0.0,5,2,7,1.8571428571428572
2020-21,RegularSeason,1629690,500,Adam Mokoka,1610612741,CHI,14,56,7,19,0.368,1,10,0.1,0,1,0.0,1,4,5,5,2,1,5,5,15,10,1.0,0.4,2020,21,1.0714285714285714,1.0,12,1,13,0.38461538461538464
2020-21,RegularSeason,1629244,500,Cam Reynolds,1610612745,HOU,5,40,6,18,0.333,3,12,0.25,0,0,0.0,2,3,5,2,0,0,0,2,15,10,0.0,0.0,2020,21,3.0,inf,12,0,12,0.4166666666666667
2020-21,RegularSeason,1627740,500,Henry Ellenson,1610612761,TOR,2,38,5,14,0.357,2,9,0.222,3,4,0.75,3,9,12,5,0,0,0,7,15,22,0.0,0.0,2020,21,7.5,inf,9,1,10,1.2
2020-21,RegularSeason,203263,500,James Nunnally,1610612740,NOP,9,48,5,13,0.385,4,12,0.333,1,2,0.5,2,7,9,3,0,0,2,1,15,16,1.5,0.0,2020,21,1.6666666666666667,1.5,8,1,9,1.0
2020-21,RegularSeason,1628395,500,Jordan Bell,1610612744,GSW,6,82,7,22,0.318,0,2,0.0,1,2,0.5,7,17,24,7,3,5,4,7,15,34,1.75,0.75,2020,21,2.5,1.75,15,1,16,1.5
2020-21,RegularSeason,1630208,500,Nick Richards,1610612766,CHA,18,63,4,9,0.444,0,1,0.0,7,11,0.636,4,7,11,2,0,0,3,7,15,16,0.67,0.0,2020,21,0.8333333333333334,0.6666666666666666,5,4,9,1.2222222222222223
2020-21,RegularSeason,1626253,506,Axel Toupane,1610612749,MIL,8,61,4,11,0.364,1,2,0.5,5,7,0.714,0,6,6,4,2,3,0,6,14,20,0.0,0.0,2020,21,1.75,inf,7,2,9,0.6666666666666666
2020-21,RegularSeason,1628578,507,Amida Brimah,1610612754,IND,5,29,5,8,0.625,0,0,0.0,3,3,1.0,2,6,8,1,0,5,4,4,13,20,0.25,0.0,2020,21,2.6,0.25,3,0,3,2.6666666666666665
2020-21,RegularSeason,2760,507,Anderson Varejao,1610612739,CLE,5,36,4,16,0.25,0,1,0.0,5,9,0.556,7,13,20,3,0,2,1,3,13,21,3.0,0.0,2020,21,2.6,3.0,12,4,16,1.25
2020-21,RegularSeason,1627737,507,Marquese Chriss,1610612744,GSW,2,27,5,14,0.357,1,5,0.2,2,4,0.5,3,10,13,2,0,2,2,3,13,17,1.0,0.0,2020,21,6.5,1.0,9,2,11,1.1818181818181819
2020-21,RegularSeason,1629833,510,Keljin Blevins,1610612757,POR,17,75,5,20,0.25,2,8,0.25,0,0,0.0,3,7,10,4,2,0,5,8,12,8,0.8,0.4,2020,21,0.7058823529411765,0.8,15,0,15,0.6666666666666666
2020-21,RegularSeason,1628961,510,Kostas Antetokounmpo,1610612747,LAL,15,56,3,10,0.3,0,0,0.0,6,13,0.462,4,15,19,1,2,4,11,8,12,13,0.09,0.18,2020,21,0.8,0.09090909090909091,7,7,14,1.3571428571428572
2020-21,RegularSeason,1628388,510,T.J. Leaf,1610612757,POR,7,35,5,10,0.5,0,0,0.0,2,2,1.0,0,5,5,1,2,1,2,1,12,14,0.5,1.0,2020,21,1.7142857142857142,0.5,5,0,5,1.0
2020-21,RegularSeason,1630211,513,Karim Mane,1610612753,ORL,10,88,3,13,0.231,1,2,0.5,4,5,0.8,1,13,14,4,0,2,3,10,11,17,1.33,0.0,2020,21,1.1,1.3333333333333333,10,1,11,1.2727272727272727
2020-21,RegularSeason,1630179,513,Tyrell Terry,1610612742,DAL,11,56,5,16,0.313,0,7,0.0,1,3,0.333,0,6,6,6,5,0,2,2,11,13,3.0,2.5,2020,21,1.0,3.0,11,2,13,0.46153846153846156
2020-21,RegularSeason,203086,515,Meyers Leonard,1610612748,MIA,3,29,3,7,0.429,3,7,0.429,1,2,0.5,0,7,7,2,0,0,2,5,10,12,1.0,0.0,2020,21,3.3333333333333335,1.0,4,1,5,1.4
2020-21,RegularSeason,1630268,516,Nate Darling,1610612766,CHA,7,26,2,7,0.286,2,7,0.286,3,3,1.0,1,0,1,1,0,1,1,1,9,6,1.0,0.0,2020,21,1.2857142857142858,1.0,5,0,5,0.2
2020-21,RegularSeason,1630234,516,Ty-Shon Alexander,1610612756,PHX,15,47,3,12,0.25,2,9,0.222,1,2,0.5,2,8,10,6,0,1,3,2,9,13,2.0,0.0,2020,21,0.6,2.0,9,1,10,1.0
2020-21,RegularSeason,1629712,518,Didi Louzada,1610612740,NOP,3,56,3,13,0.231,2,8,0.25,0,0,0.0,1,2,3,3,2,0,3,5,8,3,1.0,0.67,2020,21,2.6666666666666665,1.0,10,0,10,0.3
2020-21,RegularSeason,204025,518,Tim Frazier,1610612763,MEM,5,62,3,20,0.15,0,8,0.0,2,6,0.333,0,8,8,16,2,1,4,7,8,10,4.0,0.5,2020,21,1.6,4.0,17,4,21,0.38095238095238093
2020-21,RegularSeason,1629738,518,Vincent Poirier,1610612755,PHI,10,39,3,12,0.25,0,1,0.0,2,6,0.333,6,8,14,2,0,3,4,8,8,10,0.5,0.0,2020,21,0.8,0.5,9,4,13,1.0769230769230769
2020-21,RegularSeason,1629716,521,Marques Bolden,1610612739,CLE,6,29,1,3,0.333,0,0,0.0,5,8,0.625,3,3,6,0,2,2,2,0,7,10,0.0,1.0,2020,21,1.1666666666666667,0.0,2,3,5,1.2
2020-21,RegularSeason,203460,522,Andre Roberson,1610612751,BKN,5,63,2,14,0.143,1,8,0.125,1,2,0.5,7,8,15,4,3,1,2,4,6,14,2.0,1.5,2020,21,1.2,2.0,12,1,13,1.1538461538461537
2020-21,RegularSeason,201162,522,Jared Dudley,1610612747,LAL,12,81,2,9,0.222,2,6,0.333,0,0,0.0,4,17,21,5,1,1,2,7,6,25,2.5,0.5,2020,21,0.5,2.5,7,0,7,3.0
2020-21,RegularSeason,1629665,524,Jalen Lecque,1610612754,IND,4,12,1,9,0.111,0,1,0.0,3,3,1.0,2,3,5,2,0,0,0,0,5,4,0.0,0.0,2020,21,1.25,inf,8,0,8,0.625
2020-21,RegularSeason,1627739,524,Kris Dunn,1610612737,ATL,4,45,1,12,0.083,0,2,0.0,3,4,0.75,0,6,6,2,2,2,3,10,5,2,0.67,0.67,2020,21,1.25,0.6666666666666666,11,1,12,0.5
2020-21,RegularSeason,1627775,524,Patrick McCaw,1610612761,TOR,5,33,1,1,1.0,0,0,0.0,3,3,1.0,1,2,3,4,2,0,0,6,5,14,0.0,0.0,2020,21,1.0,inf,0,0,0,inf
2020-21,RegularSeason,1629034,527,Ray Spalding,1610612745,HOU,2,19,2,4,0.5,0,1,0.0,0,2,0.0,2,2,4,0,0,2,3,3,4,3,0.0,0.0,2020,21,2.0,0.0,2,2,4,1.0
2020-21,RegularSeason,2617,527,Udonis Haslem,1610612748,MIA,1,3,2,2,1.0,0,0,0.0,0,0,0.0,0,1,1,0,0,0,0,0,4,5,0.0,0.0,2020,21,4.0,,0,0,0,inf
2020-21,RegularSeason,1628968,529,Brian Bowen II,1610612754,IND,6,15,1,4,0.25,0,1,0.0,1,1,1.0,0,3,3,0,0,0,0,1,3,3,0.0,0.0,2020,21,0.5,,3,0,3,1.0
2020-21,RegularSeason,1629607,529,Jared Harper,1610612752,NYK,8,16,0,4,0.0,0,1,0.0,3,4,0.75,0,2,2,1,0,0,3,1,3,-2,0.33,0.0,2020,21,0.375,0.3333333333333333,4,1,5,0.4
2020-21,RegularSeason,1630238,529,Malik Fitts,1610612746,LAC,3,11,1,3,0.333,1,2,0.5,0,0,0.0,0,3,3,0,0,0,0,3,3,4,0.0,0.0,2020,21,1.0,,2,0,2,1.5
2020-21,RegularSeason,202697,532,Iman Shumpert,1610612751,BKN,2,11,1,4,0.25,0,3,0.0,0,0,0.0,1,0,1,0,1,0,1,0,2,0,0.0,1.0,2020,21,1.0,0.0,3,0,3,0.3333333333333333
2020-21,RegularSeason,1629121,532,Jaylen Adams,1610612749,MIL,7,18,1,8,0.125,0,2,0.0,0,0,0.0,0,3,3,2,0,0,0,1,2,0,0.0,0.0,2020,21,0.2857142857142857,inf,7,0,7,0.42857142857142855
2020-21,RegularSeason,1628390,532,Terrance Ferguson,1610612755,PHI,13,49,1,7,0.143,0,5,0.0,0,0,0.0,0,1,1,2,1,0,4,7,2,-4,0.5,0.25,2020,21,0.15384615384615385,0.5,6,0,6,0.16666666666666666
2020-21,RegularSeason,1629033,532,Theo Pinson,1610612752,NYK,17,34,1,9,0.111,0,8,0.0,0,0,0.0,0,5,5,1,0,0,1,4,2,-1,1.0,0.0,2020,21,0.11764705882352941,1.0,8,0,8,0.625
2020-21,RegularSeason,1628394,536,Anzejs Pasecniks,1610612764,WAS,1,6,0,1,0.0,0,1,0.0,0,0,0.0,1,0,1,1,0,0,5,2,0,-4,0.2,0.0,2020,21,0.0,0.2,1,0,1,1.0
2020-21,RegularSeason,1630204,536,Ashton Hagans,1610612750,MIN,2,4,0,0,0.0,0,0,0.0,0,0,0.0,0,0,0,0,0,0,1,0,0,-1,0.0,0.0,2020,21,0.0,0.0,0,0,0,
2020-21,RegularSeason,204222,536,Greg Whittington,1610612743,DEN,4,12,0,3,0.0,0,2,0.0,0,0,0.0,0,0,0,0,0,0,0,0,0,-3,0.0,0.0,2020,21,0.0,,3,0,3,0.0
2020-21,RegularSeason,203943,536,Noah Vonleh,1610612751,BKN,4,11,0,3,0.0,0,2,0.0,0,0,0.0,0,1,1,1,0,0,2,2,0,-3,0.5,0.0,2020,21,0.0,0.5,3,0,3,0.3333333333333333
2020-21,RegularSeason,1630266,536,Will Magnay,1610612740,NOP,1,3,0,1,0.0,0,1,0.0,0,0,0.0,0,0,0,0,0,0,1,1,0,-2,0.0,0.0,2020,21,0.0,0.0,1,0,1,0.0
2020-21,Playoffs,203507,1,Giannis Antetokounmpo,1610612749,MIL,21,800,250,439,0.569,13,70,0.186,121,206,0.587,59,210,269,108,21,25,64,61,634,719,1.69,0.33,2020,21,30.19047619047619,1.6875,189,85,274,0.9817518248175182
2020-21,Playoffs,1626164,2,Devin Booker,1610612756,PHX,22,888,212,474,0.447,44,137,0.321,133,147,0.905,15,109,124,100,18,4,81,76,601,490,1.24,0.22,2020,21,27.318181818181817,1.2345679012345678,262,14,276,0.4492753623188406
2020-21,Playoffs,203114,3,Khris Middleton,1610612749,MIL,23,922,198,452,0.438,60,175,0.343,86,97,0.887,25,149,174,118,35,4,74,58,542,534,1.59,0.47,2020,21,23.565217391304348,1.5945945945945945,254,11,265,0.6566037735849056
2020-21,Playoffs,202331,4,Paul George,1610612746,LAC,19,776,165,374,0.441,51,152,0.336,130,154,0.844,17,166,183,102,19,10,67,59,511,525,1.52,0.28,2020,21,26.894736842105264,1.5223880597014925,209,24,233,0.7854077253218884
2020-21,Playoffs,1629027,5,Trae Young,1610612737,ATL,16,603,150,359,0.418,45,144,0.313,116,134,0.866,7,38,45,152,20,0,64,35,461,387,2.38,0.31,2020,21,28.8125,2.375,209,18,227,0.19823788546255505
2020-21,Playoffs,201142,6,Kevin Durant,1610612751,BKN,12,485,145,282,0.514,33,82,0.402,88,101,0.871,5,106,111,53,18,19,42,31,411,420,1.26,0.43,2020,21,34.25,1.2619047619047619,137,13,150,0.74
2020-21,Playoffs,201950,7,Jrue Holiday,1610612749,MIL,23,912,158,389,0.406,43,142,0.303,40,56,0.714,32,100,132,199,38,10,56,48,399,475,3.55,0.68,2020,21,17.347826086956523,3.5535714285714284,231,16,247,0.5344129554655871
2020-21,Playoffs,101108,8,Chris Paul,1610612756,PHX,20,683,149,300,0.497,29,65,0.446,57,65,0.877,9,61,70,171,23,3,43,48,384,449,3.98,0.54,2020,21,19.2,3.9767441860465116,151,8,159,0.44025157232704404
2020-21,Playoffs,1629028,9,Deandre Ayton,1610612756,PHX,22,801,154,234,0.658,0,0,0.0,39,53,0.736,67,193,260,25,18,24,28,63,347,552,0.89,0.64,2020,21,15.772727272727273,0.8928571428571429,80,14,94,2.765957446808511
2020-21,Playoffs,202704,10,Reggie Jackson,1610612746,LAC,19,622,122,252,0.484,58,142,0.408,36,41,0.878,7,53,60,65,18,3,28,49,338,321,2.32,0.64,2020,21,17.789473684210527,2.3214285714285716,130,5,135,0.4444444444444444
2020-21,Playoffs,202695,11,Kawhi Leonard,1610612746,LAC,11,432,122,213,0.573,24,61,0.393,66,75,0.88,22,63,85,48,23,9,24,29,334,375,2.0,0.96,2020,21,30.363636363636363,2.0,91,9,100,0.85
2020-21,Playoffs,1628378,12,Donovan Mitchell,1610612762,UTA,10,346,105,235,0.447,50,115,0.435,63,76,0.829,3,39,42,55,11,2,28,20,323,262,1.96,0.39,2020,21,32.3,1.9642857142857142,130,13,143,0.2937062937062937
2020-21,Playoffs,203954,13,Joel Embiid,1610612755,PHI,11,357,101,197,0.513,16,41,0.39,91,109,0.835,16,100,116,37,11,16,42,33,309,333,0.88,0.26,2020,21,28.09090909090909,0.8809523809523809,96,18,114,1.0175438596491229
2020-21,Playoffs,201572,14,Brook Lopez,1610612749,MIL,23,667,119,217,0.548,23,72,0.319,37,43,0.86,48,87,135,6,17,34,25,48,298,361,0.24,0.68,2020,21,12.956521739130435,0.24,98,6,104,1.2980769230769231
2020-21,Playoffs,203999,14,Nikola Jokic,1610612743,DEN,10,345,116,228,0.509,20,53,0.377,46,55,0.836,37,79,116,50,6,9,24,23,298,334,2.08,0.25,2020,21,29.8,2.0833333333333335,112,9,121,0.9586776859504132
2020-21,Playoffs,202699,16,Tobias Harris,1610612755,PHI,12,438,105,215,0.488,16,43,0.372,35,40,0.875,10,92,102,42,12,5,18,29,261,289,2.33,0.67,2020,21,21.75,2.3333333333333335,110,5,115,0.8869565217391304
2020-21,Playoffs,203992,17,Bogdan Bogdanovic,1610612737,ATL,18,598,97,249,0.39,47,143,0.329,12,17,0.706,11,64,75,52,29,5,27,50,253,230,1.93,1.07,2020,21,14.055555555555555,1.9259259259259258,152,5,157,0.47770700636942676
2020-21,Playoffs,1628381,18,John Collins,1610612737,ATL,18,576,100,182,0.549,20,56,0.357,30,36,0.833,36,121,157,16,8,11,23,59,250,331,0.7,0.35,2020,21,13.88888888888889,0.6956521739130435,82,6,88,1.7840909090909092
2020-21,Playoffs,1629029,18,Luka Doncic,1610612742,DAL,7,281,96,196,0.49,31,76,0.408,27,51,0.529,4,51,55,72,9,3,32,17,250,233,2.25,0.28,2020,21,35.714285714285715,2.25,100,24,124,0.4435483870967742
2020-21,Playoffs,1628969,20,Mikal Bridges,1610612756,PHX,22,707,92,190,0.484,35,95,0.368,25,28,0.893,20,74,94,36,22,15,16,41,244,294,2.25,1.38,2020,21,11.090909090909092,2.25,98,3,101,0.9306930693069307
2020-21,Playoffs,203109,21,Jae Crowder,1610612756,PHX,22,729,76,184,0.413,54,142,0.38,31,35,0.886,10,124,134,41,19,18,19,67,237,318,2.16,1.0,2020,21,10.772727272727273,2.1578947368421053,108,4,112,1.1964285714285714
2020-21,Playoffs,202694,22,Marcus Morris Sr.,1610612746,LAC,19,604,86,200,0.43,36,96,0.375,24,32,0.75,13,68,81,28,10,10,7,49,232,232,4.0,1.43,2020,21,12.210526315789474,4.0,114,8,122,0.6639344262295082
2020-21,Playoffs,201568,23,Danilo Gallinari,1610612737,ATL,18,442,74,174,0.425,34,84,0.405,49,52,0.942,8,62,70,14,6,3,15,46,231,206,0.93,0.4,2020,21,12.833333333333334,0.9333333333333333,100,3,103,0.6796116504854369
2020-21,Playoffs,203552,24,Seth Curry,1610612755,PHI,12,381,85,147,0.578,41,81,0.506,15,19,0.789,4,24,28,28,9,3,10,33,226,218,2.8,0.9,2020,21,18.833333333333332,2.8,62,4,66,0.42424242424242425
2020-21,Playoffs,203081,25,Damian Lillard,1610612757,POR,6,248,62,134,0.463,35,78,0.449,47,50,0.94,1,25,26,61,6,4,13,9,206,215,4.69,0.46,2020,21,34.333333333333336,4.6923076923076925,72,3,75,0.3466666666666667
2020-21,Playoffs,1626166,26,Cameron Payne,1610612756,PHX,22,418,82,193,0.425,25,69,0.362,16,18,0.889,6,49,55,70,17,11,24,39,205,221,2.92,0.71,2020,21,9.318181818181818,2.9166666666666665,111,2,113,0.48672566371681414
2020-21,Playoffs,202681,27,Kyrie Irving,1610612751,BKN,9,325,77,163,0.472,24,65,0.369,26,28,0.929,12,40,52,31,9,5,11,19,204,202,2.82,0.82,2020,21,22.666666666666668,2.8181818181818183,86,2,88,0.5909090909090909
2020-21,Playoffs,202711,28,Bojan Bogdanovic,1610612762,UTA,11,390,64,137,0.467,35,76,0.461,36,41,0.878,6,41,47,16,10,0,23,27,199,171,0.7,0.43,2020,21,18.09090909090909,0.6956521739130435,73,5,78,0.6025641025641025
2020-21,Playoffs,1628989,28,Kevin Huerter,1610612737,ATL,18,558,77,180,0.428,33,95,0.347,12,17,0.706,11,58,69,51,14,16,19,49,199,222,2.68,0.74,2020,21,11.055555555555555,2.6842105263157894,103,5,108,0.6388888888888888
2020-21,Playoffs,203903,30,Jordan Clarkson,1610612762,UTA,11,298,67,165,0.406,34,97,0.351,25,26,0.962,6,28,34,17,7,3,23,15,193,132,0.74,0.3,2020,21,17.545454545454547,0.7391304347826086,98,1,99,0.3434343434343434
2020-21,Playoffs,201935,31,James Harden,1610612751,BKN,9,322,51,108,0.472,24,66,0.364,56,62,0.903,7,50,57,77,15,6,26,23,182,248,2.96,0.58,2020,21,20.22222222222222,2.9615384615384617,57,6,63,0.9047619047619048
2020-21,Playoffs,203991,32,Clint Capela,1610612737,ATL,18,569,82,136,0.603,0,0,0.0,17,39,0.436,61,140,201,17,12,19,18,46,181,336,0.94,0.67,2020,21,10.055555555555555,0.9444444444444444,54,22,76,2.6447368421052633
2020-21,Playoffs,1626171,33,Bobby Portis,1610612749,MIL,20,366,70,151,0.464,18,52,0.346,18,25,0.72,33,67,100,12,14,7,9,31,176,212,1.33,1.56,2020,21,8.8,1.3333333333333333,81,7,88,1.1363636363636365
2020-21,Playoffs,1629008,34,Michael Porter Jr.,1610612743,DEN,10,332,64,135,0.474,29,73,0.397,17,21,0.81,12,50,62,13,11,3,16,31,174,172,0.81,0.69,2020,21,17.4,0.8125,71,4,75,0.8266666666666667
2020-21,Playoffs,1629661,35,Cameron Johnson,1610612756,PHX,21,443,55,110,0.5,33,74,0.446,29,32,0.906,16,50,66,16,19,4,15,28,172,204,1.07,1.27,2020,21,8.19047619047619,1.0666666666666667,55,3,58,1.1379310344827587
2020-21,Playoffs,203497,36,Rudy Gobert,1610612762,UTA,11,376,60,81,0.741,0,1,0.0,42,66,0.636,43,92,135,9,6,23,17,46,162,273,0.53,0.35,2020,21,14.727272727272727,0.5294117647058824,21,24,45,3.0
2020-21,Playoffs,1626192,37,Pat Connaughton,1610612749,MIL,23,546,55,119,0.462,37,95,0.389,11,13,0.846,29,72,101,20,10,6,12,38,158,217,1.67,0.83,2020,21,6.869565217391305,1.6666666666666667,64,2,66,1.5303030303030303
2020-21,Playoffs,1628369,38,Jayson Tatum,1610612738,BOS,5,185,47,111,0.423,14,36,0.389,45,49,0.918,3,26,29,23,6,8,13,15,153,138,1.77,0.46,2020,21,30.6,1.7692307692307692,64,4,68,0.4264705882352941
2020-21,Playoffs,201587,38,Nicolas Batum,1610612746,LAC,19,555,53,109,0.486,28,72,0.389,19,23,0.826,19,86,105,39,24,10,6,26,153,265,6.5,4.0,2020,21,8.052631578947368,6.5,56,4,60,1.75
2020-21,Playoffs,1629630,40,Ja Morant,1610612763,MEM,5,203,55,113,0.487,10,31,0.323,31,40,0.775,7,17,24,41,2,0,17,9,151,134,2.41,0.12,2020,21,30.2,2.411764705882353,58,9,67,0.3582089552238806
2020-21,Playoffs,203078,41,Bradley Beal,1610612764,WAS,5,195,56,123,0.455,7,32,0.219,31,36,0.861,6,25,31,21,4,3,20,6,150,117,1.05,0.2,2020,21,30.0,1.05,67,5,72,0.4305555555555556
2020-21,Playoffs,1629611,42,Terance Mann,1610612746,LAC,19,378,54,104,0.519,16,37,0.432,20,28,0.714,17,35,52,14,10,5,4,41,144,163,3.5,2.5,2020,21,7.578947368421052,3.5,50,8,58,0.896551724137931
2020-21,Playoffs,1627732,43,Ben Simmons,1610612755,PHI,12,402,59,95,0.621,0,1,0.0,25,73,0.342,25,70,95,106,15,10,27,39,143,258,3.93,0.56,2020,21,11.916666666666666,3.925925925925926,36,48,84,1.130952380952381
2020-21,Playoffs,2544,44,LeBron James,1610612747,LAL,6,224,54,114,0.474,18,48,0.375,14,23,0.609,7,36,43,48,9,2,25,7,140,148,1.92,0.36,2020,21,23.333333333333332,1.92,60,9,69,0.6231884057971014
2020-21,Playoffs,101150,45,Lou Williams,1610612737,ATL,18,277,50,110,0.455,13,30,0.433,26,27,0.963,2,24,26,39,12,1,22,16,139,134,1.77,0.55,2020,21,7.722222222222222,1.7727272727272727,60,1,61,0.4262295081967213
2020-21,Playoffs,1628420,46,Monte Morris,1610612743,DEN,10,286,50,116,0.431,16,40,0.4,21,29,0.724,7,17,24,55,10,2,7,12,137,147,7.86,1.43,2020,21,13.7,7.857142857142857,66,8,74,0.32432432432432434
2020-21,Playoffs,203925,47,Joe Harris,1610612751,BKN,12,434,49,123,0.398,33,82,0.402,3,4,0.75,5,38,43,19,4,2,9,34,134,118,2.11,0.44,2020,21,11.166666666666666,2.111111111111111,74,1,75,0.5733333333333334
2020-21,Playoffs,1627854,48,Bryn Forbes,1610612749,MIL,20,273,46,112,0.411,33,89,0.371,6,8,0.75,2,26,28,6,2,2,7,16,131,94,0.86,0.29,2020,21,6.55,0.8571428571428571,66,2,68,0.4117647058823529
2020-21,Playoffs,1628415,49,Dillon Brooks,1610612763,MEM,5,175,50,97,0.515,8,20,0.4,21,26,0.808,5,16,21,11,7,2,9,17,129,109,1.22,0.78,2020,21,25.8,1.2222222222222223,47,5,52,0.40384615384615385
2020-21,Playoffs,203468,50,CJ McCollum,1610612757,POR,6,240,50,114,0.439,14,42,0.333,10,13,0.769,6,30,36,26,2,4,12,25,124,113,2.17,0.17,2020,21,20.666666666666668,2.1666666666666665,64,3,67,0.5373134328358209
2020-21,Playoffs,1626220,50,Royce O'Neale,1610612762,UTA,11,404,43,85,0.506,28,60,0.467,10,12,0.833,16,64,80,23,12,3,8,41,124,190,2.88,1.5,2020,21,11.272727272727273,2.875,42,2,44,1.8181818181818181
2020-21,Playoffs,203501,52,Tim Hardaway Jr.,1610612742,DAL,7,262,42,101,0.416,23,57,0.404,12,16,0.75,5,18,23,10,3,0,6,17,119,86,1.67,0.5,2020,21,17.0,1.6666666666666667,59,4,63,0.36507936507936506
2020-21,Playoffs,204060,53,Joe Ingles,1610612762,UTA,11,306,39,79,0.494,24,58,0.414,10,13,0.769,1,33,34,38,7,0,9,19,112,139,4.22,0.78,2020,21,10.181818181818182,4.222222222222222,40,3,43,0.7906976744186046
2020-21,Playoffs,203932,54,Aaron Gordon,1610612743,DEN,10,299,43,99,0.434,9,23,0.391,16,25,0.64,21,33,54,20,5,3,14,23,111,114,1.43,0.36,2020,21,11.1,1.4285714285714286,56,9,65,0.8307692307692308
2020-21,Playoffs,201933,55,Blake Griffin,1610612751,BKN,12,318,42,79,0.532,14,36,0.389,10,14,0.714,15,56,71,21,10,6,5,40,108,170,4.2,2.0,2020,21,9.0,4.2,37,4,41,1.7317073170731707
2020-21,Playoffs,1627826,56,Ivica Zubac,1610612746,LAC,17,301,34,57,0.596,0,0,0.0,39,49,0.796,43,56,99,7,2,12,16,33,107,178,0.44,0.13,2020,21,6.294117647058823,0.4375,23,10,33,3.0
2020-21,Playoffs,1626181,57,Norman Powell,1610612757,POR,6,216,38,76,0.5,10,26,0.385,16,18,0.889,3,10,13,12,5,6,7,17,102,91,1.71,0.71,2020,21,17.0,1.7142857142857142,38,2,40,0.325
2020-21,Playoffs,200782,58,P.J. Tucker,1610612749,MIL,23,681,38,98,0.388,19,59,0.322,3,4,0.75,48,63,111,25,22,3,10,77,98,188,2.5,2.2,2020,21,4.260869565217392,2.5,60,1,61,1.819672131147541
2020-21,Playoffs,201565,59,Derrick Rose,1610612752,NYK,5,175,40,84,0.476,8,17,0.471,9,9,1.0,4,16,20,25,2,1,8,5,97,93,3.13,0.25,2020,21,19.4,3.125,44,0,44,0.45454545454545453
2020-21,Playoffs,1628971,60,Bruce Brown,1610612751,BKN,12,277,40,79,0.506,2,11,0.182,13,16,0.813,23,38,61,25,8,5,11,31,95,141,2.27,0.73,2020,21,7.916666666666667,2.272727272727273,39,3,42,1.4523809523809523
2020-21,Playoffs,201566,60,Russell Westbrook,1610612764,WAS,5,186,28,84,0.333,5,20,0.25,34,43,0.791,14,38,52,59,2,1,21,17,95,123,2.81,0.1,2020,21,19.0,2.8095238095238093,56,9,65,0.8
2020-21,Playoffs,1630267,62,Facundo Campazzo,1610612743,DEN,10,270,29,74,0.392,19,48,0.396,16,19,0.842,7,23,30,41,14,4,15,35,93,119,2.73,0.93,2020,21,9.3,2.7333333333333334,45,3,48,0.625
2020-21,Playoffs,203085,63,Austin Rivers,1610612743,DEN,10,305,30,69,0.435,19,46,0.413,13,16,0.813,1,16,17,21,2,3,9,32,92,84,2.33,0.22,2020,21,9.2,2.3333333333333335,39,3,42,0.40476190476190477
2020-21,Playoffs,204001,63,Kristaps Porzingis,1610612742,DAL,7,233,34,72,0.472,8,27,0.296,16,19,0.842,7,31,38,9,9,5,3,19,92,109,3.0,3.0,2020,21,13.142857142857142,3.0,38,3,41,0.926829268292683
2020-21,Playoffs,201144,63,Mike Conley,1610612762,UTA,6,176,29,68,0.426,18,37,0.486,16,16,1.0,3,18,21,46,1,3,14,15,92,110,3.29,0.07,2020,21,15.333333333333334,3.2857142857142856,39,0,39,0.5384615384615384
2020-21,Playoffs,203944,66,Julius Randle,1610612752,NYK,5,180,28,94,0.298,11,33,0.333,23,27,0.852,11,47,58,20,3,0,23,18,90,78,0.87,0.13,2020,21,18.0,0.8695652173913043,66,4,70,0.8285714285714286
2020-21,Playoffs,203935,67,Marcus Smart,1610612738,BOS,5,183,29,66,0.439,16,43,0.372,15,21,0.714,4,18,22,30,5,1,14,14,89,90,2.14,0.36,2020,21,17.8,2.142857142857143,37,6,43,0.5116279069767442
2020-21,Playoffs,203076,68,Anthony Davis,1610612747,LAL,5,144,25,62,0.403,2,11,0.182,35,42,0.833,7,26,33,13,3,8,6,9,87,94,2.17,0.5,2020,21,17.4,2.1666666666666665,37,7,44,0.75
2020-21,Playoffs,1628470,68,Torrey Craig,1610612756,PHX,22,266,32,75,0.427,15,37,0.405,8,13,0.615,19,44,63,9,1,8,10,33,87,110,0.9,0.1,2020,21,3.9545454545454546,0.9,43,5,48,1.3125
2020-21,Playoffs,203471,70,Dennis Schroder,1610612747,LAL,6,196,28,70,0.4,8,26,0.308,22,26,0.846,1,17,18,17,6,1,10,13,86,72,1.7,0.6,2020,21,14.333333333333334,1.7,42,4,46,0.391304347826087
2020-21,Playoffs,1627788,71,Furkan Korkmaz,1610612755,PHI,12,195,30,73,0.411,14,44,0.318,10,14,0.714,4,20,24,7,7,3,5,9,84,73,1.4,1.4,2020,21,7.0,1.4,43,4,47,0.5106382978723404
2020-21,Playoffs,1628379,71,Luke Kennard,1610612746,LAC,15,219,31,65,0.477,21,51,0.412,1,2,0.5,5,9,14,7,2,0,3,15,84,69,2.33,0.67,2020,21,5.6,2.3333333333333335,34,1,35,0.4
2020-21,Playoffs,201976,73,Patrick Beverley,1610612746,LAC,17,323,29,68,0.426,13,37,0.351,12,14,0.857,11,30,41,24,12,12,4,35,83,127,6.0,3.0,2020,21,4.882352941176471,6.0,39,2,41,1.0
2020-21,Playoffs,203994,74,Jusuf Nurkic,1610612757,POR,6,173,30,55,0.545,1,5,0.2,18,25,0.72,18,44,62,16,3,7,14,30,79,121,1.14,0.21,2020,21,13.166666666666666,1.1428571428571428,25,7,32,1.9375
2020-21,Playoffs,203095,75,Evan Fournier,1610612738,BOS,5,167,27,63,0.429,13,30,0.433,10,12,0.833,5,13,18,7,6,0,5,20,77,65,1.4,1.2,2020,21,15.4,1.4,36,2,38,0.47368421052631576
2020-21,Playoffs,1630178,76,Tyrese Maxey,1610612755,PHI,12,157,29,66,0.439,4,12,0.333,14,22,0.636,1,21,22,16,3,6,5,16,76,73,3.2,0.6,2020,21,6.333333333333333,3.2,37,8,45,0.4888888888888889
2020-21,Playoffs,202685,77,Jonas Valanciunas,1610612763,MEM,5,166,33,58,0.569,2,8,0.25,7,8,0.875,20,29,49,13,3,3,10,18,75,107,1.3,0.3,2020,21,15.0,1.3,25,1,26,1.8846153846153846
2020-21,Playoffs,2546,78,Carmelo Anthony,1610612757,POR,6,143,25,60,0.417,14,37,0.378,10,11,0.909,2,17,19,9,2,1,7,15,74,62,1.29,0.29,2020,21,12.333333333333334,1.2857142857142858,35,1,36,0.5277777777777778
2020-21,Playoffs,1629060,78,Rui Hachimura,1610612764,WAS,5,173,29,47,0.617,9,15,0.6,7,12,0.583,5,31,36,5,2,1,5,18,74,90,1.0,0.4,2020,21,14.8,1.0,18,5,23,1.565217391304348
2020-21,Playoffs,1627827,80,Dorian Finney-Smith,1610612742,DAL,7,271,26,64,0.406,16,37,0.432,4,5,0.8,17,29,46,15,8,2,12,23,72,92,1.25,0.67,2020,21,10.285714285714286,1.25,38,1,39,1.1794871794871795
2020-21,Playoffs,1629628,80,RJ Barrett,1610612752,NYK,5,162,26,67,0.388,8,28,0.286,12,15,0.8,4,32,36,15,4,2,2,11,72,83,7.5,2.0,2020,21,14.4,7.5,41,3,44,0.8181818181818182
2020-21,Playoffs,202692,82,Alec Burks,1610612752,NYK,5,128,24,56,0.429,8,24,0.333,14,19,0.737,5,20,25,13,1,0,4,11,70,68,3.25,0.25,2020,21,14.0,3.25,32,5,37,0.6756756756756757
2020-21,Playoffs,1628991,83,Jaren Jackson Jr.,1610612763,MEM,5,137,23,54,0.426,8,28,0.286,14,16,0.875,9,19,28,5,5,6,4,21,68,75,1.25,1.25,2020,21,13.6,1.25,31,2,33,0.8484848484848485
2020-21,Playoffs,201609,84,Goran Dragic,1610612748,MIA,4,117,23,54,0.426,9,26,0.346,9,12,0.75,1,6,7,11,4,2,6,11,64,48,1.83,0.67,2020,21,16.0,1.8333333333333333,31,3,34,0.20588235294117646
2020-21,Playoffs,203967,85,Dario Saric,1610612756,PHX,14,147,21,45,0.467,8,18,0.444,13,14,0.929,9,26,35,14,2,1,6,21,63,84,2.33,0.33,2020,21,4.5,2.3333333333333335,24,1,25,1.4
2020-21,Playoffs,1629680,85,Matisse Thybulle,1610612755,PHI,12,220,25,52,0.481,11,34,0.324,2,5,0.4,4,13,17,3,16,11,2,29,63,78,1.5,8.0,2020,21,5.25,1.5,27,3,30,0.5666666666666667
2020-21,Playoffs,1628389,87,Bam Adebayo,1610612748,MIA,4,136,26,57,0.456,0,0,0.0,10,13,0.769,14,23,37,17,5,2,11,11,62,78,1.54,0.46,2020,21,15.5,1.5454545454545454,31,3,34,1.088235294117647
2020-21,Playoffs,1629655,88,Daniel Gafford,1610612764,WAS,5,117,22,26,0.846,0,0,0.0,15,24,0.625,14,15,29,3,5,10,3,17,59,90,1.0,1.67,2020,21,11.8,1.0,4,9,13,2.230769230769231
2020-21,Playoffs,202710,89,Jimmy Butler,1610612748,MIA,4,154,19,64,0.297,4,15,0.267,16,22,0.727,6,24,30,28,5,1,9,6,58,62,3.11,0.56,2020,21,14.5,3.111111111111111,45,6,51,0.5882352941176471
2020-21,Playoffs,200794,89,Paul Millsap,1610612743,DEN,9,109,22,50,0.44,6,23,0.261,8,13,0.615,9,26,35,15,3,6,8,14,58,76,1.88,0.38,2020,21,6.444444444444445,1.875,28,5,33,1.0606060606060606
2020-21,Playoffs,201980,91,Danny Green,1610612755,PHI,8,199,21,48,0.438,14,37,0.378,0,0,0.0,9,12,21,21,9,8,5,13,56,83,4.2,1.8,2020,21,7.0,4.2,27,0,27,0.7777777777777778
2020-21,Playoffs,2730,91,Dwight Howard,1610612755,PHI,12,149,16,30,0.533,0,1,0.0,24,40,0.6,26,49,75,8,2,6,12,31,56,105,0.67,0.17,2020,21,4.666666666666667,0.6666666666666666,14,16,30,2.5
2020-21,Playoffs,201588,91,George Hill,1610612755,PHI,12,205,19,43,0.442,8,19,0.421,10,13,0.769,5,11,16,18,8,3,10,18,56,64,1.8,0.8,2020,21,4.666666666666667,1.8,24,3,27,0.5925925925925926
2020-21,Playoffs,1628973,91,Jalen Brunson,1610612742,DAL,7,114,20,44,0.455,6,13,0.462,10,13,0.769,6,12,18,10,0,0,4,6,56,53,2.5,0.0,2020,21,8.0,2.5,24,3,27,0.6666666666666666
2020-21,Playoffs,203496,91,Robert Covington,1610612757,POR,6,228,18,36,0.5,11,22,0.5,9,10,0.9,9,38,47,7,9,6,8,20,56,98,0.88,1.13,2020,21,9.333333333333334,0.875,18,1,19,2.473684210526316
2020-21,Playoffs,200765,96,Rajon Rondo,1610612746,LAC,13,220,18,53,0.34,11,28,0.393,8,12,0.667,4,30,34,50,5,3,14,18,55,94,3.57,0.36,2020,21,4.230769230769231,3.5714285714285716,35,4,39,0.8717948717948718
2020-21,Playoffs,1629631,97,De'Andre Hunter,1610612737,ATL,5,152,18,45,0.4,6,16,0.375,12,16,0.75,2,18,20,3,1,3,7,11,54,43,0.43,0.14,2020,21,10.8,0.42857142857142855,27,4,31,0.6451612903225806
2020-21,Playoffs,203210,97,JaMychal Green,1610612743,DEN,10,190,20,45,0.444,6,20,0.3,8,9,0.889,17,35,52,11,2,2,3,12,54,92,3.67,0.67,2020,21,5.4,3.6666666666666665,25,1,26,2.0
2020-21,Playoffs,202326,99,DeMarcus Cousins,1610612746,LAC,7,58,19,42,0.452,4,10,0.4,11,14,0.786,6,8,14,5,2,3,5,13,53,46,1.0,0.4,2020,21,7.571428571428571,1.0,23,3,26,0.5384615384615384
2020-21,Playoffs,1629003,100,Shake Milton,1610612755,PHI,12,121,15,47,0.319,8,19,0.421,14,15,0.933,0,9,9,9,3,1,11,18,52,30,0.82,0.27,2020,21,4.333333333333333,0.8181818181818182,32,1,33,0.2727272727272727
2020-21,Playoffs,202684,100,Tristan Thompson,1610612738,BOS,5,132,20,34,0.588,0,0,0.0,12,17,0.706,29,20,49,5,4,6,5,12,52,92,1.0,0.8,2020,21,10.4,1.0,14,5,19,2.5789473684210527
2020-21,Playoffs,1629629,102,Cam Reddish,1610612737,ATL,4,92,19,36,0.528,9,14,0.643,4,5,0.8,1,13,14,7,6,2,5,11,51,57,1.4,1.2,2020,21,12.75,1.4,17,1,18,0.7777777777777778
2020-21,Playoffs,1629013,103,Landry Shamet,1610612751,BKN,12,206,18,41,0.439,10,26,0.385,4,5,0.8,3,18,21,7,5,1,6,19,50,54,1.17,0.83,2020,21,4.166666666666667,1.1666666666666667,23,1,24,0.875
2020-21,Playoffs,201145,104,Jeff Green,1610612751,BKN,6,148,16,33,0.485,10,18,0.556,7,8,0.875,4,13,17,10,3,2,3,14,49,60,3.33,1.0,2020,21,8.166666666666666,3.3333333333333335,17,1,18,0.9444444444444444
2020-21,Playoffs,203115,104,Will Barton,1610612743,DEN,3,83,19,43,0.442,7,21,0.333,4,4,1.0,1,12,13,8,2,1,4,4,49,45,2.0,0.5,2020,21,16.333333333333332,2.0,24,0,24,0.5416666666666666
2020-21,Playoffs,1630168,106,Onyeka Okongwu,1610612737,ATL,18,166,17,31,0.548,0,1,0.0,14,21,0.667,21,27,48,2,5,13,4,28,48,91,0.5,1.25,2020,21,2.6666666666666665,0.5,14,7,21,2.2857142857142856
2020-21,Playoffs,1626246,107,Boban Marjanovic,1610612742,DAL,4,83,20,39,0.513,0,0,0.0,7,9,0.778,14,18,32,4,0,1,4,13,47,59,1.0,0.0,2020,21,11.75,1.0,19,2,21,1.5238095238095237
2020-21,Playoffs,203083,108,Andre Drummond,1610612747,LAL,5,105,19,32,0.594,0,0,0.0,7,10,0.7,19,36,55,0,4,3,11,12,45,80,0.0,0.36,2020,21,9.0,0.0,13,3,16,3.4375
2020-21,Playoffs,203493,109,Reggie Bullock Jr.,1610612752,NYK,5,162,15,39,0.385,10,29,0.345,4,5,0.8,5,12,17,6,3,1,4,11,44,42,1.5,0.75,2020,21,8.8,1.5,24,1,25,0.68
2020-21,Playoffs,203937,110,Kyle Anderson,1610612763,MEM,5,142,18,42,0.429,3,12,0.25,3,4,0.75,4,21,25,16,14,0,4,9,42,68,4.0,3.5,2020,21,8.4,4.0,24,1,25,1.0
2020-21,Playoffs,1630210,110,Markus Howard,1610612743,DEN,9,112,15,37,0.405,11,26,0.423,1,2,0.5,1,6,7,4,0,1,0,10,42,31,0.0,0.0,2020,21,4.666666666666667,inf,22,1,23,0.30434782608695654
2020-21,Playoffs,1629130,112,Duncan Robinson,1610612748,MIA,4,100,11,29,0.379,10,27,0.37,9,10,0.9,0,11,11,3,3,0,4,13,41,35,0.75,0.75,2020,21,10.25,0.75,18,1,19,0.5789473684210527
2020-21,Playoffs,1629134,112,Kendrick Nunn,1610612748,MIA,4,93,17,43,0.395,5,18,0.278,2,2,1.0,0,6,6,6,2,0,3,4,41,26,2.0,0.67,2020,21,10.25,2.0,26,0,26,0.23076923076923078
2020-21,Playoffs,1629014,114,Anfernee Simons,1610612757,POR,6,107,14,25,0.56,11,18,0.611,0,0,0.0,3,13,16,5,2,1,1,6,39,51,5.0,2.0,2020,21,6.5,5.0,11,0,11,1.4545454545454546
2020-21,Playoffs,202689,115,Kemba Walker,1610612760,OKC,3,91,13,41,0.317,3,17,0.176,9,10,0.9,0,12,12,12,1,0,8,10,38,26,1.5,0.13,2020,21,12.666666666666666,1.5,28,1,29,0.41379310344827586
2020-21,Playoffs,1628398,115,Kyle Kuzma,1610612747,LAL,6,129,14,48,0.292,4,23,0.174,6,9,0.667,4,19,23,7,2,1,6,8,38,28,1.17,0.33,2020,21,6.333333333333333,1.1666666666666667,34,3,37,0.6216216216216216
2020-21,Playoffs,202324,117,Derrick Favors,1610612762,UTA,11,145,16,23,0.696,0,0,0.0,5,9,0.556,19,27,46,3,2,10,6,25,37,81,0.5,0.33,2020,21,3.3636363636363638,0.5,7,4,11,4.181818181818182
2020-21,Playoffs,202722,117,Dāvis Bertāns,1610612764,WAS,4,106,11,27,0.407,8,23,0.348,7,7,1.0,0,11,11,1,1,2,1,12,37,35,1.0,1.0,2020,21,9.25,1.0,16,0,16,0.6875
2020-21,Playoffs,1628467,117,Maxi Kleber,1610612742,DAL,7,187,12,30,0.4,8,20,0.4,5,7,0.714,5,20,25,10,3,0,1,19,37,54,10.0,3.0,2020,21,5.285714285714286,10.0,18,2,20,1.25
2020-21,Playoffs,201577,117,Robin Lopez,1610612764,WAS,5,73,18,25,0.72,0,0,0.0,1,4,0.25,4,5,9,0,0,4,1,7,37,39,0.0,0.0,2020,21,7.4,0.0,7,3,10,0.9
2020-21,Playoffs,1629639,117,Tyler Herro,1610612748,MIA,4,93,12,38,0.316,6,19,0.316,7,7,1.0,1,12,13,7,1,1,3,2,37,30,2.33,0.33,2020,21,9.25,2.3333333333333335,26,0,26,0.5
2020-21,Playoffs,1629641,122,Romeo Langford,1610612738,BOS,4,109,13,32,0.406,6,17,0.353,4,4,1.0,5,5,10,5,3,2,1,2,36,36,5.0,3.0,2020,21,9.0,5.0,19,0,19,0.5263157894736842
2020-21,Playoffs,1627936,123,Alex Caruso,1610612747,LAL,6,121,14,38,0.368,5,17,0.294,2,2,1.0,2,6,8,3,1,4,7,12,35,20,0.43,0.14,2020,21,5.833333333333333,0.42857142857142855,24,0,24,0.3333333333333333
2020-21,Playoffs,1627777,123,Georges Niang,1610612762,UTA,11,129,11,39,0.282,9,30,0.3,4,4,1.0,2,17,19,8,0,1,8,19,35,27,1.0,0.0,2020,21,3.1818181818181817,1.0,28,0,28,0.6785714285714286
2020-21,Playoffs,202397,125,Ish Smith,1610612764,WAS,5,111,16,43,0.372,2,7,0.286,0,0,0.0,1,15,16,14,7,2,5,11,34,41,2.8,1.4,2020,21,6.8,2.8,27,0,27,0.5925925925925926
2020-21,Playoffs,203953,125,Jabari Parker,1610612738,BOS,4,59,13,21,0.619,2,5,0.4,6,8,0.75,2,13,15,2,0,3,6,7,34,38,0.33,0.0,2020,21,8.5,0.3333333333333333,8,2,10,1.5
2020-21,Playoffs,1626196,125,Josh Richardson,1610612742,DAL,7,94,11,28,0.393,3,10,0.3,9,9,1.0,3,8,11,5,2,0,6,8,34,29,0.83,0.33,2020,21,4.857142857142857,0.8333333333333334,17,0,17,0.6470588235294118
2020-21,Playoffs,1628455,128,Mike James,1610612751,BKN,9,103,14,43,0.326,5,16,0.313,0,0,0.0,2,14,16,12,2,0,3,6,33,31,4.0,0.67,2020,21,3.6666666666666665,4.0,29,0,29,0.5517241379310345
2020-21,Playoffs,202083,128,Wesley Matthews,1610612747,LAL,6,110,10,33,0.303,7,25,0.28,6,6,1.0,5,5,10,2,2,0,0,13,33,24,0.0,0.0,2020,21,5.5,inf,23,0,23,0.43478260869565216
2020-21,Playoffs,1628960,130,Grayson Allen,1610612763,MEM,5,116,12,33,0.364,8,21,0.381,0,1,0.0,3,10,13,1,2,1,1,13,32,26,1.0,2.0,2020,21,6.4,1.0,21,1,22,0.5909090909090909
2020-21,Playoffs,201952,130,Jeff Teague,1610612749,MIL,16,119,9,31,0.29,5,11,0.455,9,11,0.818,2,6,8,13,3,0,6,9,32,26,2.17,0.5,2020,21,2.0,2.1666666666666665,22,2,24,0.3333333333333333
2020-21,Playoffs,1630167,130,Obi Toppin,1610612752,NYK,5,65,12,23,0.522,3,9,0.333,5,6,0.833,4,9,13,2,0,1,3,6,32,33,0.67,0.0,2020,21,6.4,0.6666666666666666,11,1,12,1.0833333333333333
2020-21,Playoffs,203526,130,Raul Neto,1610612764,WAS,5,112,12,34,0.353,4,15,0.267,4,5,0.8,3,8,11,5,2,0,1,11,32,26,5.0,2.0,2020,21,6.4,5.0,22,1,23,0.4782608695652174
2020-21,Playoffs,1629001,134,De'Anthony Melton,1610612763,MEM,5,83,11,31,0.355,6,20,0.3,3,5,0.6,4,12,16,5,1,4,3,7,31,32,1.67,0.33,2020,21,6.2,1.6666666666666667,20,2,22,0.7272727272727273
2020-21,Playoffs,203484,134,Kentavious Caldwell-Pope,1610612747,LAL,5,146,11,29,0.379,4,19,0.211,5,5,1.0,2,12,14,5,5,0,2,15,31,35,2.5,2.5,2020,21,6.2,2.5,18,0,18,0.7777777777777778
2020-21,Playoffs,1629651,136,Nic Claxton,1610612751,BKN,12,130,14,29,0.483,0,0,0.0,2,3,0.667,14,19,33,7,4,12,4,20,30,66,1.75,1.0,2020,21,2.5,1.75,15,1,16,2.0625
2020-21,Playoffs,1630193,137,Immanuel Quickley,1610612752,NYK,5,77,10,33,0.303,4,11,0.364,5,7,0.714,0,7,7,5,3,0,6,8,29,13,0.83,0.5,2020,21,5.8,0.8333333333333334,23,2,25,0.28
2020-21,Playoffs,1630217,138,Desmond Bane,1610612763,MEM,5,99,11,19,0.579,6,12,0.5,0,0,0.0,2,15,17,10,4,2,3,6,28,50,3.33,1.33,2020,21,5.6,3.3333333333333335,8,0,8,2.125
2020-21,Playoffs,201188,139,Marc Gasol,1610612747,LAL,5,88,8,13,0.615,7,11,0.636,3,4,0.75,4,15,19,15,4,4,4,16,26,58,3.75,1.0,2020,21,5.2,3.75,5,1,6,3.1666666666666665
2020-21,Playoffs,1629659,139,Talen Horton-Tucker,1610612747,LAL,4,48,11,24,0.458,1,5,0.2,3,5,0.6,2,12,14,2,1,0,3,3,26,25,0.67,0.33,2020,21,6.5,0.6666666666666666,13,2,15,0.9333333333333333
2020-21,Playoffs,203473,141,Dewayne Dedmon,1610612748,MIA,4,57,10,18,0.556,1,3,0.333,4,5,0.8,8,10,18,3,0,2,6,10,25,33,0.5,0.0,2020,21,6.25,0.5,8,1,9,2.0
2020-21,Playoffs,201959,141,Taj Gibson,1610612752,NYK,5,138,12,20,0.6,0,0,0.0,1,1,1.0,16,19,35,4,8,5,3,13,25,66,1.33,2.67,2020,21,5.0,1.3333333333333333,8,0,8,4.375
2020-21,Playoffs,1626149,143,Montrezl Harrell,1610612747,LAL,4,39,8,14,0.571,0,0,0.0,7,9,0.778,5,5,10,0,2,0,2,3,23,25,0.0,1.0,2020,21,5.75,0.0,6,2,8,1.25
2020-21,Playoffs,203457,143,Nerlens Noel,1610612752,NYK,5,92,5,10,0.5,0,0,0.0,13,16,0.813,10,10,20,1,4,3,4,15,23,39,0.25,1.0,2020,21,4.6,0.25,5,3,8,2.5
2020-21,Playoffs,1626163,145,Frank Kaminsky,1610612756,PHX,10,68,10,22,0.455,1,5,0.2,1,1,1.0,2,12,14,14,2,3,4,9,22,39,3.5,0.5,2020,21,2.2,3.5,12,0,12,1.1666666666666667
2020-21,Playoffs,203458,146,Alex Len,1610612764,WAS,5,42,8,14,0.571,0,0,0.0,4,7,0.571,4,7,11,2,1,0,1,8,20,24,2.0,1.0,2020,21,4.0,2.0,6,3,9,1.2222222222222223
2020-21,Playoffs,203939,147,Dwight Powell,1610612742,DAL,7,52,7,8,0.875,0,0,0.0,5,6,0.833,5,8,13,6,2,0,1,8,19,37,6.0,2.0,2020,21,2.7142857142857144,6.0,1,1,2,6.5
2020-21,Playoffs,1629057,147,Robert Williams III,1610612738,BOS,3,46,9,14,0.643,0,0,0.0,1,2,0.5,8,7,15,2,1,9,1,7,19,39,2.0,1.0,2020,21,6.333333333333333,2.0,5,1,6,2.5
2020-21,Playoffs,2772,147,Trevor Ariza,1610612748,MIA,4,96,7,23,0.304,5,17,0.294,0,0,0.0,2,21,23,2,3,1,3,11,19,29,0.67,1.0,2020,21,4.75,0.6666666666666666,16,0,16,1.4375
2020-21,Playoffs,202357,150,Nemanja Bjelica,1610612748,MIA,2,30,5,11,0.455,4,8,0.5,4,6,0.667,1,4,5,2,2,1,0,5,18,20,0.0,0.0,2020,21,9.0,inf,6,2,8,0.625
2020-21,Playoffs,202734,151,E'Twaun Moore,1610612756,PHX,7,46,8,18,0.444,1,5,0.2,0,0,0.0,0,10,10,9,1,0,3,3,17,24,3.0,0.33,2020,21,2.4285714285714284,3.0,10,0,10,1.0
2020-21,Playoffs,1629684,151,Grant Williams,1610612738,BOS,5,57,6,12,0.5,2,4,0.5,3,3,1.0,3,7,10,4,1,4,1,7,17,29,4.0,1.0,2020,21,3.4,4.0,6,0,6,1.6666666666666667
2020-21,Playoffs,1630202,151,Payton Pritchard,1610612738,BOS,5,67,6,17,0.353,3,10,0.3,2,2,1.0,2,7,9,12,2,0,3,4,17,26,4.0,0.67,2020,21,3.4,4.0,11,0,11,0.8181818181818182
2020-21,Playoffs,203524,151,Solomon Hill,1610612737,ATL,14,145,6,24,0.25,3,18,0.167,2,4,0.5,3,16,19,3,2,1,1,18,17,21,3.0,2.0,2020,21,1.2142857142857142,3.0,18,2,20,0.95
2020-21,Playoffs,204020,151,Tyler Johnson,1610612751,BKN,8,69,6,17,0.353,3,11,0.273,2,2,1.0,2,4,6,5,2,0,1,9,17,18,5.0,2.0,2020,21,2.125,5.0,11,0,11,0.5454545454545454
2020-21,Playoffs,1630174,156,Aaron Nesmith,1610612738,BOS,5,75,5,18,0.278,4,14,0.286,2,2,1.0,2,11,13,1,1,1,2,7,16,17,0.5,0.5,2020,21,3.2,0.5,13,0,13,1.0
2020-21,Playoffs,1629617,156,Reggie Perry,1610612751,BKN,5,22,7,13,0.538,2,5,0.4,0,0,0.0,4,2,6,1,1,0,3,4,16,15,0.33,0.33,2020,21,3.2,0.3333333333333333,6,0,6,1.0
2020-21,Playoffs,2738,158,Andre Iguodala,1610612748,MIA,4,71,6,11,0.545,3,7,0.429,0,0,0.0,3,9,12,5,4,2,5,8,15,28,1.0,0.8,2020,21,3.75,1.0,5,0,5,2.4
2020-21,Playoffs,1629670,158,Jordan Nwora,1610612749,MIL,5,31,4,18,0.222,2,8,0.25,5,7,0.714,5,4,9,1,0,1,1,1,15,9,1.0,0.0,2020,21,3.0,1.0,14,2,16,0.5625
2020-21,Playoffs,1626145,158,Tyus Jones,1610612763,MEM,5,47,6,17,0.353,1,4,0.25,2,2,1.0,1,6,7,6,1,0,0,1,15,18,0.0,0.0,2020,21,3.0,inf,11,0,11,0.6363636363636364
2020-21,Playoffs,1626161,158,Willie Cauley-Stein,1610612742,DAL,6,63,6,9,0.667,0,0,0.0,3,3,1.0,3,13,16,3,2,4,3,8,15,34,1.0,0.67,2020,21,2.5,1.0,3,0,3,5.333333333333333
2020-21,Playoffs,1629091,162,Elijah Bryant,1610612749,MIL,11,50,7,20,0.35,0,8,0.0,0,0,0.0,2,10,12,4,2,1,2,1,14,18,2.0,1.0,2020,21,1.2727272727272727,2.0,13,0,13,0.9230769230769231
2020-21,Playoffs,1630192,163,Zeke Nnaji,1610612743,DEN,5,18,4,8,0.5,3,7,0.429,1,2,0.5,1,1,2,2,1,0,0,1,12,12,0.0,0.0,2020,21,2.4,inf,4,1,5,0.4
2020-21,Playoffs,1628427,164,Vlatko Cancar,1610612743,DEN,5,21,3,3,1.0,1,1,1.0,4,5,0.8,0,3,3,1,1,1,1,0,11,15,1.0,1.0,2020,21,2.2,1.0,0,1,1,3.0
2020-21,Playoffs,202683,165,Enes Freedom,1610612757,POR,5,56,4,8,0.5,0,0,0.0,2,2,1.0,6,7,13,0,0,2,3,9,10,18,0.0,0.0,2020,21,2.0,0.0,4,0,4,3.25
2020-21,Playoffs,1626178,165,Rondae Hollis-Jefferson,1610612757,POR,5,36,4,5,0.8,0,0,0.0,2,3,0.667,3,5,8,0,1,1,0,5,10,18,0.0,0.0,2020,21,2.0,,1,1,2,4.0
2020-21,Playoffs,201586,165,Serge Ibaka,1610612746,LAC,2,18,3,6,0.5,0,2,0.0,4,4,1.0,1,3,4,2,1,3,1,1,10,16,2.0,1.0,2020,21,5.0,2.0,3,0,3,1.3333333333333333
2020-21,Playoffs,202693,168,Markieff Morris,1610612747,LAL,4,38,2,9,0.222,1,4,0.25,4,6,0.667,4,0,4,3,0,1,2,6,9,6,1.5,0.0,2020,21,2.25,1.5,7,2,9,0.4444444444444444
2020-21,Playoffs,1627885,168,Shaquille Harrison,1610612743,DEN,9,40,3,4,0.75,1,1,1.0,2,3,0.667,0,8,8,3,3,3,5,3,9,19,0.6,0.6,2020,21,1.0,0.6,1,1,2,4.0
2020-21,Playoffs,203648,168,Thanasis Antetokounmpo,1610612749,MIL,13,45,2,7,0.286,0,0,0.0,5,6,0.833,3,7,10,3,5,2,3,12,9,20,1.0,1.67,2020,21,0.6923076923076923,1.0,5,1,6,1.6666666666666667
2020-21,Playoffs,1628993,171,Alize Johnson,1610612751,BKN,5,23,4,7,0.571,0,0,0.0,0,0,0.0,3,10,13,0,3,0,3,1,8,18,0.0,1.0,2020,21,1.6,0.0,3,0,3,4.333333333333333
2020-21,Playoffs,1628978,171,Donte DiVincenzo,1610612749,MIL,3,70,3,16,0.188,2,12,0.167,0,0,0.0,2,17,19,8,3,1,6,4,8,20,1.33,0.5,2020,21,2.6666666666666665,1.3333333333333333,13,0,13,1.4615384615384615
2020-21,Playoffs,201580,171,JaVale McGee,1610612743,DEN,4,34,3,10,0.3,0,2,0.0,2,6,0.333,3,9,12,3,1,5,1,4,8,17,3.0,1.0,2020,21,2.0,3.0,7,4,11,1.0909090909090908
2020-21,Playoffs,1630219,171,Skylar Mays,1610612737,ATL,7,17,4,5,0.8,0,0,0.0,0,0,0.0,0,2,2,1,2,0,1,1,8,11,1.0,2.0,2020,21,1.1428571428571428,1.0,1,0,1,2.0
2020-21,Playoffs,1627789,171,Timothe Luwawu-Cabarrot,1610612751,BKN,7,25,3,10,0.3,2,6,0.333,0,0,0.0,0,3,3,2,0,0,1,1,8,5,2.0,0.0,2020,21,1.1428571428571428,2.0,7,0,7,0.42857142857142855
2020-21,Playoffs,1629599,176,Amir Coffey,1610612746,LAC,10,16,3,4,0.75,1,1,1.0,0,1,0.0,0,2,2,1,1,0,1,0,7,8,1.0,1.0,2020,21,0.7,1.0,1,1,2,1.0
2020-21,Playoffs,1629603,176,Mamadi Diakite,1610612749,MIL,7,35,2,10,0.2,1,2,0.5,2,2,1.0,1,6,7,0,3,1,1,7,7,9,0.0,3.0,2020,21,1.0,0.0,8,0,8,0.875
2020-21,Playoffs,1630173,176,Precious Achiuwa,1610612748,MIA,3,12,3,4,0.75,0,0,0.0,1,4,0.25,0,6,6,0,0,2,4,1,7,7,0.0,0.0,2020,21,2.3333333333333335,0.0,1,3,4,1.5
2020-21,Playoffs,203463,179,Ben McLemore,1610612747,LAL,4,36,2,9,0.222,2,6,0.333,0,0,0.0,1,6,7,1,1,0,1,5,6,7,1.0,1.0,2020,21,1.5,1.0,7,0,7,1.0
2020-21,Playoffs,1628981,179,Bruno Fernando,1610612737,ATL,6,12,2,3,0.667,0,0,0.0,2,2,1.0,1,0,1,0,0,0,0,0,6,6,0.0,0.0,2020,21,1.0,,1,0,1,1.0
2020-21,Playoffs,1628990,179,Chandler Hutchison,1610612764,WAS,2,18,2,5,0.4,0,0,0.0,2,2,1.0,0,3,3,1,0,0,1,1,6,6,1.0,0.0,2020,21,3.0,1.0,3,0,3,1.0
2020-21,Playoffs,1628975,179,Jevon Carter,1610612756,PHX,7,22,3,8,0.375,0,2,0.0,0,2,0.0,0,2,2,4,0,0,0,0,6,5,0.0,0.0,2020,21,0.8571428571428571,inf,5,2,7,0.2857142857142857
2020-21,Playoffs,1628382,179,Justin Jackson,1610612749,MIL,5,15,3,5,0.6,0,2,0.0,0,0,0.0,1,1,2,1,1,0,1,0,6,7,1.0,1.0,2020,21,1.2,1.0,2,0,2,1.0
2020-21,Playoffs,1627739,179,Kris Dunn,1610612737,ATL,5,33,1,5,0.2,0,1,0.0,4,4,1.0,0,5,5,5,2,2,4,5,6,12,1.25,0.5,2020,21,1.2,1.25,4,0,4,1.25
2020-21,Playoffs,203118,179,Mike Scott,1610612755,PHI,5,34,2,9,0.222,2,7,0.286,0,0,0.0,1,2,3,3,1,1,0,3,6,7,0.0,0.0,2020,21,1.2,inf,7,0,7,0.42857142857142855
2020-21,Playoffs,1628388,179,T.J. Leaf,1610612757,POR,3,7,3,4,0.75,0,0,0.0,0,0,0.0,2,1,3,0,0,0,0,0,6,8,0.0,0.0,2020,21,2.0,,1,0,1,3.0
2020-21,Playoffs,1626253,187,Axel Toupane,1610612749,MIL,4,10,2,4,0.5,1,2,0.5,0,0,0.0,2,2,4,0,0,0,0,0,5,7,0.0,0.0,2020,21,1.25,,2,0,2,2.0
2020-21,Playoffs,1629035,187,Carsen Edwards,1610612738,BOS,2,5,2,3,0.667,1,2,0.5,0,0,0.0,0,1,1,0,0,0,0,0,5,5,0.0,0.0,2020,21,2.5,,1,0,1,1.0
2020-21,Playoffs,1629185,187,Chris Chiozza,1610612751,BKN,6,19,2,7,0.286,1,3,0.333,0,0,0.0,0,1,1,1,1,0,1,2,5,2,1.0,1.0,2020,21,0.8333333333333334,1.0,5,0,5,0.2
2020-21,Playoffs,1630187,187,Daniel Oturu,1610612746,LAC,8,15,2,5,0.4,0,1,0.0,1,2,0.5,2,2,4,0,0,1,0,2,5,6,0.0,0.0,2020,21,0.625,,3,1,4,1.0
2020-21,Playoffs,1629216,187,Gabe Vincent,1610612748,MIA,3,14,2,3,0.667,1,2,0.5,0,0,0.0,0,1,1,2,0,0,1,0,5,6,2.0,0.0,2020,21,1.6666666666666667,2.0,1,0,1,1.0
2020-21,Playoffs,1630188,187,Jalen Smith,1610612756,PHX,6,18,2,4,0.5,1,1,1.0,0,0,0.0,2,3,5,1,0,0,1,2,5,8,1.0,0.0,2020,21,0.8333333333333334,1.0,2,0,2,2.5
2020-21,Playoffs,1629642,187,Nassir Little,1610612757,POR,3,9,1,4,0.25,1,4,0.25,2,4,0.5,0,1,1,0,0,1,1,0,5,1,0.0,0.0,2020,21,1.6666666666666667,0.0,3,2,5,0.2
2020-21,Playoffs,1630241,187,Sam Merrill,1610612749,MIL,8,30,2,7,0.286,1,5,0.2,0,0,0.0,1,4,5,1,4,0,1,2,5,9,1.0,4.0,2020,21,0.625,1.0,5,0,5,1.0
2020-21,Playoffs,203503,187,Tony Snell,1610612737,ATL,9,66,2,16,0.125,1,11,0.091,0,0,0.0,0,5,5,2,2,1,4,5,5,-3,0.5,0.5,2020,21,0.5555555555555556,0.5,14,0,14,0.35714285714285715
2020-21,Playoffs,1627846,196,Abdel Nader,1610612756,PHX,5,29,2,6,0.333,0,2,0.0,0,0,0.0,0,5,5,0,0,0,0,3,4,5,0.0,0.0,2020,21,0.8,,4,0,4,1.25
2020-21,Playoffs,1627884,196,Derrick Jones Jr.,1610612757,POR,2,10,2,5,0.4,0,2,0.0,0,0,0.0,0,0,0,0,1,0,0,2,4,2,0.0,0.0,2020,21,2.0,,3,0,3,0.0
2020-21,Playoffs,101141,196,Ersan Ilyasova,1610612762,UTA,1,3,1,2,0.5,0,1,0.0,2,2,1.0,0,0,0,0,0,0,0,0,4,3,0.0,0.0,2020,21,4.0,,1,0,1,0.0
2020-21,Playoffs,1629726,196,Garrison Mathews,1610612764,WAS,3,17,0,4,0.0,0,4,0.0,4,5,0.8,0,2,2,0,0,0,0,4,4,1,0.0,0.0,2020,21,1.3333333333333333,,4,1,5,0.4
2020-21,Playoffs,1630233,196,Nathan Knight,1610612737,ATL,6,14,2,7,0.286,0,2,0.0,0,2,0.0,0,6,6,0,0,2,0,2,4,5,0.0,0.0,2020,21,0.6666666666666666,,5,2,7,0.8571428571428571
2020-21,Playoffs,1630194,196,Paul Reed,1610612755,PHI,3,11,2,4,0.5,0,0,0.0,0,0,0.0,3,5,8,0,0,1,0,1,4,11,0.0,0.0,2020,21,1.3333333333333333,,2,0,2,4.0
2020-21,Playoffs,1629682,196,Tremont Waters,1610612738,BOS,3,6,1,4,0.25,0,2,0.0,2,3,0.667,0,0,0,2,1,0,2,0,4,1,1.0,0.5,2020,21,1.3333333333333333,1.0,3,1,4,0.0
2020-21,Playoffs,1630235,196,Trent Forrest,1610612762,UTA,4,10,2,4,0.5,0,0,0.0,0,0,0.0,0,0,0,0,0,0,0,0,4,2,0.0,0.0,2020,21,1.0,,2,0,2,0.0
2020-21,Playoffs,1627812,196,Yogi Ferrell,1610612746,LAC,9,15,2,5,0.4,0,1,0.0,0,0,0.0,0,3,3,3,0,0,0,0,4,7,0.0,0.0,2020,21,0.4444444444444444,inf,3,0,3,1.0
2020-21,Playoffs,1628436,205,Luke Kornet,1610612738,BOS,2,5,1,1,1.0,0,0,0.0,1,2,0.5,0,3,3,0,0,0,0,0,3,5,0.0,0.0,2020,21,1.5,,0,1,1,3.0
2020-21,Playoffs,1629634,206,Brandon Clarke,1610612763,MEM,2,9,1,2,0.5,0,0,0.0,0,0,0.0,0,1,1,0,0,1,0,0,2,3,0.0,0.0,2020,21,1.0,,1,0,1,1.0
2020-21,Playoffs,1630216,206,Cassius Winston,1610612764,WAS,1,5,1,3,0.333,0,1,0.0,0,0,0.0,1,1,2,1,0,0,2,1,2,1,0.5,0.0,2020,21,2.0,0.5,2,0,2,1.0
2020-21,Playoffs,1630198,206,Isaiah Joe,1610612755,PHI,4,9,1,3,0.333,0,2,0.0,0,0,0.0,0,0,0,1,0,0,0,2,2,1,0.0,0.0,2020,21,0.5,inf,2,0,2,0.0
2020-21,Playoffs,1629833,206,Keljin Blevins,1610612757,POR,2,4,1,2,0.5,0,1,0.0,0,0,0.0,0,0,0,0,0,0,0,1,2,1,0.0,0.0,2020,21,1.0,,1,0,1,0.0
2020-21,Playoffs,1628995,206,Kevin Knox II,1610612752,NYK,1,4,0,0,0.0,0,0,0.0,2,2,1.0,0,1,1,1,0,1,0,0,2,5,0.0,0.0,2020,21,2.0,inf,0,0,0,inf
2020-21,Playoffs,204038,206,Langston Galloway,1610612756,PHX,2,15,1,7,0.143,0,2,0.0,0,1,0.0,0,2,2,1,0,1,0,1,2,-1,0.0,0.0,2020,21,1.0,inf,6,1,7,0.2857142857142857
2020-21,Playoffs,1630234,206,Ty-Shon Alexander,1610612756,PHX,1,1,1,1,1.0,0,0,0.0,0,0,0.0,0,0,0,0,0,0,0,0,2,2,0.0,0.0,2020,21,2.0,,0,0,0,
2020-21,Playoffs,1630214,206,Xavier Tillman,1610612763,MEM,3,18,1,5,0.2,0,1,0.0,0,0,0.0,1,2,3,1,1,0,1,2,2,2,1.0,1.0,2020,21,0.6666666666666666,1.0,4,0,4,0.75
2020-21,Playoffs,203901,214,Elfrid Payton,1610612752,NYK,2,13,0,5,0.0,0,0,0.0,1,2,0.5,0,0,0,1,1,0,0,1,1,-3,0.0,0.0,2020,21,0.5,inf,5,1,6,0.0
2020-21,Playoffs,1629714,214,Jarrell Brantley,1610612762,UTA,2,3,0,1,0.0,0,0,0.0,1,2,0.5,0,1,1,0,0,0,1,0,1,-1,0.0,0.0,2020,21,0.5,0.0,1,1,2,0.5
2020-21,Playoffs,1629730,214,Rayjon Tucker,1610612755,PHI,1,2,0,0,0.0,0,0,0.0,1,2,0.5,0,0,0,0,0,0,0,1,1,0,0.0,0.0,2020,21,1.0,,0,1,1,0.0
2020-21,Playoffs,1628400,214,Semi Ojeleye,1610612738,BOS,2,12,0,4,0.0,0,3,0.0,1,2,0.5,0,0,0,0,1,1,0,0,1,-2,0.0,0.0,2020,21,0.5,,4,1,5,0.0
2020-21,Playoffs,203504,214,Trey Burke,1610612742,DAL,2,17,0,7,0.0,0,3,0.0,1,2,0.5,1,0,1,1,0,0,0,1,1,-5,0.0,0.0,2020,21,0.5,inf,7,1,8,0.125
2020-21,Playoffs,1628035,219,Alfonzo McKinnie,1610612747,LAL,2,12,0,3,0.0,0,2,0.0,0,0,0.0,0,1,1,0,0,0,0,1,0,-2,0.0,0.0,2020,21,0.0,,3,0,3,0.3333333333333333
2020-21,Playoffs,1630264,219,Anthony Gill,1610612764,WAS,4,33,0,3,0.0,0,1,0.0,0,0,0.0,1,3,4,0,0,0,3,7,0,-2,0.0,0.0,2020,21,0.0,0.0,3,0,3,1.3333333333333333
2020-21,Playoffs,201229,219,Anthony Tolliver,1610612755,PHI,1,2,0,0,0.0,0,0,0.0,0,0,0.0,0,0,0,0,0,0,0,1,0,0,0.0,0.0,2020,21,0.0,,0,0,0,
2020-21,Playoffs,1629626,219,Bol Bol,1610612743,DEN,3,6,0,1,0.0,0,1,0.0,0,0,0.0,0,1,1,2,0,0,0,0,0,2,0.0,0.0,2020,21,0.0,inf,1,0,1,1.0
2020-21,Playoffs,1629604,219,CJ Elleby,1610612757,POR,2,8,0,1,0.0,0,0,0.0,0,0,0.0,1,2,3,1,0,0,1,0,0,2,1.0,0.0,2020,21,0.0,1.0,1,0,1,3.0
2020-21,Playoffs,1628373,219,Frank Ntilikina,1610612752,NYK,3,4,0,1,0.0,0,1,0.0,0,0,0.0,0,0,0,0,0,0,0,0,0,-1,0.0,0.0,2020,21,0.0,,1,0,1,0.0
2020-21,Playoffs,1628385,219,Harry Giles III,1610612757,POR,1,4,0,1,0.0,0,0,0.0,0,0,0.0,2,1,3,0,0,0,3,0,0,-1,0.0,0.0,2020,21,0.0,0.0,1,0,1,3.0
2020-21,Playoffs,1629067,219,Isaac Bonga,1610612764,WAS,4,10,0,5,0.0,0,3,0.0,0,0,0.0,0,0,0,0,0,1,0,0,0,-4,0.0,0.0,2020,21,0.0,,5,0,5,0.0
2020-21,Playoffs,201162,219,Jared Dudley,1610612747,LAL,2,5,0,0,0.0,0,0,0.0,0,0,0.0,0,0,0,0,0,0,0,0,0,0,0.0,0.0,2020,21,0.0,,0,0,0,
2020-21,Playoffs,1630206,219,Jay Scrubb,1610612746,LAC,6,8,0,0,0.0,0,0,0.0,0,0,0.0,0,1,1,0,0,0,0,0,0,1,0.0,0.0,2020,21,0.0,,0,0,0,inf
2020-21,Playoffs,1629723,219,John Konchar,1610612763,MEM,1,3,0,1,0.0,0,1,0.0,0,0,0.0,0,1,1,0,0,1,0,0,0,1,0.0,0.0,2020,21,0.0,,1,0,1,1.0
2020-21,Playoffs,1630182,219,Josh Green,1610612742,DAL,1,4,0,0,0.0,0,0,0.0,0,0,0.0,0,0,0,0,0,0,0,0,0,0,0.0,0.0,2020,21,0.0,,0,0,0,
2020-21,Playoffs,1626159,219,Justise Winslow,1610612763,MEM,1,3,0,0,0.0,0,0,0.0,0,0,0.0,0,1,1,1,0,0,0,0,0,2,0.0,0.0,2020,21,0.0,inf,0,0,0,inf
2020-21,Playoffs,1629752,219,Juwan Morgan,1610612762,UTA,2,6,0,0,0.0,0,0,0.0,0,0,0.0,1,1,2,1,0,0,0,1,0,3,0.0,0.0,2020,21,0.0,inf,0,0,0,inf
2020-21,Playoffs,1629644,219,KZ Okpala,1610612748,MIA,2,6,0,1,0.0,0,1,0.0,0,0,0.0,0,0,0,0,0,0,0,0,0,-1,0.0,0.0,2020,21,0.0,,1,0,1,0.0
2020-21,Playoffs,1629744,219,Matt Thomas,1610612762,UTA,3,7,0,2,0.0,0,0,0.0,0,0,0.0,0,1,1,0,0,0,0,1,0,-1,0.0,0.0,2020,21,0.0,,2,0,2,0.5
2020-21,Playoffs,1629622,219,Max Strus,1610612748,MIA,2,6,0,1,0.0,0,0,0.0,0,0,0.0,0,0,0,0,0,0,0,0,0,-1,0.0,0.0,2020,21,0.0,,1,0,1,0.0
2020-21,Playoffs,1629671,219,Miye Oni,1610612762,UTA,8,41,0,5,0.0,0,5,0.0,0,0,0.0,3,0,3,0,1,0,0,8,0,-1,0.0,0.0,2020,21,0.0,,5,0,5,0.6
2020-21,Playoffs,1629740,219,Nicolo Melli,1610612742,DAL,3,19,0,4,0.0,0,2,0.0,0,0,0.0,2,4,6,0,1,0,0,3,0,3,0.0,0.0,2020,21,0.0,,4,0,4,1.5
2020-21,Playoffs,1629605,219,Tacko Fall,1610612738,BOS,1,1,0,0,0.0,0,0,0.0,0,0,0.0,0,1,1,0,0,0,0,0,0,1,0.0,0.0,2020,21,0.0,,0,0,0,inf
2020-21,Playoffs,1628962,219,Udoka Azubuike,1610612762,UTA,1,1,0,0,0.0,0,0,0.0,0,0,0.0,0,1,1,0,0,0,0,0,0,1,0.0,0.0,2020,21,0.0,,0,0,0,inf
2021-22,RegularSeason,1629027,1,Trae Young,1610612737,ATL,76,2652,711,1544,0.46,233,610,0.382,500,553,0.904,50,234,284,737,72,7,303,128,2155,2066,2.43,0.24,2021,22,28.355263157894736,2.432343234323432,833,53,886,0.32054176072234764
2021-22,RegularSeason,201942,2,DeMar DeRozan,1610612741,CHI,76,2743,774,1535,0.504,50,142,0.352,520,593,0.877,56,336,392,374,68,24,181,178,2118,1961,2.07,0.38,2021,22,27.86842105263158,2.0662983425414363,761,73,834,0.47002398081534774
2021-22,RegularSeason,203954,3,Joel Embiid,1610612755,PHI,68,2296,666,1334,0.499,93,251,0.371,654,803,0.814,146,650,796,284,77,99,214,181,2079,2304,1.33,0.36,2021,22,30.573529411764707,1.3271028037383177,668,149,817,0.9742962056303549
2021-22,RegularSeason,1628369,4,Jayson Tatum,1610612738,BOS,76,2731,708,1564,0.453,230,651,0.353,400,469,0.853,85,524,609,334,75,49,217,174,2046,1971,1.54,0.35,2021,22,26.92105263157895,1.5391705069124424,856,69,925,0.6583783783783784
2021-22,RegularSeason,203999,5,Nikola Jokic,1610612743,DEN,74,2476,764,1311,0.583,97,288,0.337,379,468,0.81,206,813,1019,584,109,63,281,191,2004,2862,2.08,0.39,2021,22,27.08108108108108,2.078291814946619,547,89,636,1.6022012578616351
2021-22,RegularSeason,203507,6,Giannis Antetokounmpo,1610612749,MIL,67,2204,689,1245,0.553,71,242,0.293,553,766,0.722,134,644,778,388,72,91,219,212,2002,2343,1.77,0.33,2021,22,29.880597014925375,1.7716894977168949,556,213,769,1.011703511053316
2021-22,RegularSeason,1629029,7,Luka Doncic,1610612742,DAL,65,2301,641,1403,0.457,201,569,0.353,364,489,0.744,56,537,593,568,75,36,292,145,1847,1940,1.95,0.26,2021,22,28.415384615384614,1.9452054794520548,762,125,887,0.6685456595264938
2021-22,RegularSeason,1626164,8,Devin Booker,1610612756,PHX,68,2345,662,1421,0.466,183,478,0.383,315,363,0.868,45,297,342,329,77,26,162,180,1822,1627,2.03,0.47,2021,22,26.794117647058822,2.0308641975308643,759,48,807,0.42379182156133827
2021-22,RegularSeason,1626157,9,Karl-Anthony Towns,1610612750,MIN,74,2475,642,1214,0.529,150,366,0.41,384,467,0.822,194,533,727,269,72,83,226,267,1818,2088,1.19,0.32,2021,22,24.56756756756757,1.1902654867256637,572,83,655,1.1099236641221375
2021-22,RegularSeason,1628378,10,Donovan Mitchell,1610612762,UTA,67,2266,617,1376,0.448,232,654,0.355,267,313,0.853,55,227,282,358,99,12,200,164,1733,1479,1.79,0.49,2021,22,25.865671641791046,1.79,759,46,805,0.35031055900621116
2021-22,RegularSeason,2544,11,LeBron James,1610612747,LAL,56,2084,640,1221,0.524,161,448,0.359,254,336,0.756,63,396,459,349,73,59,196,121,1695,1776,1.78,0.37,2021,22,30.267857142857142,1.780612244897959,581,82,663,0.6923076923076923
2021-22,RegularSeason,201142,12,Kevin Durant,1610612751,BKN,55,2047,578,1115,0.518,115,300,0.383,372,409,0.91,29,378,407,351,48,52,191,113,1643,1736,1.84,0.25,2021,22,29.87272727272727,1.837696335078534,537,37,574,0.7090592334494773
2021-22,RegularSeason,203897,13,Zach LaVine,1610612741,CHI,67,2328,565,1186,0.476,185,475,0.389,320,375,0.853,22,286,308,303,41,23,171,120,1635,1463,1.77,0.24,2021,22,24.402985074626866,1.7719298245614035,621,55,676,0.4556213017751479
2021-22,RegularSeason,201939,14,Stephen Curry,1610612744,GSW,64,2211,535,1224,0.437,285,750,0.38,275,298,0.923,34,301,335,404,85,23,206,130,1630,1559,1.96,0.41,2021,22,25.46875,1.9611650485436893,689,23,712,0.4705056179775281
2021-22,RegularSeason,1628970,15,Miles Bridges,1610612766,CHA,80,2837,596,1214,0.491,154,465,0.331,267,333,0.802,90,469,559,300,74,67,150,193,1613,1779,2.0,0.49,2021,22,20.1625,2.0,618,66,684,0.8172514619883041
2021-22,RegularSeason,1629630,16,Ja Morant,1610612763,MEM,57,1889,580,1177,0.493,88,256,0.344,316,415,0.761,77,248,325,384,66,22,196,86,1564,1469,1.96,0.34,2021,22,27.43859649122807,1.9591836734693877,597,99,696,0.46695402298850575
2021-22,RegularSeason,1627759,17,Jaylen Brown,1610612738,BOS,66,2220,576,1217,0.473,166,464,0.358,241,318,0.758,53,351,404,231,70,18,178,163,1559,1386,1.3,0.39,2021,22,23.62121212121212,1.297752808988764,641,77,718,0.5626740947075209
2021-22,RegularSeason,1627783,18,Pascal Siakam,1610612761,TOR,68,2578,596,1207,0.494,75,218,0.344,284,379,0.749,128,452,580,360,85,42,181,225,1551,1731,1.99,0.47,2021,22,22.808823529411764,1.988950276243094,611,95,706,0.8215297450424929
2021-22,RegularSeason,1630162,19,Anthony Edwards,1610612750,MIN,72,2466,549,1245,0.441,215,602,0.357,220,280,0.786,62,281,343,275,105,46,190,164,1533,1356,1.45,0.55,2021,22,21.291666666666668,1.4473684210526316,696,60,756,0.4537037037037037
2021-22,RegularSeason,1630163,20,LaMelo Ball,1610612766,CHA,75,2422,538,1254,0.429,220,565,0.389,212,243,0.872,108,393,501,571,119,30,245,237,1508,1737,2.33,0.49,2021,22,20.106666666666666,2.330612244897959,716,31,747,0.6706827309236948
2021-22,RegularSeason,1629636,21,Darius Garland,1610612739,CLE,68,2430,542,1173,0.462,174,454,0.383,215,241,0.892,39,185,224,583,89,7,248,115,1473,1471,2.35,0.36,2021,22,21.66176470588235,2.350806451612903,631,26,657,0.3409436834094368
2021-22,RegularSeason,203944,22,Julius Randle,1610612752,NYK,72,2544,512,1246,0.411,120,390,0.308,303,401,0.756,125,591,716,370,53,39,245,205,1447,1548,1.51,0.22,2021,22,20.09722222222222,1.510204081632653,734,98,832,0.8605769230769231
2021-22,RegularSeason,201566,23,Russell Westbrook,1610612747,LAL,78,2678,548,1233,0.444,79,265,0.298,266,399,0.667,110,470,580,550,75,20,295,235,1441,1553,1.86,0.25,2021,22,18.474358974358974,1.8644067796610169,685,133,818,0.7090464547677262
2021-22,RegularSeason,1627749,24,Dejounte Murray,1610612759,SAS,68,2366,573,1241,0.462,96,294,0.327,196,247,0.794,80,483,563,627,138,23,180,138,1438,1890,3.48,0.77,2021,22,21.147058823529413,3.4833333333333334,668,51,719,0.7830319888734353
2021-22,RegularSeason,201935,25,James Harden,1610612755,PHI,65,2420,407,992,0.41,148,448,0.33,470,536,0.877,55,445,500,667,82,36,284,153,1432,1782,2.35,0.29,2021,22,22.03076923076923,2.3485915492957745,585,66,651,0.7680491551459293
2021-22,RegularSeason,1626179,26,Terry Rozier,1610612766,CHA,73,2458,518,1167,0.444,222,593,0.374,150,176,0.852,56,259,315,326,93,25,96,119,1408,1396,3.4,0.97,2021,22,19.28767123287671,3.3958333333333335,649,26,675,0.4666666666666667
2021-22,RegularSeason,1629673,27,Jordan Poole,1610612744,GSW,76,2283,474,1058,0.448,211,580,0.364,246,266,0.925,34,226,260,304,60,23,187,206,1405,1261,1.63,0.32,2021,22,18.486842105263158,1.625668449197861,584,20,604,0.4304635761589404
2021-22,RegularSeason,1629628,28,RJ Barrett,1610612752,NYK,70,2417,487,1194,0.408,138,404,0.342,290,406,0.714,66,342,408,208,43,16,151,142,1402,1103,1.38,0.28,2021,22,20.02857142857143,1.3774834437086092,707,116,823,0.4957472660996355
2021-22,RegularSeason,1630217,29,Desmond Bane,1610612763,MEM,76,2266,508,1101,0.461,228,523,0.436,140,155,0.903,46,288,334,208,92,29,111,196,1384,1328,1.87,0.83,2021,22,18.210526315789473,1.8738738738738738,593,15,608,0.5493421052631579
2021-22,RegularSeason,1628983,30,Shai Gilgeous-Alexander,1610612760,OKC,56,1942,477,1052,0.453,89,297,0.3,328,405,0.81,37,241,278,331,71,46,154,142,1371,1291,2.15,0.46,2021,22,24.482142857142858,2.1493506493506493,575,77,652,0.4263803680981595
2021-22,RegularSeason,203468,31,CJ McCollum,1610612740,NOP,62,2145,536,1164,0.46,182,469,0.388,116,170,0.682,53,216,269,315,70,22,127,121,1370,1237,2.48,0.55,2021,22,22.096774193548388,2.4803149606299213,628,54,682,0.3944281524926686
2021-22,RegularSeason,1628368,32,De'Aaron Fox,1610612758,SAC,59,2083,516,1092,0.473,74,249,0.297,261,348,0.75,25,206,231,330,68,25,168,172,1367,1190,1.96,0.41,2021,22,23.16949152542373,1.9642857142857142,576,87,663,0.34841628959276016
2021-22,RegularSeason,1629639,32,Tyler Herro,1610612748,MIA,66,2151,501,1122,0.447,175,439,0.399,190,219,0.868,32,297,329,263,44,8,174,95,1367,1187,1.51,0.25,2021,22,20.71212121212121,1.5114942528735633,621,29,650,0.5061538461538462
2021-22,RegularSeason,203114,34,Khris Middleton,1610612749,MIL,66,2141,452,1021,0.443,162,434,0.373,259,291,0.89,41,315,356,358,76,18,190,160,1325,1342,1.88,0.4,2021,22,20.075757575757574,1.8842105263157896,569,32,601,0.5923460898502496
2021-22,RegularSeason,1630180,35,Saddiq Bey,1610612765,DET,82,2704,450,1136,0.396,211,610,0.346,210,254,0.827,107,334,441,233,73,16,96,128,1321,1258,2.43,0.76,2021,22,16.109756097560975,2.4270833333333335,686,44,730,0.6041095890410959
2021-22,RegularSeason,1627832,36,Fred VanVleet,1610612761,TOR,65,2462,442,1097,0.403,242,642,0.377,194,222,0.874,44,245,289,434,111,35,170,162,1320,1336,2.55,0.65,2021,22,20.307692307692307,2.552941176470588,655,28,683,0.42313323572474376
2021-22,RegularSeason,202685,37,Jonas Valanciunas,1610612740,NOP,74,2240,510,938,0.544,57,158,0.361,237,289,0.82,226,617,843,190,41,60,179,247,1314,1789,1.06,0.23,2021,22,17.756756756756758,1.0614525139664805,428,52,480,1.75625
2021-22,RegularSeason,1630178,38,Tyrese Maxey,1610612755,PHI,75,2650,483,995,0.485,132,309,0.427,213,246,0.866,26,214,240,321,55,32,88,156,1311,1326,3.65,0.63,2021,22,17.48,3.647727272727273,512,33,545,0.44036697247706424
2021-22,RegularSeason,202696,39,Nikola Vucevic,1610612741,CHI,73,2418,546,1154,0.473,104,331,0.314,92,121,0.76,142,662,804,236,70,71,136,181,1288,1696,1.74,0.52,2021,22,17.643835616438356,1.7352941176470589,608,29,637,1.262166405023548
2021-22,RegularSeason,1628973,40,Jalen Brunson,1610612742,DAL,79,2524,506,1008,0.502,94,252,0.373,179,213,0.84,43,266,309,377,66,3,124,151,1285,1380,3.04,0.53,2021,22,16.265822784810126,3.0403225806451615,502,34,536,0.5764925373134329
2021-22,RegularSeason,1629018,41,Gary Trent Jr.,1610612761,TOR,70,2448,450,1086,0.414,209,545,0.383,174,204,0.853,26,165,191,141,122,19,73,144,1283,1017,1.93,1.67,2021,22,18.32857142857143,1.9315068493150684,636,30,666,0.28678678678678676
2021-22,RegularSeason,1629640,42,Keldon Johnson,1610612759,SAS,75,2392,471,1011,0.466,159,399,0.398,177,234,0.756,80,377,457,158,58,14,92,148,1278,1276,1.72,0.63,2021,22,17.04,1.7173913043478262,540,57,597,0.7654941373534339
2021-22,RegularSeason,1628991,43,Jaren Jackson Jr.,1610612763,MEM,78,2126,430,1036,0.415,128,401,0.319,284,345,0.823,119,335,454,86,73,177,130,272,1272,1265,0.66,0.56,2021,22,16.307692307692307,0.6615384615384615,606,61,667,0.6806596701649176
2021-22,RegularSeason,203903,44,Jordan Clarkson,1610612762,UTA,79,2141,466,1113,0.419,190,597,0.318,144,174,0.828,67,206,273,194,66,16,129,149,1266,1009,1.5,0.51,2021,22,16.025316455696203,1.503875968992248,647,30,677,0.4032496307237814
2021-22,RegularSeason,1627741,45,Buddy Hield,1610612754,IND,81,2499,446,1098,0.406,262,716,0.366,111,127,0.874,66,287,353,229,73,25,153,184,1265,1124,1.5,0.48,2021,22,15.617283950617283,1.4967320261437909,652,16,668,0.5284431137724551
2021-22,RegularSeason,203084,45,Harrison Barnes,1610612758,SAC,77,2587,391,834,0.469,142,360,0.394,341,413,0.826,82,350,432,186,53,14,118,94,1265,1317,1.58,0.45,2021,22,16.428571428571427,1.576271186440678,443,72,515,0.8388349514563107
2021-22,RegularSeason,202704,47,Reggie Jackson,1610612746,LAC,75,2337,479,1222,0.392,167,512,0.326,138,163,0.847,39,232,271,359,55,15,173,159,1263,1022,2.08,0.32,2021,22,16.84,2.0751445086705202,743,25,768,0.3528645833333333
2021-22,RegularSeason,202699,48,Tobias Harris,1610612755,PHI,73,2543,493,1022,0.482,101,275,0.367,170,202,0.842,77,419,496,252,47,43,116,164,1257,1418,2.17,0.41,2021,22,17.21917808219178,2.1724137931034484,529,32,561,0.8841354723707665
2021-22,RegularSeason,203952,49,Andrew Wiggins,1610612744,GSW,73,2330,475,1019,0.466,157,399,0.393,149,235,0.634,85,240,325,161,76,51,111,158,1256,1128,1.45,0.69,2021,22,17.205479452054796,1.4504504504504505,544,86,630,0.5158730158730159
2021-22,RegularSeason,202711,50,Bojan Bogdanovic,1610612762,UTA,69,2131,422,928,0.455,181,468,0.387,223,260,0.858,58,238,296,120,34,1,118,116,1248,1038,1.02,0.29,2021,22,18.08695652173913,1.0169491525423728,506,37,543,0.5451197053406999
2021-22,RegularSeason,1627742,51,Brandon Ingram,1610612740,NOP,55,1869,453,983,0.461,74,226,0.327,266,322,0.826,35,285,320,307,34,26,151,119,1246,1196,2.03,0.23,2021,22,22.654545454545456,2.033112582781457,530,56,586,0.5460750853242321
2021-22,RegularSeason,201950,52,Jrue Holiday,1610612749,MIL,67,2207,478,954,0.501,132,321,0.411,137,180,0.761,69,232,301,457,108,29,183,133,1225,1418,2.5,0.59,2021,22,18.28358208955224,2.4972677595628414,476,43,519,0.5799614643545279
2021-22,RegularSeason,202710,53,Jimmy Butler,1610612748,MIA,57,1931,398,829,0.48,27,116,0.233,396,455,0.87,102,234,336,312,94,27,121,88,1219,1377,2.58,0.78,2021,22,21.385964912280702,2.5785123966942147,431,59,490,0.6857142857142857
2021-22,RegularSeason,1626174,54,Christian Wood,1610612745,HOU,68,2094,440,878,0.501,131,336,0.39,207,332,0.623,110,576,686,155,54,65,126,171,1218,1489,1.23,0.43,2021,22,17.91176470588235,1.2301587301587302,438,125,563,1.2184724689165187
2021-22,RegularSeason,1630532,55,Franz Wagner,1610612753,ORL,79,2429,456,975,0.468,96,271,0.354,189,219,0.863,84,272,356,231,68,34,119,164,1197,1218,1.94,0.57,2021,22,15.151898734177216,1.9411764705882353,519,30,549,0.6484517304189436
2021-22,RegularSeason,1630169,56,Tyrese Haliburton,1610612754,IND,77,2694,430,909,0.473,161,389,0.414,160,190,0.842,61,250,311,628,134,49,199,121,1181,1595,3.16,0.67,2021,22,15.337662337662337,3.1557788944723617,479,30,509,0.6110019646365422
2021-22,RegularSeason,1626156,57,D'Angelo Russell,1610612750,MIN,65,2077,401,975,0.411,176,518,0.34,198,240,0.825,25,191,216,460,62,22,165,130,1176,1155,2.79,0.38,2021,22,18.092307692307692,2.787878787878788,574,42,616,0.35064935064935066
2021-22,RegularSeason,1627734,58,Domantas Sabonis,1610612758,SAC,62,2136,443,773,0.573,39,125,0.312,246,332,0.741,201,551,752,323,59,27,195,203,1171,1721,1.66,0.3,2021,22,18.887096774193548,1.6564102564102565,330,86,416,1.8076923076923077
2021-22,RegularSeason,1628969,59,Mikal Bridges,1610612756,PHX,82,2854,458,858,0.534,115,312,0.369,131,157,0.834,74,273,347,185,96,36,68,150,1162,1332,2.72,1.41,2021,22,14.170731707317072,2.7205882352941178,400,26,426,0.8145539906103286
2021-22,RegularSeason,1630224,60,Jalen Green,1610612745,HOU,67,2138,406,954,0.426,157,458,0.343,188,236,0.797,33,193,226,176,44,18,135,103,1157,890,1.3,0.33,2021,22,17.26865671641791,1.3037037037037038,548,48,596,0.37919463087248323
2021-22,RegularSeason,1626162,61,Kelly Oubre Jr.,1610612766,CHA,76,1999,410,932,0.44,191,553,0.345,126,189,0.667,79,223,302,84,77,31,67,189,1137,979,1.25,1.15,2021,22,14.960526315789474,1.2537313432835822,522,63,585,0.5162393162393163
2021-22,RegularSeason,1630567,62,Scottie Barnes,1610612761,TOR,74,2617,459,932,0.492,58,193,0.301,158,215,0.735,195,362,557,256,80,55,136,192,1134,1416,1.88,0.59,2021,22,15.324324324324325,1.8823529411764706,473,57,530,1.0509433962264152
2021-22,RegularSeason,1628398,63,Kyle Kuzma,1610612764,WAS,66,2204,423,936,0.452,128,375,0.341,156,219,0.712,70,491,561,233,42,57,169,128,1130,1278,1.38,0.25,2021,22,17.12121212121212,1.378698224852071,513,63,576,0.9739583333333334
2021-22,RegularSeason,203932,64,Aaron Gordon,1610612743,DEN,75,2375,434,834,0.52,87,260,0.335,171,230,0.743,125,314,439,188,44,44,133,148,1126,1249,1.41,0.33,2021,22,15.013333333333334,1.413533834586466,400,59,459,0.9564270152505446
2021-22,RegularSeason,203095,65,Evan Fournier,1610612752,NYK,80,2358,402,965,0.417,241,619,0.389,80,113,0.708,34,176,210,171,79,20,105,180,1125,904,1.63,0.75,2021,22,14.0625,1.6285714285714286,563,33,596,0.3523489932885906
2021-22,RegularSeason,1630595,66,Cade Cunningham,1610612765,DET,64,2088,429,1031,0.416,114,363,0.314,142,168,0.845,58,296,354,356,78,43,234,200,1114,1083,1.52,0.33,2021,22,17.40625,1.5213675213675213,602,26,628,0.5636942675159236
2021-22,RegularSeason,1628389,67,Bam Adebayo,1610612748,MIA,56,1825,406,729,0.557,0,6,0.0,256,340,0.753,137,427,564,190,80,44,148,171,1068,1391,1.28,0.54,2021,22,19.071428571428573,1.2837837837837838,323,84,407,1.3857493857493857
2021-22,RegularSeason,1630175,68,Cole Anthony,1610612753,ORL,65,2059,357,912,0.391,132,391,0.338,216,253,0.854,32,316,348,369,46,17,170,171,1062,1080,2.17,0.27,2021,22,16.338461538461537,2.1705882352941175,555,37,592,0.5878378378378378
2021-22,RegularSeason,1626171,69,Bobby Portis,1610612749,MIL,72,2028,417,871,0.479,133,338,0.393,85,113,0.752,180,477,657,86,53,51,90,174,1052,1327,0.96,0.59,2021,22,14.61111111111111,0.9555555555555556,454,28,482,1.3630705394190872
2021-22,RegularSeason,1628370,70,Malik Monk,1610612747,LAL,76,2138,391,826,0.473,173,442,0.391,93,117,0.795,37,219,256,218,61,29,122,138,1048,1031,1.79,0.5,2021,22,13.789473684210526,1.7868852459016393,435,24,459,0.5577342047930284
2021-22,RegularSeason,203115,71,Will Barton,1610612743,DEN,71,2276,392,896,0.438,157,430,0.365,102,127,0.803,44,296,340,276,55,31,127,114,1043,1089,2.17,0.43,2021,22,14.690140845070422,2.173228346456693,504,25,529,0.6427221172022685
2021-22,RegularSeason,1630596,72,Evan Mobley,1610612739,CLE,69,2331,422,830,0.508,23,92,0.25,167,252,0.663,143,427,570,174,56,115,133,147,1034,1323,1.31,0.42,2021,22,14.985507246376812,1.3082706766917294,408,85,493,1.156186612576065
2021-22,RegularSeason,204001,73,Kristaps Porzingis,1610612764,WAS,51,1481,352,767,0.459,78,252,0.31,248,286,0.867,102,309,411,119,37,84,81,137,1030,1147,1.47,0.46,2021,22,20.19607843137255,1.4691358024691359,415,38,453,0.9072847682119205
2021-22,RegularSeason,203497,74,Rudy Gobert,1610612762,UTA,66,2120,362,508,0.713,0,4,0.0,303,439,0.69,241,727,968,72,45,137,119,176,1027,1848,0.6,0.38,2021,22,15.56060606060606,0.6050420168067226,146,136,282,3.4326241134751774
2021-22,RegularSeason,203484,75,Kentavious Caldwell-Pope,1610612764,WAS,77,2329,361,829,0.435,159,408,0.39,137,154,0.89,41,220,261,145,83,26,97,139,1018,951,1.5,0.86,2021,22,13.220779220779221,1.4948453608247423,468,17,485,0.5381443298969072
2021-22,RegularSeason,201567,76,Kevin Love,1610612739,CLE,74,1665,327,761,0.43,187,477,0.392,166,198,0.838,87,449,536,160,26,18,98,101,1007,1183,1.63,0.27,2021,22,13.608108108108109,1.6326530612244898,434,32,466,1.150214592274678
2021-22,RegularSeason,1629028,77,Deandre Ayton,1610612756,PHX,58,1713,442,697,0.634,7,19,0.368,106,142,0.746,149,444,593,84,40,40,91,142,997,1372,0.92,0.44,2021,22,17.189655172413794,0.9230769230769231,255,36,291,2.0378006872852232
2021-22,RegularSeason,1628401,78,Derrick White,1610612738,BOS,75,2199,337,800,0.421,115,369,0.312,203,235,0.864,38,223,261,366,64,58,119,172,992,1127,3.08,0.54,2021,22,13.226666666666667,3.0756302521008405,463,32,495,0.5272727272727272
2021-22,RegularSeason,1629014,79,Anfernee Simons,1610612757,POR,57,1681,353,797,0.443,179,442,0.405,103,116,0.888,26,125,151,221,30,6,115,110,988,824,1.92,0.26,2021,22,17.333333333333332,1.9217391304347826,444,13,457,0.3304157549234136
2021-22,RegularSeason,1627747,80,Caris LeVert,1610612739,CLE,58,1780,379,854,0.444,82,256,0.32,146,193,0.756,43,171,214,248,51,23,108,131,986,892,2.3,0.47,2021,22,17.0,2.2962962962962963,475,47,522,0.4099616858237548
2021-22,RegularSeason,201144,80,Mike Conley,1610612762,UTA,72,2058,344,791,0.435,169,414,0.408,129,162,0.796,47,170,217,385,96,21,123,142,986,1102,3.13,0.78,2021,22,13.694444444444445,3.130081300813008,447,33,480,0.45208333333333334
2021-22,RegularSeason,203552,82,Seth Curry,1610612751,BKN,64,2134,360,739,0.487,158,374,0.422,82,94,0.872,21,179,200,230,53,14,109,148,960,957,2.11,0.49,2021,22,15.0,2.110091743119266,379,12,391,0.5115089514066496
2021-22,RegularSeason,101108,83,Chris Paul,1610612756,PHX,65,2139,363,736,0.493,63,199,0.317,169,202,0.837,22,261,283,702,121,20,153,134,958,1525,4.59,0.79,2021,22,14.738461538461538,4.588235294117647,373,33,406,0.6970443349753694
2021-22,RegularSeason,1627736,84,Malik Beasley,1610612750,MIN,79,1976,332,850,0.391,240,637,0.377,49,60,0.817,26,201,227,116,43,12,43,88,953,779,2.7,1.0,2021,22,12.063291139240507,2.697674418604651,518,11,529,0.42911153119092627
2021-22,RegularSeason,203992,85,Bogdan Bogdanovic,1610612737,ATL,63,1849,342,794,0.431,169,459,0.368,97,115,0.843,29,221,250,194,68,14,70,132,950,936,2.77,0.97,2021,22,15.079365079365079,2.7714285714285714,452,18,470,0.5319148936170213
2021-22,RegularSeason,1629645,86,Kevin Porter Jr.,1610612745,HOU,61,1907,335,808,0.415,155,413,0.375,124,193,0.642,43,224,267,376,69,22,192,156,949,949,1.96,0.36,2021,22,15.557377049180328,1.9583333333333333,473,69,542,0.492619926199262
2021-22,RegularSeason,1628420,87,Monte Morris,1610612743,DEN,75,2239,374,773,0.484,124,314,0.395,73,84,0.869,27,199,226,333,56,14,78,92,945,1086,4.27,0.72,2021,22,12.6,4.269230769230769,399,11,410,0.551219512195122
2021-22,RegularSeason,202692,88,Alec Burks,1610612752,NYK,81,2318,285,728,0.391,157,389,0.404,217,264,0.822,47,350,397,239,85,26,91,215,944,1110,2.63,0.93,2021,22,11.654320987654321,2.6263736263736264,443,47,490,0.810204081632653
2021-22,RegularSeason,1626149,89,Montrezl Harrell,1610612766,CHA,71,1640,358,555,0.645,4,17,0.235,212,296,0.716,149,282,431,145,29,43,72,137,932,1227,2.01,0.4,2021,22,13.126760563380282,2.013888888888889,197,84,281,1.5338078291814947
2021-22,RegularSeason,1628976,90,Wendell Carter Jr.,1610612753,ORL,62,1852,359,684,0.525,70,214,0.327,143,207,0.691,139,509,648,171,36,43,117,169,931,1323,1.46,0.31,2021,22,15.016129032258064,1.4615384615384615,325,64,389,1.6658097686375322
2021-22,RegularSeason,203078,91,Bradley Beal,1610612764,WAS,40,1439,348,771,0.451,63,210,0.3,169,203,0.833,38,151,189,265,36,15,135,95,928,841,1.96,0.27,2021,22,23.2,1.962962962962963,423,34,457,0.4135667396061269
2021-22,RegularSeason,203076,92,Anthony Davis,1610612747,LAL,40,1404,370,695,0.532,13,70,0.186,174,244,0.713,106,288,394,122,49,90,82,97,927,1105,1.49,0.6,2021,22,23.175,1.4878048780487805,325,70,395,0.9974683544303797
2021-22,RegularSeason,201988,93,Patty Mills,1610612751,BKN,81,2346,324,794,0.408,227,568,0.4,48,59,0.814,18,138,156,183,51,17,73,112,923,776,2.51,0.7,2021,22,11.395061728395062,2.506849315068493,470,11,481,0.32432432432432434
2021-22,RegularSeason,2546,94,Carmelo Anthony,1610612747,LAL,69,1793,319,723,0.441,149,397,0.375,132,159,0.83,62,226,288,68,47,52,59,166,919,884,1.15,0.8,2021,22,13.318840579710145,1.152542372881356,404,27,431,0.6682134570765661
2021-22,RegularSeason,1630256,94,Jae'Sean Tate,1610612745,HOU,78,2056,363,729,0.498,63,202,0.312,130,184,0.707,135,285,420,222,72,41,139,286,919,1115,1.6,0.52,2021,22,11.782051282051283,1.5971223021582734,366,54,420,1.0
2021-22,RegularSeason,203915,94,Spencer Dinwiddie,1610612742,DAL,67,1981,306,735,0.416,112,330,0.339,195,252,0.774,45,234,279,346,44,13,104,150,919,1011,3.33,0.42,2021,22,13.716417910447761,3.326923076923077,429,57,486,0.5740740740740741
2021-22,RegularSeason,1627751,97,Jakob Poeltl,1610612759,SAS,68,1970,410,663,0.618,1,1,1.0,94,190,0.495,262,372,634,189,45,118,109,212,915,1443,1.73,0.41,2021,22,13.455882352941176,1.7339449541284404,253,96,349,1.816618911174785
2021-22,RegularSeason,1628386,98,Jarrett Allen,1610612739,CLE,56,1810,369,545,0.677,1,10,0.1,165,233,0.708,192,410,602,92,44,75,94,97,904,1379,0.98,0.47,2021,22,16.142857142857142,0.9787234042553191,176,68,244,2.4672131147540983
2021-22,RegularSeason,203924,98,Jerami Grant,1610612765,DET,47,1500,298,699,0.426,91,254,0.358,217,259,0.838,28,163,191,111,44,49,85,107,904,771,1.31,0.52,2021,22,19.23404255319149,1.3058823529411765,401,42,443,0.43115124153498874
2021-22,RegularSeason,1628984,100,Devonte' Graham,1610612740,NOP,76,2162,296,815,0.363,192,563,0.341,118,140,0.843,37,140,177,316,71,12,105,95,902,832,3.01,0.68,2021,22,11.868421052631579,3.0095238095238095,519,22,541,0.32717190388170053
2021-22,RegularSeason,1628374,101,Lauri Markkanen,1610612739,CLE,61,1878,313,703,0.445,136,380,0.358,138,159,0.868,59,286,345,81,45,30,54,130,900,936,1.5,0.83,2021,22,14.754098360655737,1.5,390,21,411,0.8394160583941606
2021-22,RegularSeason,1628989,102,Kevin Huerter,1610612737,ATL,74,2188,345,760,0.454,160,411,0.389,42,52,0.808,32,222,254,203,55,26,91,185,892,914,2.23,0.6,2021,22,12.054054054054054,2.230769230769231,415,10,425,0.5976470588235294
2021-22,RegularSeason,1630193,103,Immanuel Quickley,1610612752,NYK,78,1802,284,724,0.392,137,396,0.346,177,201,0.881,31,216,247,275,54,3,99,167,882,898,2.78,0.55,2021,22,11.307692307692308,2.7777777777777777,440,24,464,0.5323275862068966
2021-22,RegularSeason,1627827,104,Dorian Finney-Smith,1610612742,DAL,80,2644,326,692,0.471,172,435,0.395,56,83,0.675,122,253,375,150,88,39,80,183,880,1059,1.88,1.1,2021,22,11.0,1.875,366,27,393,0.9541984732824428
2021-22,RegularSeason,1629652,105,Luguentz Dort,1610612760,OKC,51,1665,293,726,0.404,130,391,0.332,161,191,0.843,38,174,212,88,46,18,88,149,877,690,1.0,0.52,2021,22,17.19607843137255,1.0,433,30,463,0.45788336933045354
2021-22,RegularSeason,1628381,106,John Collins,1610612737,ATL,54,1663,339,644,0.526,64,176,0.364,134,169,0.793,93,329,422,98,33,56,60,164,876,1085,1.63,0.55,2021,22,16.22222222222222,1.6333333333333333,305,35,340,1.2411764705882353
2021-22,RegularSeason,1630170,107,Devin Vassell,1610612759,SAS,71,1937,326,764,0.427,137,380,0.361,83,99,0.838,44,262,306,136,76,41,58,143,872,919,2.35,1.31,2021,22,12.28169014084507,2.3448275862068964,438,16,454,0.6740088105726872
2021-22,RegularSeason,1629611,107,Terance Mann,1610612746,LAC,81,2317,334,690,0.484,76,208,0.365,128,164,0.78,104,321,425,209,55,21,84,178,872,1106,2.49,0.66,2021,22,10.765432098765432,2.488095238095238,356,36,392,1.0841836734693877
2021-22,RegularSeason,203471,109,Dennis Schroder,1610612745,HOU,64,1838,312,724,0.431,86,250,0.344,157,184,0.853,34,180,214,296,53,8,143,154,867,856,2.07,0.37,2021,22,13.546875,2.06993006993007,412,27,439,0.4874715261958998
2021-22,RegularSeason,1629130,110,Duncan Robinson,1610612748,MIA,79,2043,290,726,0.399,232,624,0.372,51,61,0.836,24,179,203,129,42,14,60,201,863,745,2.15,0.7,2021,22,10.924050632911392,2.15,436,10,446,0.4551569506726457
2021-22,RegularSeason,1630558,111,Davion Mitchell,1610612758,SAC,75,2076,352,843,0.418,101,320,0.316,56,85,0.659,33,133,166,313,55,24,114,141,861,785,2.75,0.48,2021,22,11.48,2.745614035087719,491,29,520,0.3192307692307692
2021-22,RegularSeason,203935,111,Marcus Smart,1610612738,BOS,71,2296,300,718,0.418,119,360,0.331,142,179,0.793,42,228,270,417,119,18,159,160,861,1071,2.62,0.75,2021,22,12.126760563380282,2.6226415094339623,418,37,455,0.5934065934065934
2021-22,RegularSeason,1626181,113,Norman Powell,1610612746,LAC,45,1458,279,605,0.461,106,253,0.419,189,233,0.811,20,125,145,96,42,21,69,106,853,718,1.39,0.61,2021,22,18.955555555555556,1.391304347826087,326,44,370,0.3918918918918919
2021-22,RegularSeason,1629022,114,Lonnie Walker IV,1610612759,SAS,70,1612,311,764,0.407,111,353,0.314,116,148,0.784,18,163,181,152,44,19,71,98,849,689,2.14,0.62,2021,22,12.128571428571428,2.140845070422535,453,32,485,0.3731958762886598
2021-22,RegularSeason,200768,115,Kyle Lowry,1610612748,MIA,63,2133,276,627,0.44,144,382,0.377,148,174,0.851,33,249,282,474,67,17,168,177,844,1139,2.82,0.4,2021,22,13.396825396825397,2.8214285714285716,351,26,377,0.7480106100795756
2021-22,RegularSeason,203994,116,Jusuf Nurkic,1610612757,POR,56,1578,321,600,0.535,15,56,0.268,185,268,0.69,167,452,619,157,62,34,143,189,842,1209,1.1,0.43,2021,22,15.035714285714286,1.097902097902098,279,83,362,1.7099447513812154
2021-22,RegularSeason,1628379,117,Luke Kennard,1610612746,LAC,70,1919,287,639,0.449,190,423,0.449,69,77,0.896,20,209,229,146,42,6,60,101,833,836,2.43,0.7,2021,22,11.9,2.433333333333333,352,8,360,0.6361111111111111
2021-22,RegularSeason,202694,118,Marcus Morris Sr.,1610612746,LAC,54,1564,300,691,0.434,101,275,0.367,129,148,0.872,26,213,239,113,28,18,69,115,830,749,1.64,0.41,2021,22,15.37037037037037,1.6376811594202898,391,19,410,0.5829268292682926
2021-22,RegularSeason,1629661,119,Cameron Johnson,1610612756,PHX,66,1730,279,607,0.46,166,391,0.425,98,114,0.86,42,231,273,99,57,16,47,113,822,876,2.11,1.21,2021,22,12.454545454545455,2.106382978723404,328,16,344,0.7936046511627907
2021-22,RegularSeason,1628384,119,OG Anunoby,1610612761,TOR,48,1728,309,697,0.443,115,317,0.363,89,118,0.754,74,190,264,125,71,25,80,131,822,810,1.56,0.89,2021,22,17.125,1.5625,388,29,417,0.6330935251798561
2021-22,RegularSeason,203991,121,Clint Capela,1610612737,ATL,74,2042,370,604,0.613,0,1,0.0,80,169,0.473,279,598,877,92,55,93,44,166,820,1570,2.09,1.25,2021,22,11.08108108108108,2.090909090909091,234,89,323,2.7151702786377707
2021-22,RegularSeason,1628404,122,Josh Hart,1610612757,POR,54,1791,287,569,0.504,73,213,0.343,160,211,0.758,62,326,388,224,61,13,114,150,807,1046,1.97,0.54,2021,22,14.944444444444445,1.9649122807017543,282,51,333,1.165165165165165
2021-22,RegularSeason,202681,123,Kyrie Irving,1610612751,BKN,29,1092,289,616,0.469,100,239,0.418,118,129,0.915,16,111,127,167,41,17,73,81,796,737,2.29,0.56,2021,22,27.448275862068964,2.287671232876712,327,11,338,0.3757396449704142
2021-22,RegularSeason,1629001,124,De'Anthony Melton,1610612763,MEM,73,1657,281,695,0.404,139,372,0.374,90,120,0.75,64,264,328,194,104,39,112,128,791,900,1.73,0.93,2021,22,10.835616438356164,1.7321428571428572,414,30,444,0.7387387387387387
2021-22,RegularSeason,1626168,125,Trey Lyles,1610612758,SAC,75,1536,262,562,0.466,67,209,0.321,195,243,0.802,89,290,379,88,29,32,73,123,786,893,1.21,0.4,2021,22,10.48,1.2054794520547945,300,48,348,1.089080459770115
2021-22,RegularSeason,1627826,126,Ivica Zubac,1610612746,LAC,76,1852,310,495,0.626,0,0,0.0,165,227,0.727,217,427,644,120,36,77,114,203,785,1301,1.05,0.32,2021,22,10.328947368421053,1.0526315789473684,185,62,247,2.6072874493927127
2021-22,RegularSeason,202330,127,Gordon Hayward,1610612766,CHA,49,1564,283,617,0.459,86,220,0.391,126,149,0.846,38,186,224,177,47,22,81,85,778,810,2.19,0.58,2021,22,15.877551020408163,2.185185185185185,334,23,357,0.6274509803921569
2021-22,RegularSeason,1629632,128,Coby White,1610612741,CHI,61,1675,279,644,0.433,136,353,0.385,78,91,0.857,17,165,182,176,29,11,70,137,772,722,2.51,0.41,2021,22,12.655737704918034,2.5142857142857142,365,13,378,0.48148148148148145
2021-22,RegularSeason,201145,128,Jeff Green,1610612743,DEN,75,1849,277,529,0.524,53,168,0.315,165,198,0.833,41,190,231,96,28,27,71,151,772,798,1.35,0.39,2021,22,10.293333333333333,1.352112676056338,252,33,285,0.8105263157894737
2021-22,RegularSeason,201568,130,Danilo Gallinari,1610612737,ATL,66,1672,259,597,0.434,112,294,0.381,141,156,0.904,35,273,308,101,28,12,38,93,771,829,2.66,0.74,2021,22,11.681818181818182,2.6578947368421053,338,15,353,0.8725212464589235
2021-22,RegularSeason,201569,131,Eric Gordon,1610612745,HOU,57,1670,268,564,0.475,124,301,0.412,105,135,0.778,15,98,113,154,28,18,107,63,765,645,1.44,0.26,2021,22,13.421052631578947,1.439252336448598,296,30,326,0.34662576687116564
2021-22,RegularSeason,1628964,132,Mo Bamba,1610612753,ORL,71,1824,296,617,0.48,107,281,0.381,57,73,0.781,148,424,572,85,38,118,77,182,756,1155,1.1,0.49,2021,22,10.647887323943662,1.103896103896104,321,16,337,1.6973293768545994
2021-22,RegularSeason,1628449,133,Chris Boucher,1610612761,TOR,80,1690,268,577,0.464,68,229,0.297,150,193,0.777,179,315,494,25,49,75,42,174,754,1003,0.59,1.17,2021,22,9.425,0.5952380952380952,309,43,352,1.4034090909090908
2021-22,RegularSeason,202331,133,Paul George,1610612746,LAC,31,1077,268,636,0.421,91,257,0.354,127,148,0.858,12,201,213,176,67,13,126,74,754,708,1.4,0.53,2021,22,24.322580645161292,1.3968253968253967,368,21,389,0.5475578406169666
2021-22,RegularSeason,203200,135,Justin Holiday,1610612758,SAC,74,2057,261,662,0.394,177,482,0.367,50,62,0.806,29,161,190,128,57,33,70,154,749,674,1.83,0.81,2021,22,10.121621621621621,1.8285714285714285,401,12,413,0.4600484261501211
2021-22,RegularSeason,1629647,136,Darius Bazley,1610612760,OKC,69,1924,274,649,0.422,80,269,0.297,117,170,0.688,71,365,436,97,58,70,90,68,745,888,1.08,0.64,2021,22,10.797101449275363,1.0777777777777777,375,53,428,1.0186915887850467
2021-22,RegularSeason,1630529,137,Herbert Jones,1610612740,NOP,78,2335,274,576,0.476,57,169,0.337,137,163,0.84,98,198,296,167,130,60,100,238,742,967,1.67,1.3,2021,22,9.512820512820513,1.67,302,26,328,0.9024390243902439
2021-22,RegularSeason,1628960,138,Grayson Allen,1610612749,MIL,66,1805,255,569,0.448,159,389,0.409,64,74,0.865,32,190,222,100,46,18,43,96,733,752,2.33,1.07,2021,22,11.106060606060606,2.3255813953488373,314,10,324,0.6851851851851852
2021-22,RegularSeason,1629622,139,Max Strus,1610612748,MIA,68,1587,249,564,0.441,181,442,0.41,42,53,0.792,24,178,202,92,28,16,57,116,721,676,1.61,0.49,2021,22,10.602941176470589,1.6140350877192982,315,11,326,0.6196319018404908
2021-22,RegularSeason,1630537,140,Chris Duarte,1610612754,IND,55,1541,268,621,0.432,94,255,0.369,90,112,0.804,41,185,226,114,56,10,90,95,720,661,1.27,0.62,2021,22,13.090909090909092,1.2666666666666666,353,22,375,0.6026666666666667
2021-22,RegularSeason,203939,141,Dwight Powell,1610612742,DAL,82,1798,269,401,0.671,13,37,0.351,166,212,0.783,173,231,404,97,37,39,64,220,717,1052,1.52,0.58,2021,22,8.74390243902439,1.515625,132,46,178,2.269662921348315
2021-22,RegularSeason,1626224,142,Cedi Osman,1610612739,CLE,66,1462,247,572,0.432,128,359,0.357,87,131,0.664,25,121,146,135,52,10,67,127,709,616,2.02,0.78,2021,22,10.742424242424242,2.014925373134328,325,44,369,0.3956639566395664
2021-22,RegularSeason,1629631,142,De'Andre Hunter,1610612737,ATL,53,1577,254,575,0.442,74,195,0.379,127,166,0.765,26,150,176,68,36,21,69,155,709,581,0.99,0.52,2021,22,13.377358490566039,0.9855072463768116,321,39,360,0.4888888888888889
2021-22,RegularSeason,201143,144,Al Horford,1610612738,BOS,69,2005,266,569,0.467,89,265,0.336,80,95,0.842,108,422,530,232,49,92,65,130,701,1221,3.57,0.75,2021,22,10.159420289855072,3.5692307692307694,303,15,318,1.6666666666666667
2021-22,RegularSeason,1627777,145,Georges Niang,1610612755,PHI,76,1736,246,563,0.437,156,387,0.403,52,59,0.881,25,178,203,102,30,13,59,190,700,665,1.73,0.51,2021,22,9.210526315789474,1.728813559322034,317,7,324,0.6265432098765432
2021-22,RegularSeason,1630538,146,Bones Hyland,1610612743,DEN,69,1310,230,571,0.403,131,358,0.366,107,125,0.856,14,174,188,191,41,20,86,153,698,693,2.22,0.48,2021,22,10.115942028985508,2.2209302325581395,341,18,359,0.5236768802228412
2021-22,RegularSeason,1630231,147,KJ Martin,1610612745,HOU,79,1656,279,523,0.533,60,168,0.357,78,123,0.634,80,217,297,101,34,40,60,113,696,819,1.68,0.57,2021,22,8.810126582278482,1.6833333333333333,244,45,289,1.027681660899654
2021-22,RegularSeason,203081,148,Damian Lillard,1610612757,POR,29,1056,222,552,0.402,92,284,0.324,159,181,0.878,13,107,120,212,17,11,83,37,695,620,2.55,0.2,2021,22,23.96551724137931,2.5542168674698793,330,22,352,0.3409090909090909
2021-22,RegularSeason,1630578,149,Alperen Sengun,1610612745,HOU,72,1489,249,525,0.474,29,117,0.248,165,232,0.711,138,255,393,185,59,68,145,214,692,909,1.28,0.41,2021,22,9.61111111111111,1.2758620689655173,276,67,343,1.1457725947521866
2021-22,RegularSeason,1629638,149,Nickeil Alexander-Walker,1610612762,UTA,65,1466,253,680,0.372,105,338,0.311,81,109,0.743,37,150,187,156,46,23,93,103,692,556,1.68,0.49,2021,22,10.646153846153846,1.6774193548387097,427,28,455,0.41098901098901097
2021-22,RegularSeason,1627763,151,Malcolm Brogdon,1610612754,IND,36,1206,243,543,0.448,58,186,0.312,143,167,0.856,33,152,185,212,30,14,77,71,687,727,2.75,0.39,2021,22,19.083333333333332,2.7532467532467533,300,24,324,0.5709876543209876
2021-22,RegularSeason,1630166,152,Deni Avdija,1610612764,WAS,82,1984,250,579,0.432,82,259,0.317,103,136,0.757,52,373,425,167,59,44,87,190,685,931,1.92,0.68,2021,22,8.353658536585366,1.9195402298850575,329,33,362,1.1740331491712708
2021-22,RegularSeason,201580,153,JaVale McGee,1610612756,PHX,74,1172,288,458,0.629,2,9,0.222,102,146,0.699,163,333,496,42,22,81,98,181,680,1009,0.43,0.22,2021,22,9.18918918918919,0.42857142857142855,170,44,214,2.317757009345794
2021-22,RegularSeason,1630245,154,Ayo Dosunmu,1610612741,CHI,77,2110,278,535,0.52,70,186,0.376,53,78,0.679,27,187,214,256,60,29,108,182,679,848,2.37,0.56,2021,22,8.818181818181818,2.3703703703703702,257,25,282,0.7588652482269503
2021-22,RegularSeason,203914,154,Gary Harris,1610612753,ORL,61,1730,240,553,0.434,116,302,0.384,83,95,0.874,36,86,122,108,59,9,61,112,679,591,1.77,0.97,2021,22,11.131147540983607,1.7704918032786885,313,12,325,0.37538461538461537
2021-22,RegularSeason,1629655,156,Daniel Gafford,1610612764,WAS,72,1444,285,411,0.693,0,1,0.0,107,153,0.699,155,252,407,68,30,99,65,170,677,1044,1.05,0.46,2021,22,9.402777777777779,1.0461538461538462,126,46,172,2.366279069767442
2021-22,RegularSeason,1630581,157,Josh Giddey,1610612760,OKC,54,1700,281,670,0.419,56,213,0.263,56,79,0.709,98,323,421,345,51,20,171,88,674,928,2.02,0.3,2021,22,12.481481481481481,2.017543859649123,389,23,412,1.0218446601941749
2021-22,RegularSeason,1629023,158,P.J. Washington,1610612766,CHA,65,1768,250,532,0.47,110,301,0.365,58,81,0.716,82,255,337,147,57,61,82,152,668,883,1.79,0.69,2021,22,10.276923076923078,1.7926829268292683,282,23,305,1.1049180327868853
2021-22,RegularSeason,1629634,159,Brandon Clarke,1610612763,MEM,64,1246,288,447,0.644,5,22,0.227,85,130,0.654,135,207,342,86,39,68,34,122,666,963,2.53,1.15,2021,22,10.40625,2.5294117647058822,159,45,204,1.6764705882352942
2021-22,RegularSeason,1626196,159,Josh Richardson,1610612759,SAS,65,1600,234,534,0.438,102,246,0.415,96,108,0.889,42,143,185,115,56,29,66,116,666,673,1.74,0.85,2021,22,10.246153846153845,1.7424242424242424,300,12,312,0.592948717948718
2021-22,RegularSeason,1630173,161,Precious Achiuwa,1610612761,TOR,73,1725,265,603,0.439,56,156,0.359,78,131,0.595,146,327,473,82,37,41,84,151,664,822,0.98,0.44,2021,22,9.095890410958905,0.9761904761904762,338,53,391,1.2097186700767264
2021-22,RegularSeason,1627854,162,Bryn Forbes,1610612743,DEN,75,1286,231,539,0.429,122,295,0.414,79,87,0.908,10,83,93,75,25,5,56,95,663,489,1.34,0.45,2021,22,8.84,1.3392857142857142,308,8,316,0.29430379746835444
2021-22,RegularSeason,203463,163,Ben McLemore,1610612757,POR,64,1285,216,539,0.401,151,417,0.362,72,88,0.818,12,91,103,59,38,10,55,103,655,471,1.07,0.69,2021,22,10.234375,1.0727272727272728,323,16,339,0.30383480825958703
2021-22,RegularSeason,1629637,164,Jaxson Hayes,1610612740,NOP,70,1398,245,398,0.616,20,57,0.351,144,188,0.766,115,200,315,43,33,55,54,155,654,849,0.8,0.61,2021,22,9.342857142857143,0.7962962962962963,153,44,197,1.598984771573604
2021-22,RegularSeason,1630228,165,Jonathan Kuminga,1610612744,GSW,70,1185,236,460,0.513,50,149,0.336,130,190,0.684,54,180,234,64,31,22,74,146,652,645,0.86,0.42,2021,22,9.314285714285715,0.8648648648648649,224,60,284,0.823943661971831
2021-22,RegularSeason,202691,165,Klay Thompson,1610612744,GSW,32,941,246,573,0.429,114,296,0.385,46,51,0.902,15,110,125,88,16,17,43,54,652,523,2.05,0.37,2021,22,20.375,2.046511627906977,327,5,332,0.37650602409638556
2021-22,RegularSeason,1629726,167,Garrison Mathews,1610612745,HOU,65,1712,184,461,0.399,139,386,0.36,143,180,0.794,32,158,190,64,57,24,41,168,650,630,1.56,1.39,2021,22,10.0,1.5609756097560976,277,37,314,0.6050955414012739
2021-22,RegularSeason,1630167,168,Obi Toppin,1610612752,NYK,72,1230,251,473,0.531,52,169,0.308,94,124,0.758,69,199,268,77,25,33,56,102,648,743,1.38,0.45,2021,22,9.0,1.375,222,30,252,1.0634920634920635
2021-22,RegularSeason,1628971,169,Bruce Brown,1610612751,BKN,72,1774,256,506,0.506,38,94,0.404,97,128,0.758,100,245,345,148,77,52,56,176,647,932,2.64,1.38,2021,22,8.98611111111111,2.642857142857143,250,31,281,1.2277580071174377
2021-22,RegularSeason,1630183,169,Jaden McDaniels,1610612750,MIN,70,1803,255,554,0.46,80,252,0.317,57,71,0.803,76,217,293,79,52,54,75,224,647,737,1.05,0.69,2021,22,9.242857142857142,1.0533333333333332,299,14,313,0.9361022364217252
2021-22,RegularSeason,1626192,171,Pat Connaughton,1610612749,MIL,65,1691,227,496,0.458,146,370,0.395,45,54,0.833,45,228,273,82,59,15,35,86,645,761,2.34,1.69,2021,22,9.923076923076923,2.342857142857143,269,9,278,0.9820143884892086
2021-22,RegularSeason,1629675,172,Naz Reid,1610612750,MIN,77,1215,233,476,0.489,57,166,0.343,114,149,0.765,102,199,301,71,40,71,82,172,637,760,0.87,0.49,2021,22,8.272727272727273,0.8658536585365854,243,35,278,1.0827338129496402
2021-22,RegularSeason,1628977,173,Hamidou Diallo,1610612765,DET,58,1269,261,526,0.496,23,93,0.247,91,140,0.65,69,208,277,73,71,17,58,143,636,702,1.26,1.22,2021,22,10.96551724137931,1.2586206896551724,265,49,314,0.8821656050955414
2021-22,RegularSeason,1630557,174,Corey Kispert,1610612764,WAS,77,1801,234,514,0.455,112,320,0.35,54,62,0.871,53,156,209,85,35,22,50,93,634,647,1.7,0.7,2021,22,8.233766233766234,1.7,280,8,288,0.7256944444444444
2021-22,RegularSeason,203109,175,Jae Crowder,1610612756,PHX,67,1886,217,544,0.399,127,365,0.348,71,90,0.789,30,324,354,124,95,30,55,173,632,834,2.25,1.73,2021,22,9.432835820895523,2.2545454545454544,327,19,346,1.023121387283237
2021-22,RegularSeason,1626145,175,Tyus Jones,1610612763,MEM,73,1549,249,552,0.451,80,205,0.39,54,66,0.818,17,159,176,324,66,2,46,32,632,839,7.04,1.44,2021,22,8.657534246575343,7.043478260869565,303,12,315,0.5587301587301587
2021-22,RegularSeason,203082,177,Terrence Ross,1610612753,ORL,63,1448,220,554,0.397,77,264,0.292,112,130,0.862,20,141,161,116,28,12,75,68,629,519,1.55,0.37,2021,22,9.984126984126984,1.5466666666666666,334,18,352,0.45738636363636365
2021-22,RegularSeason,1626166,178,Cameron Payne,1610612756,PHX,58,1278,240,587,0.409,71,211,0.336,75,89,0.843,24,151,175,282,40,17,103,119,626,676,2.74,0.39,2021,22,10.793103448275861,2.737864077669903,347,14,361,0.48476454293628807
2021-22,RegularSeason,1630544,179,Tre Mann,1610612760,OKC,60,1367,231,588,0.393,98,272,0.36,65,82,0.793,25,146,171,91,47,12,71,102,625,501,1.28,0.66,2021,22,10.416666666666666,1.2816901408450705,357,17,374,0.4572192513368984
2021-22,RegularSeason,1629599,180,Amir Coffey,1610612746,LAC,69,1567,211,466,0.453,96,254,0.378,101,117,0.863,26,171,197,124,38,15,45,87,619,677,2.76,0.84,2021,22,8.971014492753623,2.7555555555555555,255,16,271,0.7269372693726938
2021-22,RegularSeason,1629052,181,Oshae Brissett,1610612754,IND,67,1564,208,506,0.411,83,237,0.35,114,164,0.695,108,250,358,72,44,29,54,116,613,714,1.33,0.81,2021,22,9.149253731343284,1.3333333333333333,298,50,348,1.028735632183908
2021-22,RegularSeason,1629011,182,Mitchell Robinson,1610612752,NYK,72,1848,261,343,0.761,0,0,0.0,88,181,0.486,295,322,617,38,58,133,60,195,610,1221,0.63,0.97,2021,22,8.472222222222221,0.6333333333333333,82,93,175,3.525714285714286
2021-22,RegularSeason,200746,183,LaMarcus Aldridge,1610612751,BKN,47,1050,252,458,0.55,14,46,0.304,89,102,0.873,73,185,258,42,14,47,44,78,607,705,0.95,0.32,2021,22,12.914893617021276,0.9545454545454546,206,13,219,1.178082191780822
2021-22,RegularSeason,1629057,183,Robert Williams III,1610612738,BOS,61,1804,271,368,0.736,0,1,0.0,65,90,0.722,238,350,588,121,56,134,63,137,607,1321,1.92,0.89,2021,22,9.950819672131148,1.9206349206349207,97,25,122,4.819672131147541
2021-22,RegularSeason,1629643,185,Chuma Okeke,1610612753,ORL,70,1749,216,575,0.376,118,371,0.318,55,65,0.846,47,300,347,118,97,42,57,95,605,783,2.07,1.7,2021,22,8.642857142857142,2.0701754385964914,359,10,369,0.940379403794038
2021-22,RegularSeason,203496,186,Robert Covington,1610612746,LAC,71,1940,209,498,0.42,128,339,0.378,58,69,0.841,59,332,391,92,103,91,75,190,604,906,1.23,1.37,2021,22,8.507042253521126,1.2266666666666666,289,11,300,1.3033333333333332
2021-22,RegularSeason,1629684,187,Grant Williams,1610612738,BOS,77,1875,205,432,0.475,106,258,0.411,86,95,0.905,64,210,274,78,38,57,62,186,602,751,1.26,0.61,2021,22,7.818181818181818,1.2580645161290323,227,9,236,1.1610169491525424
2021-22,RegularSeason,203501,188,Tim Hardaway Jr.,1610612742,DAL,42,1245,209,530,0.394,102,304,0.336,78,103,0.757,13,143,156,92,38,6,34,74,598,510,2.71,1.12,2021,22,14.238095238095237,2.7058823529411766,321,25,346,0.4508670520231214
2021-22,RegularSeason,1629659,189,Talen Horton-Tucker,1610612747,LAL,60,1511,224,538,0.416,49,182,0.269,100,125,0.8,37,156,193,159,59,29,82,148,597,616,1.94,0.72,2021,22,9.95,1.9390243902439024,314,25,339,0.5693215339233039
2021-22,RegularSeason,1629216,190,Gabe Vincent,1610612748,MIA,68,1589,214,513,0.417,119,323,0.368,44,54,0.815,22,104,126,210,62,12,98,158,591,594,2.14,0.63,2021,22,8.691176470588236,2.142857142857143,299,10,309,0.4077669902912621
2021-22,RegularSeason,1628415,191,Dillon Brooks,1610612763,MEM,32,885,227,526,0.432,46,149,0.309,90,106,0.849,29,73,102,88,36,8,50,105,590,459,1.76,0.72,2021,22,18.4375,1.76,299,16,315,0.3238095238095238
2021-22,RegularSeason,1630191,192,Isaiah Stewart,1610612765,DET,71,1816,250,490,0.51,15,46,0.326,74,103,0.718,226,391,617,82,22,78,85,211,589,1034,0.96,0.26,2021,22,8.295774647887324,0.9647058823529412,240,29,269,2.2936802973977697
2021-22,RegularSeason,1630171,193,Isaac Okoro,1610612739,CLE,67,1981,207,431,0.48,55,157,0.35,119,155,0.768,72,129,201,121,56,22,58,164,588,670,2.09,0.97,2021,22,8.776119402985074,2.086206896551724,224,36,260,0.7730769230769231
2021-22,RegularSeason,1630528,194,Josh Christopher,1610612745,HOU,74,1334,224,500,0.448,56,189,0.296,83,113,0.735,52,134,186,150,65,13,114,97,587,581,1.32,0.57,2021,22,7.9324324324324325,1.3157894736842106,276,30,306,0.6078431372549019
2021-22,RegularSeason,203493,195,Reggie Bullock Jr.,1610612742,DAL,68,1902,201,501,0.401,141,392,0.36,40,48,0.833,33,208,241,83,41,14,40,111,583,614,2.08,1.02,2021,22,8.573529411764707,2.075,300,8,308,0.7824675324675324
2021-22,RegularSeason,203083,196,Andre Drummond,1610612751,BKN,73,1437,247,433,0.57,0,3,0.0,86,164,0.524,229,451,680,131,78,68,115,192,580,1158,1.14,0.68,2021,22,7.945205479452055,1.1391304347826088,186,78,264,2.5757575757575757
2021-22,RegularSeason,203926,197,Doug McDermott,1610612759,SAS,51,1223,215,465,0.462,108,256,0.422,40,51,0.784,18,97,115,64,13,6,43,79,578,472,1.49,0.3,2021,22,11.333333333333334,1.4883720930232558,250,11,261,0.44061302681992337
2021-22,RegularSeason,1629013,198,Landry Shamet,1610612756,PHX,69,1437,191,485,0.394,123,334,0.368,68,81,0.84,16,110,126,108,28,9,41,92,573,496,2.63,0.68,2021,22,8.304347826086957,2.6341463414634148,294,13,307,0.41042345276872966
2021-22,RegularSeason,1630560,199,Cam Thomas,1610612751,BKN,67,1176,218,503,0.433,47,174,0.27,87,105,0.829,16,145,161,78,33,8,55,66,570,492,1.42,0.6,2021,22,8.507462686567164,1.4181818181818182,285,18,303,0.5313531353135313
2021-22,RegularSeason,1626220,199,Royce O'Neale,1610612762,UTA,77,2406,203,444,0.457,119,306,0.389,45,56,0.804,64,304,368,191,86,32,79,183,570,916,2.42,1.09,2021,22,7.402597402597403,2.4177215189873418,241,11,252,1.4603174603174602
2021-22,RegularSeason,1630591,201,Jalen Suggs,1610612753,ORL,48,1307,198,548,0.361,42,196,0.214,126,163,0.773,26,145,171,209,59,19,143,142,564,492,1.46,0.41,2021,22,11.75,1.4615384615384615,350,37,387,0.4418604651162791
2021-22,RegularSeason,1629021,201,Moritz Wagner,1610612753,ORL,63,960,197,396,0.497,66,201,0.328,104,129,0.806,42,190,232,87,20,13,56,123,564,636,1.55,0.36,2021,22,8.952380952380953,1.5535714285714286,199,25,224,1.0357142857142858
2021-22,RegularSeason,1628392,203,Isaiah Hartenstein,1610612746,LAC,68,1216,229,366,0.626,14,30,0.467,91,132,0.689,117,215,332,160,50,77,84,167,563,920,1.91,0.59,2021,22,8.279411764705882,1.9047619047619047,137,41,178,1.8651685393258426
2021-22,RegularSeason,1628402,204,Frank Jackson,1610612765,DET,53,1164,194,483,0.402,86,279,0.308,86,104,0.827,19,68,87,55,27,9,38,89,560,393,1.45,0.71,2021,22,10.566037735849056,1.4473684210526316,289,18,307,0.28338762214983715
2021-22,RegularSeason,1628997,205,Caleb Martin,1610612748,MIA,60,1372,208,410,0.507,64,155,0.413,71,93,0.763,70,160,230,64,58,30,52,104,551,657,1.23,1.11,2021,22,9.183333333333334,1.2307692307692308,202,22,224,1.0267857142857142
2021-22,RegularSeason,1629234,206,Drew Eubanks,1610612757,POR,71,1245,221,371,0.596,5,23,0.217,99,130,0.762,130,252,382,85,31,40,81,122,546,822,1.05,0.38,2021,22,7.690140845070423,1.0493827160493827,150,31,181,2.110497237569061
2021-22,RegularSeason,1628998,207,Cody Martin,1610612766,CHA,71,1866,204,423,0.482,61,159,0.384,75,107,0.701,82,203,285,179,88,32,61,116,544,816,2.93,1.44,2021,22,7.661971830985915,2.9344262295081966,219,32,251,1.1354581673306774
2021-22,RegularSeason,1628963,208,Marvin Bagley III,1610612765,DET,48,1146,225,446,0.504,23,97,0.237,67,101,0.663,105,233,338,36,22,18,39,93,540,660,0.92,0.56,2021,22,11.25,0.9230769230769231,221,34,255,1.3254901960784313
2021-22,RegularSeason,1626167,208,Myles Turner,1610612754,IND,42,1235,200,393,0.509,61,183,0.333,79,105,0.752,65,232,297,44,28,118,54,119,540,754,0.81,0.52,2021,22,12.857142857142858,0.8148148148148148,193,26,219,1.356164383561644
2021-22,RegularSeason,200782,210,P.J. Tucker,1610612748,MIA,71,1981,207,428,0.484,80,193,0.415,45,61,0.738,100,287,387,149,58,15,66,161,539,845,2.26,0.88,2021,22,7.591549295774648,2.257575757575758,221,16,237,1.6329113924050633
2021-22,RegularSeason,1629002,211,Chimezie Metu,1610612758,SAC,60,1279,203,449,0.452,57,186,0.306,71,91,0.78,34,301,335,60,51,32,61,93,534,685,0.98,0.84,2021,22,8.9,0.9836065573770492,246,20,266,1.2593984962406015
2021-22,RegularSeason,202339,211,Eric Bledsoe,1610612757,POR,54,1361,197,468,0.421,51,163,0.313,89,117,0.761,28,154,182,225,69,19,116,85,534,614,1.94,0.59,2021,22,9.88888888888889,1.9396551724137931,271,28,299,0.6086956521739131
2021-22,RegularSeason,202355,211,Hassan Whiteside,1610612762,UTA,65,1162,215,330,0.652,0,0,0.0,104,167,0.623,166,328,494,26,22,103,53,179,534,948,0.49,0.41,2021,22,8.215384615384615,0.49056603773584906,115,63,178,2.7752808988764044
2021-22,RegularSeason,201976,214,Patrick Beverley,1610612750,MIN,58,1476,177,436,0.406,83,242,0.343,96,133,0.722,62,178,240,268,67,52,73,174,533,791,3.67,0.92,2021,22,9.189655172413794,3.671232876712329,259,37,296,0.8108108108108109
2021-22,RegularSeason,203500,215,Steven Adams,1610612763,MEM,76,1999,210,384,0.547,0,1,0.0,108,199,0.543,349,411,760,256,65,60,115,153,528,1289,2.23,0.56,2021,22,6.947368421052632,2.226086956521739,174,91,265,2.8679245283018866
2021-22,RegularSeason,1629669,216,Jaylen Nowell,1610612750,MIN,62,975,196,413,0.475,63,160,0.394,72,92,0.783,22,101,123,130,27,10,36,73,527,544,3.61,0.75,2021,22,8.5,3.611111111111111,217,20,237,0.5189873417721519
2021-22,RegularSeason,203526,217,Raul Neto,1610612764,WAS,70,1372,204,441,0.463,35,120,0.292,83,108,0.769,13,121,134,217,55,3,79,104,526,594,2.75,0.7,2021,22,7.514285714285714,2.7468354430379747,237,25,262,0.5114503816793893
2021-22,RegularSeason,202709,218,Cory Joseph,1610612765,DET,65,1600,178,400,0.445,65,157,0.414,100,113,0.885,29,145,174,237,42,17,85,147,521,671,2.79,0.49,2021,22,8.015384615384615,2.788235294117647,222,13,235,0.7404255319148936
2021-22,RegularSeason,203937,218,Kyle Anderson,1610612763,MEM,69,1484,209,469,0.446,36,109,0.33,67,105,0.638,69,299,368,183,77,45,71,108,521,825,2.58,1.08,2021,22,7.550724637681159,2.5774647887323945,260,38,298,1.2348993288590604
2021-22,RegularSeason,1628470,220,Torrey Craig,1610612756,PHX,78,1596,200,441,0.454,77,234,0.329,39,52,0.75,86,224,310,91,46,36,67,151,516,678,1.36,0.69,2021,22,6.615384615384615,1.3582089552238805,241,13,254,1.220472440944882
2021-22,RegularSeason,203490,221,Otto Porter Jr.,1610612744,GSW,63,1396,193,416,0.464,80,216,0.37,49,61,0.803,86,276,362,94,68,29,37,83,515,796,2.54,1.84,2021,22,8.174603174603174,2.5405405405405403,223,12,235,1.5404255319148936
2021-22,RegularSeason,1629020,222,Jarred Vanderbilt,1610612750,MIN,74,1881,212,361,0.587,2,14,0.143,86,131,0.656,215,409,624,94,99,46,73,181,512,1108,1.29,1.36,2021,22,6.918918918918919,1.2876712328767124,149,45,194,3.216494845360825
2021-22,RegularSeason,1627788,223,Furkan Korkmaz,1610612755,PHI,67,1414,182,470,0.387,77,266,0.289,68,84,0.81,22,153,175,127,33,9,48,58,509,501,2.65,0.69,2021,22,7.597014925373134,2.6458333333333335,288,16,304,0.5756578947368421
2021-22,RegularSeason,1627780,224,Gary Payton II,1610612744,GSW,71,1248,212,344,0.616,43,120,0.358,35,58,0.603,72,175,247,64,96,22,40,131,502,736,1.6,2.4,2021,22,7.070422535211268,1.6,132,23,155,1.5935483870967742
2021-22,RegularSeason,1627752,224,Taurean Prince,1610612750,MIN,69,1177,177,390,0.454,86,229,0.376,62,82,0.756,26,148,174,68,47,23,53,116,502,528,1.28,0.89,2021,22,7.27536231884058,1.2830188679245282,213,20,233,0.7467811158798283
2021-22,RegularSeason,1630533,226,Ziaire Williams,1610612763,MEM,62,1346,191,424,0.45,76,242,0.314,43,55,0.782,26,103,129,65,35,12,41,113,501,456,1.58,0.85,2021,22,8.080645161290322,1.5853658536585367,233,12,245,0.5265306122448979
2021-22,RegularSeason,1629629,227,Cam Reddish,1610612752,NYK,49,1012,165,408,0.404,66,184,0.359,101,112,0.902,25,80,105,48,47,15,57,60,497,401,0.84,0.82,2021,22,10.142857142857142,0.8421052631578947,243,11,254,0.41338582677165353
2021-22,RegularSeason,1626172,228,Kevon Looney,1610612744,GSW,82,1732,208,364,0.571,0,1,0.0,75,125,0.6,208,388,596,165,50,52,67,215,491,1081,2.46,0.75,2021,22,5.987804878048781,2.462686567164179,156,50,206,2.8932038834951457
2021-22,RegularSeason,201587,228,Nicolas Batum,1610612746,LAC,59,1463,179,387,0.463,108,270,0.4,25,38,0.658,29,225,254,100,58,42,40,80,491,684,2.5,1.45,2021,22,8.322033898305085,2.5,208,13,221,1.1493212669683257
2021-22,RegularSeason,1630181,230,R.J. Hampton,1610612753,ORL,64,1402,175,457,0.383,64,183,0.35,75,117,0.641,23,171,194,158,42,13,87,101,489,485,1.82,0.48,2021,22,7.640625,1.8160919540229885,282,42,324,0.5987654320987654
2021-22,RegularSeason,1629670,231,Jordan Nwora,1610612749,MIL,62,1185,186,462,0.403,79,227,0.348,36,43,0.837,37,184,221,59,25,17,57,78,487,469,1.03,0.44,2021,22,7.854838709677419,1.0350877192982457,276,7,283,0.7809187279151943
2021-22,RegularSeason,203486,232,Mason Plumlee,1610612766,CHA,73,1793,205,320,0.641,0,2,0.0,67,171,0.392,176,389,565,226,61,52,100,224,477,1062,2.26,0.61,2021,22,6.534246575342466,2.26,115,104,219,2.5799086757990866
2021-22,RegularSeason,1629060,233,Rui Hachimura,1610612764,WAS,42,944,187,381,0.491,55,123,0.447,46,66,0.697,25,135,160,48,23,9,33,53,475,468,1.46,0.7,2021,22,11.30952380952381,1.4545454545454546,194,20,214,0.7476635514018691
2021-22,RegularSeason,1630613,234,Duane Washington Jr.,1610612754,IND,48,968,173,427,0.405,81,215,0.377,46,61,0.754,4,79,83,85,26,3,57,66,473,344,1.49,0.46,2021,22,9.854166666666666,1.4912280701754386,254,15,269,0.30855018587360594
2021-22,RegularSeason,1630188,235,Jalen Smith,1610612754,IND,51,924,176,350,0.503,40,122,0.328,78,102,0.765,101,206,307,24,15,41,42,96,470,617,0.57,0.36,2021,22,9.215686274509803,0.5714285714285714,174,24,198,1.5505050505050506
2021-22,RegularSeason,1629750,236,Javonte Green,1610612741,CHI,65,1519,176,325,0.542,36,101,0.356,80,96,0.833,91,185,276,60,67,32,30,132,468,708,2.0,2.23,2021,22,7.2,2.0,149,16,165,1.6727272727272726
2021-22,RegularSeason,1626158,236,Richaun Holmes,1610612758,SAC,45,1074,198,300,0.66,2,5,0.4,70,90,0.778,93,224,317,48,17,41,56,128,468,713,0.86,0.3,2021,22,10.4,0.8571428571428571,102,20,122,2.598360655737705
2021-22,RegularSeason,1627814,238,Damion Lee,1610612744,GSW,63,1257,169,383,0.441,63,187,0.337,66,75,0.88,27,176,203,63,39,6,38,95,467,517,1.66,1.03,2021,22,7.412698412698413,1.6578947368421053,214,9,223,0.9103139013452914
2021-22,RegularSeason,1630197,239,Aleksej Pokusevski,1610612760,OKC,61,1233,186,456,0.408,57,197,0.289,35,50,0.7,73,245,318,131,39,38,94,88,464,611,1.39,0.41,2021,22,7.60655737704918,1.3936170212765957,270,15,285,1.1157894736842104
2021-22,RegularSeason,1628366,240,Lonzo Ball,1610612741,CHI,35,1212,162,383,0.423,110,260,0.423,21,28,0.75,35,155,190,178,64,31,82,85,455,608,2.17,0.78,2021,22,13.0,2.1707317073170733,221,7,228,0.8333333333333334
2021-22,RegularSeason,1627745,241,Damian Jones,1610612758,SAC,56,1017,175,266,0.658,10,29,0.345,94,131,0.718,75,171,246,69,26,47,59,130,454,655,1.17,0.44,2021,22,8.107142857142858,1.1694915254237288,91,37,128,1.921875
2021-22,RegularSeason,1629676,241,Isaiah Roby,1610612760,OKC,45,948,166,323,0.514,44,99,0.444,78,116,0.672,75,142,217,71,36,34,43,109,454,574,1.65,0.84,2021,22,10.088888888888889,1.6511627906976745,157,38,195,1.1128205128205129
2021-22,RegularSeason,1630165,243,Killian Hayes,1610612765,DET,66,1647,176,459,0.383,44,167,0.263,57,74,0.77,36,174,210,277,78,35,111,183,453,642,2.5,0.7,2021,22,6.863636363636363,2.4954954954954953,283,17,300,0.7
2021-22,RegularSeason,1626195,243,Willy Hernangomez,1610612740,NOP,50,839,170,327,0.52,4,12,0.333,109,141,0.773,143,195,338,63,21,19,51,97,453,654,1.24,0.41,2021,22,9.06,1.2352941176470589,157,32,189,1.7883597883597884
2021-22,RegularSeason,1629003,245,Shake Milton,1610612755,PHI,55,1179,173,403,0.429,43,133,0.323,61,73,0.836,30,112,142,139,28,17,44,99,450,490,3.16,0.64,2021,22,8.181818181818182,3.159090909090909,230,12,242,0.5867768595041323
2021-22,RegularSeason,200752,246,Rudy Gay,1610612762,UTA,55,1038,157,379,0.414,70,203,0.345,62,79,0.785,55,187,242,56,25,19,47,95,446,502,1.19,0.53,2021,22,8.10909090909091,1.1914893617021276,222,17,239,1.0125523012552302
2021-22,RegularSeason,201937,247,Ricky Rubio,1610612754,IND,34,970,149,411,0.363,59,174,0.339,88,103,0.854,15,126,141,225,49,7,90,75,445,500,2.5,0.54,2021,22,13.088235294117647,2.5,262,15,277,0.5090252707581228
2021-22,RegularSeason,1630559,248,Austin Reaves,1610612747,LAL,61,1418,146,318,0.459,53,167,0.317,99,118,0.839,45,148,193,110,29,20,40,87,444,565,2.75,0.72,2021,22,7.278688524590164,2.75,172,19,191,1.0104712041884816
2021-22,RegularSeason,1630202,249,Payton Pritchard,1610612738,BOS,71,1001,160,373,0.429,101,245,0.412,21,21,1.0,32,102,134,139,25,6,41,61,442,492,3.39,0.61,2021,22,6.225352112676056,3.3902439024390243,213,0,213,0.6291079812206573
2021-22,RegularSeason,202357,250,Nemanja Bjelica,1610612744,GSW,71,1142,160,342,0.468,54,149,0.362,59,81,0.728,62,232,294,159,41,26,87,128,433,662,1.83,0.47,2021,22,6.098591549295775,1.8275862068965518,182,22,204,1.4411764705882353
2021-22,RegularSeason,203210,251,JaMychal Green,1610612743,DEN,67,1085,159,327,0.486,33,124,0.266,81,93,0.871,81,200,281,59,43,26,57,158,432,604,1.03,0.75,2021,22,6.447761194029851,1.0350877192982457,168,12,180,1.5611111111111111
2021-22,RegularSeason,202689,252,Kemba Walker,1610612752,NYK,37,948,149,370,0.403,73,199,0.367,60,71,0.845,14,97,111,131,26,7,48,37,431,426,2.73,0.54,2021,22,11.64864864864865,2.7291666666666665,221,11,232,0.47844827586206895
2021-22,RegularSeason,202326,253,DeMarcus Cousins,1610612743,DEN,48,717,149,324,0.46,37,122,0.303,95,125,0.76,74,196,270,71,35,21,85,139,430,537,0.83,0.41,2021,22,8.958333333333334,0.8352941176470589,175,30,205,1.3170731707317074
2021-22,RegularSeason,203473,254,Dewayne Dedmon,1610612748,MIA,67,1065,164,290,0.566,19,47,0.404,75,100,0.75,105,281,386,47,24,42,70,174,422,700,0.67,0.34,2021,22,6.298507462686567,0.6714285714285714,126,25,151,2.556291390728477
2021-22,RegularSeason,1630598,255,Aaron Wiggins,1610612760,OKC,50,1209,156,337,0.463,42,138,0.304,62,85,0.729,51,127,178,68,30,10,54,93,416,444,1.26,0.56,2021,22,8.32,1.2592592592592593,181,23,204,0.8725490196078431
2021-22,RegularSeason,1630200,256,Tre Jones,1610612759,SAS,69,1148,166,339,0.49,10,51,0.196,71,91,0.78,29,126,155,233,42,7,46,78,413,611,5.07,0.91,2021,22,5.9855072463768115,5.065217391304348,173,20,193,0.8031088082901554
2021-22,RegularSeason,1628467,257,Maxi Kleber,1610612742,DAL,59,1450,141,354,0.398,83,255,0.325,46,65,0.708,70,280,350,68,30,58,47,137,411,638,1.45,0.64,2021,22,6.966101694915254,1.446808510638298,213,19,232,1.5086206896551724
2021-22,RegularSeason,202397,258,Ish Smith,1610612764,WAS,65,1126,185,430,0.43,25,67,0.373,15,24,0.625,25,115,140,244,47,23,78,78,410,532,3.13,0.6,2021,22,6.3076923076923075,3.128205128205128,245,9,254,0.5511811023622047
2021-22,RegularSeason,203087,258,Jeremy Lamb,1610612758,SAC,56,936,133,347,0.383,55,170,0.324,89,106,0.84,26,128,154,81,31,22,37,59,410,430,2.19,0.84,2021,22,7.321428571428571,2.189189189189189,214,17,231,0.6666666666666666
2021-22,RegularSeason,1629642,258,Nassir Little,1610612757,POR,42,1088,145,315,0.46,51,154,0.331,69,94,0.734,58,178,236,54,25,36,40,82,410,526,1.35,0.63,2021,22,9.761904761904763,1.35,170,25,195,1.2102564102564102
2021-22,RegularSeason,1629651,258,Nic Claxton,1610612751,BKN,47,974,178,264,0.674,0,0,0.0,54,93,0.581,91,173,264,43,24,51,38,110,410,629,1.13,0.63,2021,22,8.72340425531915,1.131578947368421,86,39,125,2.112
2021-22,RegularSeason,203085,262,Austin Rivers,1610612743,DEN,67,1480,146,350,0.417,79,231,0.342,32,44,0.727,19,95,114,90,51,6,54,121,403,394,1.67,0.94,2021,22,6.014925373134329,1.6666666666666667,204,12,216,0.5277777777777778
2021-22,RegularSeason,1628988,263,Aaron Holiday,1610612756,PHX,63,1021,151,338,0.447,39,103,0.379,59,68,0.868,24,98,122,153,42,9,67,92,400,463,2.28,0.63,2021,22,6.349206349206349,2.283582089552239,187,9,196,0.6224489795918368
2021-22,RegularSeason,202340,264,Avery Bradley,1610612747,LAL,62,1406,148,350,0.423,82,210,0.39,16,18,0.889,31,105,136,47,53,9,38,118,394,397,1.24,1.4,2021,22,6.354838709677419,1.236842105263158,202,2,204,0.6666666666666666
2021-22,RegularSeason,1630168,265,Onyeka Okongwu,1610612737,ATL,48,992,156,226,0.69,0,0,0.0,80,110,0.727,115,168,283,53,31,60,44,149,392,675,1.21,0.7,2021,22,8.166666666666666,1.2045454545454546,70,30,100,2.83
2021-22,RegularSeason,1628464,266,Daniel Theis,1610612738,BOS,47,977,151,291,0.519,33,107,0.308,49,72,0.681,59,169,228,41,20,31,46,111,384,495,0.89,0.43,2021,22,8.170212765957446,0.8913043478260869,140,23,163,1.3987730061349692
2021-22,RegularSeason,202362,266,Lance Stephenson,1610612754,IND,46,814,147,323,0.455,27,90,0.3,63,80,0.788,12,115,127,165,24,4,72,96,384,439,2.29,0.33,2021,22,8.347826086956522,2.2916666666666665,176,17,193,0.6580310880829016
2021-22,RegularSeason,1630205,268,Lamar Stevens,1610612739,CLE,63,1015,156,319,0.489,18,65,0.277,53,75,0.707,47,117,164,44,31,18,41,106,383,414,1.07,0.76,2021,22,6.079365079365079,1.0731707317073171,163,22,185,0.8864864864864865
2021-22,RegularSeason,1628978,269,Donte DiVincenzo,1610612758,SAC,42,1005,118,336,0.351,74,218,0.339,70,83,0.843,40,130,170,118,48,8,72,69,380,421,1.64,0.67,2021,22,9.047619047619047,1.6388888888888888,218,13,231,0.7359307359307359
2021-22,RegularSeason,1629680,270,Matisse Thybulle,1610612755,PHI,66,1685,150,300,0.5,45,144,0.313,34,43,0.791,42,109,151,75,115,71,39,158,379,593,1.92,2.95,2021,22,5.742424242424242,1.9230769230769231,150,9,159,0.949685534591195
2021-22,RegularSeason,2730,271,Dwight Howard,1610612747,LAL,60,971,134,219,0.612,8,15,0.533,96,146,0.658,118,238,356,35,34,36,47,115,372,651,0.74,0.72,2021,22,6.2,0.7446808510638298,85,50,135,2.637037037037037
2021-22,RegularSeason,201980,272,Danny Green,1610612755,PHI,62,1353,126,320,0.394,103,271,0.38,11,14,0.786,32,125,157,64,60,37,45,105,366,442,1.42,1.33,2021,22,5.903225806451613,1.4222222222222223,194,3,197,0.7969543147208121
2021-22,RegularSeason,1630526,272,Jeremiah Robinson-Earl,1610612760,OKC,49,1087,134,324,0.414,58,165,0.352,40,54,0.741,75,199,274,49,29,15,39,75,366,490,1.26,0.74,2021,22,7.469387755102041,1.2564102564102564,190,14,204,1.3431372549019607
2021-22,RegularSeason,203482,274,Kelly Olynyk,1610612765,DET,40,764,128,286,0.448,40,119,0.336,69,89,0.775,54,123,177,111,31,19,58,100,365,467,1.91,0.53,2021,22,9.125,1.9137931034482758,158,20,178,0.9943820224719101
2021-22,RegularSeason,201586,274,Serge Ibaka,1610612749,MIL,54,878,148,296,0.5,37,99,0.374,32,44,0.727,62,188,250,49,11,33,43,102,365,505,1.14,0.26,2021,22,6.7592592592592595,1.1395348837209303,148,12,160,1.5625
2021-22,RegularSeason,1630570,276,Trendon Watford,1610612757,POR,48,869,142,267,0.532,9,38,0.237,71,94,0.755,57,142,199,81,25,28,44,116,364,505,1.84,0.57,2021,22,7.583333333333333,1.8409090909090908,125,23,148,1.3445945945945945
2021-22,RegularSeason,1629026,277,Kenrich Williams,1610612760,OKC,49,1072,146,317,0.461,41,121,0.339,30,55,0.545,75,145,220,108,44,10,46,81,363,503,2.35,0.96,2021,22,7.408163265306122,2.347826086956522,171,25,196,1.1224489795918366
2021-22,RegularSeason,1630177,278,Theo Maledon,1610612760,OKC,51,908,119,317,0.375,44,150,0.293,79,100,0.79,20,111,131,111,31,11,65,67,361,361,1.71,0.48,2021,22,7.078431372549019,1.7076923076923076,198,21,219,0.5981735159817352
2021-22,RegularSeason,201933,279,Blake Griffin,1610612751,BKN,56,958,133,313,0.425,38,145,0.262,55,76,0.724,60,168,228,105,27,14,31,95,359,501,3.39,0.87,2021,22,6.410714285714286,3.3870967741935485,180,21,201,1.1343283582089552
2021-22,RegularSeason,101150,280,Lou Williams,1610612737,ATL,56,799,125,320,0.391,37,102,0.363,67,78,0.859,16,71,87,105,28,3,43,48,354,328,2.44,0.65,2021,22,6.321428571428571,2.441860465116279,195,11,206,0.4223300970873786
2021-22,RegularSeason,1629048,281,Goga Bitadze,1610612754,IND,50,729,131,252,0.52,23,80,0.288,64,94,0.681,79,98,177,55,21,42,46,107,349,447,1.2,0.46,2021,22,6.98,1.1956521739130435,121,30,151,1.1721854304635762
2021-22,RegularSeason,1629723,281,John Konchar,1610612763,MEM,72,1292,135,262,0.515,52,126,0.413,27,49,0.551,87,242,329,109,45,22,29,90,349,676,3.76,1.55,2021,22,4.847222222222222,3.7586206896551726,127,22,149,2.208053691275168
2021-22,RegularSeason,203110,283,Draymond Green,1610612744,GSW,46,1329,135,257,0.525,16,54,0.296,60,91,0.659,45,291,336,320,61,50,139,136,346,821,2.3,0.44,2021,22,7.521739130434782,2.302158273381295,122,31,153,2.196078431372549
2021-22,RegularSeason,203488,284,Mike Muscala,1610612760,OKC,43,593,113,248,0.456,70,163,0.429,48,57,0.842,21,108,129,22,18,26,14,58,344,381,1.57,1.29,2021,22,8.0,1.5714285714285714,135,9,144,0.8958333333333334
2021-22,RegularSeason,202684,284,Tristan Thompson,1610612741,CHI,57,896,141,267,0.528,1,3,0.333,61,116,0.526,120,168,288,34,23,21,45,98,344,484,0.76,0.51,2021,22,6.035087719298246,0.7555555555555555,126,55,181,1.591160220994475
2021-22,RegularSeason,1630527,286,Brandon Boston Jr.,1610612746,LAC,51,760,125,325,0.385,34,111,0.306,59,72,0.819,17,94,111,51,26,13,31,43,343,300,1.65,0.84,2021,22,6.7254901960784315,1.6451612903225807,200,13,213,0.5211267605633803
2021-22,RegularSeason,1626153,287,Delon Wright,1610612737,ATL,77,1453,122,269,0.454,44,116,0.379,54,63,0.857,50,170,220,188,93,19,45,56,342,661,4.18,2.07,2021,22,4.441558441558442,4.177777777777778,147,9,156,1.4102564102564104
2021-22,RegularSeason,1629667,288,Jalen McDaniels,1610612766,CHA,55,895,123,254,0.484,41,108,0.38,53,72,0.736,37,133,170,58,26,22,36,93,340,430,1.61,0.72,2021,22,6.181818181818182,1.6111111111111112,131,19,150,1.1333333333333333
2021-22,RegularSeason,201949,288,James Johnson,1610612751,BKN,62,1191,144,307,0.469,23,85,0.271,29,55,0.527,51,164,215,130,30,34,48,162,340,512,2.71,0.63,2021,22,5.483870967741935,2.7083333333333335,163,26,189,1.1375661375661377
2021-22,RegularSeason,1629660,288,Ty Jerome,1610612760,OKC,48,801,124,328,0.378,54,186,0.29,38,47,0.809,19,59,78,109,30,5,37,73,340,312,2.95,0.81,2021,22,7.083333333333333,2.945945945945946,204,9,213,0.36619718309859156
2021-22,RegularSeason,1629604,291,CJ Elleby,1610612757,POR,58,1174,121,308,0.393,37,126,0.294,60,84,0.714,66,161,227,87,35,19,56,116,339,440,1.55,0.63,2021,22,5.844827586206897,1.5535714285714286,187,24,211,1.0758293838862558
2021-22,RegularSeason,1628966,292,Keita Bates-Diop,1610612759,SAS,59,957,136,263,0.517,17,55,0.309,46,61,0.754,62,169,231,41,27,14,45,61,335,461,0.91,0.6,2021,22,5.677966101694915,0.9111111111111111,127,15,142,1.6267605633802817
2021-22,RegularSeason,1629672,293,Eric Paschall,1610612762,UTA,58,737,114,235,0.485,40,108,0.37,66,86,0.767,30,76,106,36,9,5,27,51,334,322,1.33,0.33,2021,22,5.758620689655173,1.3333333333333333,121,20,141,0.75177304964539
2021-22,RegularSeason,201588,293,George Hill,1610612749,MIL,54,1253,118,275,0.429,41,134,0.306,57,62,0.919,38,117,155,120,42,6,41,70,334,454,2.93,1.02,2021,22,6.185185185185185,2.926829268292683,157,5,162,0.9567901234567902
2021-22,RegularSeason,1630530,293,Trey Murphy III,1610612740,NOP,62,864,109,277,0.394,71,186,0.382,45,51,0.882,47,100,147,38,23,7,16,60,334,359,2.38,1.44,2021,22,5.387096774193548,2.375,168,6,174,0.8448275862068966
2021-22,RegularSeason,1630267,296,Facundo Campazzo,1610612743,DEN,65,1184,107,296,0.361,58,193,0.301,60,78,0.769,23,94,117,220,63,23,67,124,332,481,3.28,0.94,2021,22,5.107692307692307,3.283582089552239,189,18,207,0.5652173913043478
2021-22,RegularSeason,1630631,297,Jose Alvarado,1610612740,NOP,54,834,131,294,0.446,32,110,0.291,36,53,0.679,25,75,100,152,71,7,40,73,330,440,3.8,1.77,2021,22,6.111111111111111,3.8,163,17,180,0.5555555555555556
2021-22,RegularSeason,1628367,298,Josh Jackson,1610612758,SAC,51,830,120,300,0.4,33,130,0.254,55,77,0.714,21,120,141,54,26,22,47,88,328,322,1.15,0.55,2021,22,6.431372549019608,1.148936170212766,180,22,202,0.698019801980198
2021-22,RegularSeason,204060,299,Joe Ingles,1610612757,POR,45,1122,115,285,0.404,78,225,0.347,17,22,0.773,12,119,131,158,23,5,46,82,325,421,3.44,0.5,2021,22,7.222222222222222,3.4347826086956523,170,5,175,0.7485714285714286
2021-22,RegularSeason,201152,300,Thaddeus Young,1610612761,TOR,52,845,141,272,0.518,17,48,0.354,23,49,0.469,80,128,208,104,54,18,52,81,322,497,2.0,1.04,2021,22,6.1923076923076925,2.0,131,26,157,1.3248407643312101
2021-22,RegularSeason,1626204,301,Larry Nance Jr.,1610612740,NOP,46,1040,129,247,0.522,23,70,0.329,40,57,0.702,72,176,248,81,43,20,37,84,321,541,2.19,1.16,2021,22,6.978260869565218,2.189189189189189,118,17,135,1.837037037037037
2021-22,RegularSeason,1626169,302,Stanley Johnson,1610612747,LAL,48,1094,117,251,0.466,33,105,0.314,53,74,0.716,34,121,155,80,43,14,35,109,320,422,2.29,1.23,2021,22,6.666666666666667,2.2857142857142856,134,21,155,1.0
2021-22,RegularSeason,1630182,303,Josh Green,1610612742,DAL,67,1039,130,256,0.508,28,78,0.359,31,45,0.689,52,109,161,79,45,14,44,115,319,434,1.79,1.02,2021,22,4.7611940298507465,1.7954545454545454,126,14,140,1.15
2021-22,RegularSeason,1630678,304,Terry Taylor,1610612754,IND,33,714,135,220,0.614,12,38,0.316,36,51,0.706,95,77,172,41,14,8,23,61,318,430,1.78,0.61,2021,22,9.636363636363637,1.7826086956521738,85,15,100,1.72
2021-22,RegularSeason,1630230,305,Naji Marshall,1610612740,NOP,55,736,109,269,0.405,21,105,0.2,74,93,0.796,38,104,142,62,33,8,46,69,313,333,1.35,0.72,2021,22,5.6909090909090905,1.3478260869565217,160,19,179,0.7932960893854749
2021-22,RegularSeason,201565,306,Derrick Rose,1610612752,NYK,26,636,122,274,0.445,37,92,0.402,30,31,0.968,21,57,78,103,22,12,39,15,311,334,2.64,0.56,2021,22,11.961538461538462,2.641025641025641,152,1,153,0.5098039215686274
2021-22,RegularSeason,202722,306,Dāvis Bertāns,1610612742,DAL,56,806,99,275,0.36,77,230,0.335,36,40,0.9,12,105,117,31,17,12,19,85,311,289,1.63,0.9,2021,22,5.553571428571429,1.631578947368421,176,4,180,0.65
2021-22,RegularSeason,1629056,306,Terence Davis,1610612758,SAC,30,536,113,267,0.423,49,149,0.329,36,44,0.818,11,83,94,40,25,11,33,70,311,286,1.21,0.76,2021,22,10.366666666666667,1.2121212121212122,154,8,162,0.5802469135802469
2021-22,RegularSeason,1630314,309,Brandon Williams,1610612757,POR,24,640,105,282,0.372,31,106,0.292,68,97,0.701,19,55,74,94,24,10,58,52,309,247,1.62,0.41,2021,22,12.875,1.6206896551724137,177,29,206,0.3592233009708738
2021-22,RegularSeason,202066,309,Garrett Temple,1610612740,NOP,59,1098,111,295,0.376,59,185,0.319,28,41,0.683,29,114,143,74,43,23,42,81,309,353,1.76,1.02,2021,22,5.237288135593221,1.7619047619047619,184,13,197,0.7258883248730964
2021-22,RegularSeason,1627936,311,Alex Caruso,1610612741,CHI,41,1147,102,256,0.398,42,126,0.333,58,73,0.795,33,115,148,165,71,15,57,106,304,477,2.9,1.25,2021,22,7.414634146341464,2.8947368421052633,154,15,169,0.8757396449704142
2021-22,RegularSeason,1630209,312,Omer Yurtseven,1610612748,MIA,56,706,130,247,0.526,1,11,0.091,38,61,0.623,85,209,294,49,17,20,41,84,299,498,1.2,0.41,2021,22,5.339285714285714,1.1951219512195121,117,23,140,2.1
2021-22,RegularSeason,1629308,313,Juan Toscano-Anderson,1610612744,GSW,73,994,115,235,0.489,28,87,0.322,40,70,0.571,28,148,176,127,48,17,68,115,298,448,1.87,0.71,2021,22,4.082191780821918,1.8676470588235294,120,30,150,1.1733333333333333
2021-22,RegularSeason,1630543,314,Isaiah Jackson,1610612754,IND,36,541,116,206,0.563,5,16,0.313,60,88,0.682,60,89,149,10,25,52,40,92,297,375,0.25,0.63,2021,22,8.25,0.25,90,28,118,1.2627118644067796
2021-22,RegularSeason,201571,315,D.J. Augustin,1610612747,LAL,55,883,94,222,0.423,68,164,0.415,38,43,0.884,11,57,68,107,17,1,56,39,294,298,1.91,0.3,2021,22,5.345454545454546,1.9107142857142858,128,5,133,0.5112781954887218
2021-22,RegularSeason,1629717,316,Armoni Brooks,1610612761,TOR,54,844,98,289,0.339,74,249,0.297,18,21,0.857,20,83,103,62,28,11,27,74,288,271,2.3,1.04,2021,22,5.333333333333333,2.2962962962962963,191,3,194,0.5309278350515464
2021-22,RegularSeason,1630563,316,Joshua Primo,1610612759,SAS,50,965,101,270,0.374,42,137,0.307,44,59,0.746,32,81,113,81,20,23,57,79,288,284,1.42,0.35,2021,22,5.76,1.4210526315789473,169,15,184,0.6141304347826086
2021-22,RegularSeason,201961,318,Wayne Ellington,1610612747,LAL,43,810,98,237,0.414,82,211,0.389,9,11,0.818,10,67,77,30,23,5,19,42,287,262,1.58,1.21,2021,22,6.674418604651163,1.5789473684210527,139,2,141,0.5460992907801419
2021-22,RegularSeason,1627884,319,Derrick Jones Jr.,1610612741,CHI,51,899,105,195,0.538,20,61,0.328,56,70,0.8,60,109,169,30,25,33,30,105,286,409,1.0,0.83,2021,22,5.607843137254902,1.0,90,14,104,1.625
2021-22,RegularSeason,1627761,320,DeAndre' Bembry,1610612749,MIL,56,1026,124,221,0.561,15,36,0.417,21,35,0.6,42,121,163,66,49,25,31,113,284,445,2.13,1.58,2021,22,5.071428571428571,2.129032258064516,97,14,111,1.4684684684684686
2021-22,RegularSeason,1630556,320,Kessler Edwards,1610612751,BKN,48,987,110,267,0.412,48,136,0.353,16,19,0.842,44,128,172,31,29,24,42,85,284,338,0.74,0.69,2021,22,5.916666666666667,0.7380952380952381,157,3,160,1.075
2021-22,RegularSeason,1628972,322,Troy Brown Jr.,1610612741,CHI,66,1055,108,258,0.419,47,133,0.353,20,26,0.769,39,164,203,66,36,5,26,62,283,411,2.54,1.39,2021,22,4.287878787878788,2.5384615384615383,150,6,156,1.3012820512820513
2021-22,RegularSeason,1628975,323,Jevon Carter,1610612749,MIL,66,905,98,253,0.387,66,170,0.388,15,18,0.833,14,96,110,96,24,14,34,67,277,329,2.82,0.71,2021,22,4.196969696969697,2.823529411764706,155,3,158,0.6962025316455697
2021-22,RegularSeason,1629656,324,Quentin Grimes,1610612752,NYK,46,786,95,235,0.404,72,189,0.381,13,19,0.684,24,70,94,44,31,11,28,72,275,281,1.57,1.11,2021,22,5.978260869565218,1.5714285714285714,140,6,146,0.6438356164383562
2021-22,RegularSeason,1626159,325,Justise Winslow,1610612757,POR,48,775,110,257,0.428,15,66,0.227,39,66,0.591,50,152,202,84,35,25,49,67,274,397,1.71,0.71,2021,22,5.708333333333333,1.7142857142857142,147,27,174,1.160919540229885
2021-22,RegularSeason,203585,326,Rodney McGruder,1610612765,DET,51,754,98,225,0.436,58,146,0.397,19,26,0.731,31,80,111,48,21,7,24,58,273,302,2.0,0.88,2021,22,5.352941176470588,2.0,127,7,134,0.8283582089552238
2021-22,RegularSeason,1630192,327,Zeke Nnaji,1610612743,DEN,41,698,96,186,0.516,37,80,0.463,41,65,0.631,56,91,147,17,16,13,23,79,270,326,0.74,0.7,2021,22,6.585365853658536,0.7391304347826086,90,24,114,1.2894736842105263
2021-22,RegularSeason,1629731,328,Dean Wade,1610612739,CLE,51,980,99,217,0.456,51,142,0.359,20,30,0.667,31,119,150,52,29,7,16,88,269,363,3.25,1.81,2021,22,5.2745098039215685,3.25,118,10,128,1.171875
2021-22,RegularSeason,1630553,329,Keon Johnson,1610612757,POR,37,696,96,272,0.353,34,100,0.34,41,51,0.804,24,57,81,76,28,12,46,69,267,232,1.65,0.61,2021,22,7.216216216216216,1.6521739130434783,176,10,186,0.43548387096774194
2021-22,RegularSeason,1629111,330,Jock Landale,1610612759,SAS,54,589,101,204,0.495,29,89,0.326,34,41,0.829,63,75,138,45,10,14,31,53,265,331,1.45,0.32,2021,22,4.907407407407407,1.4516129032258065,103,7,110,1.2545454545454546
2021-22,RegularSeason,1629004,331,Svi Mykhailiuk,1610612761,TOR,56,716,91,234,0.389,41,134,0.306,32,37,0.865,20,72,92,45,26,4,32,54,255,242,1.41,0.81,2021,22,4.553571428571429,1.40625,143,5,148,0.6216216216216216
2021-22,RegularSeason,201577,332,Robin Lopez,1610612753,ORL,36,612,110,199,0.553,2,6,0.333,32,54,0.593,68,58,126,54,2,18,44,67,254,299,1.23,0.04,2021,22,7.055555555555555,1.2272727272727273,89,22,111,1.135135135135135
2021-22,RegularSeason,1630214,333,Xavier Tillman,1610612763,MEM,53,701,98,216,0.454,10,49,0.204,46,71,0.648,66,95,161,62,49,15,34,63,252,362,1.82,1.44,2021,22,4.754716981132075,1.8235294117647058,118,25,143,1.1258741258741258
2021-22,RegularSeason,202083,334,Wesley Matthews,1610612749,MIL,49,1002,87,220,0.395,53,157,0.338,22,28,0.786,30,62,92,36,23,8,18,87,249,251,2.0,1.28,2021,22,5.081632653061225,2.0,133,6,139,0.6618705035971223
2021-22,RegularSeason,1627863,335,Danuel House Jr.,1610612762,UTA,42,727,80,198,0.404,44,117,0.376,44,58,0.759,18,93,111,44,21,17,33,51,248,276,1.33,0.64,2021,22,5.904761904761905,1.3333333333333333,118,14,132,0.8409090909090909
2021-22,RegularSeason,203920,336,Khem Birch,1610612761,TOR,55,991,97,200,0.485,0,14,0.0,53,71,0.746,122,117,239,56,30,26,29,104,247,448,1.93,1.03,2021,22,4.490909090909091,1.9310344827586208,103,18,121,1.975206611570248
2021-22,RegularSeason,1628373,337,Frank Ntilikina,1610612742,DAL,58,685,89,223,0.399,38,111,0.342,24,25,0.96,12,67,79,69,27,7,31,61,240,256,2.23,0.87,2021,22,4.137931034482759,2.225806451612903,134,1,135,0.5851851851851851
2021-22,RegularSeason,203458,338,Alex Len,1610612758,SAC,39,620,94,176,0.534,6,21,0.286,41,63,0.651,52,109,161,45,13,25,43,100,235,332,1.05,0.3,2021,22,6.0256410256410255,1.0465116279069768,82,22,104,1.5480769230769231
2021-22,RegularSeason,1628021,339,David Nwaba,1610612745,HOU,46,609,85,176,0.483,15,49,0.306,48,67,0.716,41,110,151,35,28,20,21,55,233,336,1.67,1.33,2021,22,5.065217391304348,1.6666666666666667,91,19,110,1.3727272727272728
2021-22,RegularSeason,1629162,339,Jordan McLaughlin,1610612750,MIN,62,902,88,200,0.44,27,85,0.318,30,40,0.75,22,72,94,180,57,10,38,54,233,414,4.74,1.5,2021,22,3.7580645161290325,4.7368421052631575,112,10,122,0.7704918032786885
2021-22,RegularSeason,204456,341,T.J. McConnell,1610612754,IND,27,652,100,208,0.481,10,33,0.303,19,23,0.826,20,70,90,131,29,10,29,53,229,348,4.52,1.0,2021,22,8.481481481481481,4.517241379310345,108,4,112,0.8035714285714286
2021-22,RegularSeason,201959,341,Taj Gibson,1610612752,NYK,52,946,86,166,0.518,15,38,0.395,42,52,0.808,88,141,229,32,22,40,27,137,229,435,1.19,0.81,2021,22,4.403846153846154,1.1851851851851851,80,10,90,2.5444444444444443
2021-22,RegularSeason,1630541,343,Moses Moody,1610612744,GSW,52,607,80,183,0.437,40,110,0.364,28,36,0.778,17,63,80,23,7,10,13,43,228,224,1.77,0.54,2021,22,4.384615384615385,1.7692307692307692,103,8,111,0.7207207207207207
2021-22,RegularSeason,1627789,344,Timothe Luwawu-Cabarrot,1610612737,ATL,52,685,74,186,0.398,44,122,0.361,35,41,0.854,17,65,82,40,18,6,20,76,227,235,2.0,0.9,2021,22,4.365384615384615,2.0,112,6,118,0.6949152542372882
2021-22,RegularSeason,1630535,345,Greg Brown III,1610612757,POR,48,640,81,190,0.426,19,61,0.311,44,65,0.677,38,97,135,35,26,24,36,90,225,279,0.97,0.72,2021,22,4.6875,0.9722222222222222,109,21,130,1.0384615384615385
2021-22,RegularSeason,1629641,346,Romeo Langford,1610612759,SAS,48,771,83,191,0.435,29,85,0.341,23,42,0.548,30,78,108,21,22,16,16,47,218,242,1.31,1.38,2021,22,4.541666666666667,1.3125,108,19,127,0.8503937007874016
2021-22,RegularSeason,1628380,346,Zach Collins,1610612759,SAS,28,502,76,155,0.49,14,41,0.341,52,65,0.8,46,107,153,61,13,23,45,67,218,331,1.36,0.29,2021,22,7.785714285714286,1.3555555555555556,79,13,92,1.6630434782608696
2021-22,RegularSeason,203090,348,Maurice Harkless,1610612758,SAC,47,864,83,181,0.459,31,101,0.307,20,28,0.714,12,100,112,23,29,24,31,77,217,268,0.74,0.94,2021,22,4.617021276595745,0.7419354838709677,98,8,106,1.0566037735849056
2021-22,RegularSeason,203504,349,Trey Burke,1610612742,DAL,42,441,84,215,0.391,26,82,0.317,20,23,0.87,4,29,33,57,12,0,26,39,214,156,2.19,0.46,2021,22,5.095238095238095,2.1923076923076925,131,3,134,0.2462686567164179
2021-22,RegularSeason,202687,350,Bismack Biyombo,1610612756,PHX,36,506,86,145,0.593,0,0,0.0,38,71,0.535,63,104,167,23,12,26,25,70,210,321,0.92,0.48,2021,22,5.833333333333333,0.92,59,33,92,1.815217391304348
2021-22,RegularSeason,1629649,350,Ignas Brazdeikis,1610612753,ORL,42,536,81,188,0.431,27,87,0.31,21,32,0.656,23,49,72,37,10,3,17,48,210,197,2.18,0.59,2021,22,5.0,2.176470588235294,107,11,118,0.6101694915254238
2021-22,RegularSeason,1628432,352,Davon Reed,1610612743,DEN,48,668,81,161,0.503,37,86,0.43,10,15,0.667,14,94,108,53,24,9,16,63,209,302,3.31,1.5,2021,22,4.354166666666667,3.3125,80,5,85,1.2705882352941176
2021-22,RegularSeason,1630240,353,Saben Lee,1610612765,DET,37,604,69,177,0.39,14,60,0.233,56,71,0.789,18,69,87,107,36,12,36,44,208,291,2.97,1.0,2021,22,5.621621621621622,2.9722222222222223,108,15,123,0.7073170731707317
2021-22,RegularSeason,201599,354,DeAndre Jordan,1610612755,PHI,48,622,92,143,0.643,0,0,0.0,22,40,0.55,83,181,264,21,12,35,37,71,206,432,0.57,0.32,2021,22,4.291666666666667,0.5675675675675675,51,18,69,3.8260869565217392
2021-22,RegularSeason,1628372,354,Dennis Smith Jr.,1610612757,POR,37,639,79,189,0.418,6,27,0.222,42,64,0.656,20,68,88,132,45,12,51,52,206,300,2.59,0.88,2021,22,5.5675675675675675,2.588235294117647,110,22,132,0.6666666666666666
2021-22,RegularSeason,202324,354,Derrick Favors,1610612760,OKC,39,652,94,182,0.516,2,16,0.125,16,25,0.64,58,126,184,25,17,12,9,62,206,338,2.78,1.89,2021,22,5.282051282051282,2.7777777777777777,88,9,97,1.8969072164948453
2021-22,RegularSeason,1630625,357,Dalano Banton,1610612761,TOR,64,696,83,202,0.411,13,51,0.255,26,44,0.591,38,86,124,99,28,10,53,68,205,276,1.87,0.53,2021,22,3.203125,1.8679245283018868,119,18,137,0.9051094890510949
2021-22,RegularSeason,1628418,358,Thomas Bryant,1610612764,WAS,27,439,77,148,0.52,12,42,0.286,35,40,0.875,26,82,108,23,6,21,19,43,201,264,1.21,0.32,2021,22,7.444444444444445,1.2105263157894737,71,5,76,1.4210526315789473
2021-22,RegularSeason,1630322,359,Lindy Waters III,1610612760,OKC,25,465,71,175,0.406,53,146,0.363,4,5,0.8,6,67,73,24,19,8,11,31,199,207,2.18,1.73,2021,22,7.96,2.1818181818181817,104,1,105,0.6952380952380952
2021-22,RegularSeason,1630549,360,Day'Ron Sharpe,1610612751,BKN,32,391,86,149,0.577,2,7,0.286,24,41,0.585,81,79,160,17,10,15,30,60,198,290,0.57,0.33,2021,22,6.1875,0.5666666666666667,63,17,80,2.0
2021-22,RegularSeason,1630198,360,Isaiah Joe,1610612755,PHI,55,609,62,177,0.35,45,135,0.333,29,31,0.935,6,50,56,35,14,3,19,47,198,170,1.84,0.74,2021,22,3.6,1.8421052631578947,115,2,117,0.47863247863247865
2021-22,RegularSeason,203107,360,Tomas Satoransky,1610612764,WAS,55,906,72,191,0.377,11,53,0.208,43,54,0.796,27,99,126,184,29,5,46,71,198,366,4.0,0.63,2021,22,3.6,4.0,119,11,130,0.9692307692307692
2021-22,RegularSeason,1630174,363,Aaron Nesmith,1610612738,BOS,52,574,72,182,0.396,31,115,0.27,21,26,0.808,15,74,89,22,20,5,31,70,196,186,0.71,0.65,2021,22,3.769230769230769,0.7096774193548387,110,5,115,0.7739130434782608
2021-22,RegularSeason,1628365,364,Markelle Fultz,1610612753,ORL,18,360,83,175,0.474,4,17,0.235,25,31,0.806,4,45,49,99,20,5,40,22,195,230,2.48,0.5,2021,22,10.833333333333334,2.475,92,6,98,0.5
2021-22,RegularSeason,1630235,364,Trent Forrest,1610612762,UTA,60,766,76,155,0.49,5,27,0.185,38,48,0.792,23,76,99,106,30,6,48,43,195,299,2.21,0.63,2021,22,3.25,2.2083333333333335,79,10,89,1.1123595505617978
2021-22,RegularSeason,1630201,366,Malachi Flynn,1610612761,TOR,44,537,72,183,0.393,30,90,0.333,15,24,0.625,10,53,63,70,20,4,13,45,189,213,5.38,1.54,2021,22,4.295454545454546,5.384615384615385,111,9,120,0.525
2021-22,RegularSeason,203503,367,Tony Snell,1610612740,NOP,53,823,69,171,0.404,45,128,0.352,4,4,1.0,16,87,103,28,16,9,19,70,187,222,1.47,0.84,2021,22,3.5283018867924527,1.4736842105263157,102,0,102,1.0098039215686274
2021-22,RegularSeason,1630249,367,Vit Krejci,1610612760,OKC,30,690,68,167,0.407,32,98,0.327,19,22,0.864,18,83,101,57,19,8,29,65,187,241,1.97,0.66,2021,22,6.233333333333333,1.9655172413793103,99,3,102,0.9901960784313726
2021-22,RegularSeason,1630568,369,Luka Garza,1610612765,DET,32,389,66,147,0.449,16,49,0.327,38,61,0.623,58,42,100,20,9,6,18,55,186,199,1.11,0.5,2021,22,5.8125,1.1111111111111112,81,23,104,0.9615384615384616
2021-22,RegularSeason,200765,369,Rajon Rondo,1610612739,CLE,39,698,68,176,0.386,31,88,0.352,19,26,0.731,15,93,108,170,30,6,68,56,186,317,2.5,0.44,2021,22,4.769230769230769,2.5,108,7,115,0.9391304347826087
2021-22,RegularSeason,202738,371,Isaiah Thomas,1610612766,CHA,22,333,67,167,0.401,28,83,0.337,22,26,0.846,4,25,29,34,7,5,15,34,184,140,2.27,0.47,2021,22,8.363636363636363,2.2666666666666666,100,4,104,0.27884615384615385
2021-22,RegularSeason,1630264,372,Anthony Gill,1610612764,WAS,44,463,62,109,0.569,14,26,0.538,42,52,0.808,33,52,85,27,5,11,18,58,180,233,1.5,0.28,2021,22,4.090909090909091,1.5,47,10,57,1.4912280701754386
2021-22,RegularSeason,1626208,372,Keifer Sykes,1610612754,IND,32,566,69,190,0.363,27,90,0.3,15,17,0.882,8,37,45,62,12,4,33,51,180,147,1.88,0.36,2021,22,5.625,1.878787878787879,121,2,123,0.36585365853658536
2021-22,RegularSeason,1629012,374,Collin Sexton,1610612739,CLE,11,316,68,151,0.45,11,45,0.244,29,39,0.744,13,23,36,23,10,0,31,25,176,121,0.74,0.32,2021,22,16.0,0.7419354838709677,83,10,93,0.3870967741935484
2021-22,RegularSeason,1629164,375,Brandon Goodwin,1610612739,CLE,36,502,64,154,0.416,19,55,0.345,24,38,0.632,14,53,67,91,25,1,36,39,171,215,2.53,0.69,2021,22,4.75,2.5277777777777777,90,14,104,0.6442307692307693
2021-22,RegularSeason,1629103,375,Kelan Martin,1610612738,BOS,30,450,70,171,0.409,22,75,0.293,9,13,0.692,17,38,55,21,13,9,14,36,171,150,1.5,0.93,2021,22,5.7,1.5,101,4,105,0.5238095238095238
2021-22,RegularSeason,1629650,375,Moses Brown,1610612739,CLE,40,344,64,108,0.593,0,0,0.0,43,72,0.597,39,96,135,1,7,16,20,53,171,237,0.05,0.35,2021,22,4.275,0.05,44,29,73,1.8493150684931507
2021-22,RegularSeason,203648,375,Thanasis Antetokounmpo,1610612749,MIL,48,473,70,128,0.547,2,14,0.143,29,46,0.63,40,61,101,22,16,12,26,68,171,221,0.85,0.61,2021,22,3.5625,0.8461538461538461,58,17,75,1.3466666666666667
2021-22,RegularSeason,203918,379,Rodney Hood,1610612746,LAC,52,709,58,157,0.369,30,91,0.33,17,19,0.895,15,62,77,38,15,6,11,31,163,187,3.46,1.36,2021,22,3.1346153846153846,3.4545454545454546,99,2,101,0.7623762376237624
2021-22,RegularSeason,1628396,379,Tony Bradley,1610612741,CHI,55,549,72,123,0.585,0,0,0.0,19,29,0.655,67,119,186,27,10,33,34,62,163,324,0.79,0.29,2021,22,2.963636363636364,0.7941176470588235,51,10,61,3.0491803278688523
2021-22,RegularSeason,1629139,379,Yuta Watanabe,1610612761,TOR,38,445,56,138,0.406,27,79,0.342,24,40,0.6,18,74,92,21,11,16,19,38,163,186,1.1,0.58,2021,22,4.2894736842105265,1.105263157894737,82,16,98,0.9387755102040817
2021-22,RegularSeason,201572,382,Brook Lopez,1610612749,MIL,13,298,61,131,0.466,19,53,0.358,20,23,0.87,19,34,53,6,8,15,12,34,161,158,0.5,0.67,2021,22,12.384615384615385,0.5,70,3,73,0.726027397260274
2021-22,RegularSeason,1630215,382,Jared Butler,1610612762,UTA,42,360,61,151,0.404,28,88,0.318,11,16,0.688,5,40,45,63,17,8,33,47,161,166,1.91,0.52,2021,22,3.8333333333333335,1.9090909090909092,90,5,95,0.47368421052631576
2021-22,RegularSeason,1629744,382,Matt Thomas,1610612741,CHI,40,460,55,134,0.41,35,91,0.385,16,20,0.8,3,47,50,20,8,3,8,18,161,151,2.5,1.0,2021,22,4.025,2.5,79,4,83,0.6024096385542169
2021-22,RegularSeason,1628425,385,Sterling Brown,1610612742,DAL,49,628,59,155,0.381,28,92,0.304,14,15,0.933,26,123,149,34,14,7,23,56,160,244,1.48,0.61,2021,22,3.2653061224489797,1.4782608695652173,96,1,97,1.5360824742268042
2021-22,RegularSeason,203925,386,Joe Harris,1610612751,BKN,14,423,56,124,0.452,41,88,0.466,5,6,0.833,5,51,56,14,7,2,16,31,158,152,0.88,0.44,2021,22,11.285714285714286,0.875,68,1,69,0.8115942028985508
2021-22,RegularSeason,201609,387,Goran Dragic,1610612751,BKN,21,498,57,151,0.377,16,63,0.254,27,33,0.818,13,52,65,86,19,4,34,45,157,197,2.53,0.56,2021,22,7.476190476190476,2.5294117647058822,94,6,100,0.65
2021-22,RegularSeason,203476,388,Gorgui Dieng,1610612737,ATL,44,371,53,112,0.473,29,68,0.426,19,26,0.731,32,89,121,34,11,13,20,52,154,247,1.7,0.55,2021,22,3.5,1.7,59,7,66,1.8333333333333333
2021-22,RegularSeason,1627737,388,Marquese Chriss,1610612742,DAL,34,346,62,134,0.463,8,25,0.32,22,33,0.667,33,70,103,17,13,12,17,64,154,199,1.0,0.77,2021,22,4.529411764705882,1.0,72,11,83,1.2409638554216869
2021-22,RegularSeason,1630572,388,Sandro Mamukelashvili,1610612749,MIL,41,407,57,115,0.496,22,52,0.423,18,22,0.818,35,47,82,22,9,9,15,28,154,199,1.47,0.6,2021,22,3.7560975609756095,1.4666666666666666,58,4,62,1.3225806451612903
2021-22,RegularSeason,1630846,391,Olivier Sarr,1610612760,OKC,22,421,58,101,0.574,13,29,0.448,24,29,0.828,34,59,93,19,6,15,22,52,153,216,0.86,0.27,2021,22,6.954545454545454,0.8636363636363636,43,5,48,1.9375
2021-22,RegularSeason,1630172,391,Patrick Williams,1610612741,CHI,17,422,54,102,0.529,15,29,0.517,30,41,0.732,17,52,69,15,9,9,16,28,153,180,0.94,0.56,2021,22,9.0,0.9375,48,11,59,1.1694915254237288
2021-22,RegularSeason,203901,393,Elfrid Payton,1610612756,PHX,50,549,67,175,0.383,4,18,0.222,12,32,0.375,21,67,88,99,25,6,47,38,150,193,2.11,0.53,2021,22,3.0,2.106382978723404,108,20,128,0.6875
2021-22,RegularSeason,1630208,393,Nick Richards,1610612766,CHA,50,367,60,90,0.667,0,0,0.0,30,43,0.698,34,52,86,13,9,21,24,51,150,212,0.54,0.38,2021,22,3.0,0.5416666666666666,30,13,43,2.0
2021-22,RegularSeason,1629678,395,Admiral Schofield,1610612753,ORL,38,469,54,129,0.419,26,79,0.329,12,15,0.8,17,72,89,25,4,5,21,58,146,170,1.19,0.19,2021,22,3.8421052631578947,1.1904761904761905,75,3,78,1.141025641025641
2021-22,RegularSeason,1630547,396,James Bouknight,1610612766,CHA,31,304,49,141,0.348,17,49,0.347,27,31,0.871,22,30,52,26,7,1,15,29,142,117,1.73,0.47,2021,22,4.580645161290323,1.7333333333333334,92,4,96,0.5416666666666666
2021-22,RegularSeason,1630184,397,Kira Lewis Jr.,1610612740,NOP,24,341,59,146,0.404,13,58,0.224,10,12,0.833,9,30,39,49,11,1,26,17,141,126,1.89,0.42,2021,22,5.875,1.8846153846153846,87,2,89,0.43820224719101125
2021-22,RegularSeason,1629117,397,Wenyen Gabriel,1610612747,LAL,26,359,54,110,0.491,8,28,0.286,25,42,0.595,39,58,97,14,5,11,16,68,141,179,0.88,0.31,2021,22,5.423076923076923,0.875,56,17,73,1.3287671232876712
2021-22,RegularSeason,203469,399,Cody Zeller,1610612757,POR,27,355,51,90,0.567,0,4,0.0,38,49,0.776,50,75,125,22,8,6,19,56,140,232,1.16,0.42,2021,22,5.185185185185185,1.1578947368421053,39,11,50,2.5
2021-22,RegularSeason,1630233,400,Nathan Knight,1610612750,MIN,37,267,45,88,0.511,4,13,0.308,44,60,0.733,32,53,85,22,7,8,18,42,138,183,1.22,0.39,2021,22,3.72972972972973,1.2222222222222223,43,16,59,1.4406779661016949
2021-22,RegularSeason,1629006,401,Josh Okogie,1610612750,MIN,49,516,42,104,0.404,14,47,0.298,35,51,0.686,29,41,70,25,26,12,23,53,133,165,1.09,1.13,2021,22,2.7142857142857144,1.0869565217391304,62,16,78,0.8974358974358975
2021-22,RegularSeason,203145,402,Kent Bazemore,1610612747,LAL,39,545,45,139,0.324,29,80,0.363,13,17,0.765,13,56,69,34,25,9,21,70,132,150,1.62,1.19,2021,22,3.3846153846153846,1.619047619047619,94,4,98,0.7040816326530612
2021-22,RegularSeason,1630583,402,Santi Aldama,1610612763,MEM,32,360,53,132,0.402,6,48,0.125,20,32,0.625,33,54,87,21,6,10,16,36,132,149,1.31,0.38,2021,22,4.125,1.3125,79,12,91,0.9560439560439561
2021-22,RegularSeason,1627823,404,Juancho Hernangomez,1610612762,UTA,40,445,44,106,0.415,24,69,0.348,19,34,0.559,28,72,100,20,14,10,16,25,131,182,1.25,0.88,2021,22,3.275,1.25,62,15,77,1.2987012987012987
2021-22,RegularSeason,1629633,405,Jarrett Culver,1610612763,MEM,37,338,51,135,0.378,12,47,0.255,16,34,0.471,13,35,48,33,20,5,20,42,130,114,1.65,1.0,2021,22,3.5135135135135136,1.65,84,18,102,0.47058823529411764
2021-22,RegularSeason,202693,406,Markieff Morris,1610612748,MIA,17,298,54,114,0.474,13,39,0.333,8,9,0.889,17,28,45,23,6,1,20,33,129,123,1.15,0.3,2021,22,7.588235294117647,1.15,60,1,61,0.7377049180327869
2021-22,RegularSeason,202683,407,Enes Freedom,1610612738,BOS,35,411,51,97,0.526,2,5,0.4,24,28,0.857,61,99,160,8,5,14,20,42,128,245,0.4,0.25,2021,22,3.657142857142857,0.4,46,4,50,3.2
2021-22,RegularSeason,1630190,408,Elijah Hughes,1610612757,POR,36,434,47,144,0.326,25,95,0.263,7,9,0.778,6,52,58,22,14,8,17,39,126,112,1.29,0.82,2021,22,3.5,1.2941176470588236,97,2,99,0.5858585858585859
2021-22,RegularSeason,1630210,408,Markus Howard,1610612743,DEN,31,177,39,101,0.386,28,70,0.4,20,23,0.87,2,10,12,7,9,0,7,17,126,82,1.0,1.29,2021,22,4.064516129032258,1.0,62,3,65,0.18461538461538463
2021-22,RegularSeason,2738,410,Andre Iguodala,1610612744,GSW,31,603,46,121,0.38,17,74,0.23,15,20,0.75,21,79,100,114,27,22,28,34,124,279,4.07,0.96,2021,22,4.0,4.071428571428571,75,5,80,1.25
2021-22,RegularSeason,1630587,411,Isaiah Livers,1610612765,DET,19,383,41,90,0.456,27,64,0.422,12,14,0.857,15,42,57,21,13,7,15,37,121,153,1.4,0.87,2021,22,6.368421052631579,1.4,49,2,51,1.1176470588235294
2021-22,RegularSeason,1629681,412,Killian Tillie,1610612763,MEM,36,461,43,127,0.339,27,86,0.314,5,8,0.625,21,39,60,22,23,15,13,58,118,138,1.69,1.77,2021,22,3.2777777777777777,1.6923076923076923,84,3,87,0.6896551724137931
2021-22,RegularSeason,1630194,413,Paul Reed,1610612755,PHI,38,303,54,96,0.563,2,8,0.25,6,14,0.429,44,48,92,16,33,14,10,57,116,211,1.6,3.3,2021,22,3.0526315789473686,1.6,42,8,50,1.84
2021-22,RegularSeason,200794,414,Paul Millsap,1610612755,PHI,33,376,45,115,0.391,8,35,0.229,17,24,0.708,41,73,114,29,10,13,19,67,115,185,1.53,0.53,2021,22,3.484848484848485,1.5263157894736843,70,7,77,1.4805194805194806
2021-22,RegularSeason,1629685,415,Dylan Windler,1610612739,CLE,50,459,37,98,0.378,21,70,0.3,15,18,0.833,21,68,89,34,14,3,16,47,110,170,2.13,0.88,2021,22,2.2,2.125,61,3,64,1.390625
2021-22,RegularSeason,1630688,416,Ish Wainright,1610612756,PHX,45,359,41,104,0.394,19,59,0.322,7,12,0.583,27,27,54,15,20,6,13,49,108,122,1.15,1.54,2021,22,2.4,1.1538461538461537,63,5,68,0.7941176470588235
2021-22,RegularSeason,1627739,417,Kris Dunn,1610612757,POR,14,336,44,102,0.431,1,11,0.091,17,18,0.944,9,40,49,79,23,3,32,38,106,169,2.47,0.72,2021,22,7.571428571428571,2.46875,58,1,59,0.8305084745762712
2021-22,RegularSeason,1630561,418,David Duke Jr.,1610612751,BKN,22,341,39,108,0.361,9,37,0.243,17,21,0.81,30,37,67,17,14,7,9,36,104,127,1.89,1.56,2021,22,4.7272727272727275,1.8888888888888888,69,4,73,0.9178082191780822
2021-22,RegularSeason,1629658,419,Jaylen Hoard,1610612760,OKC,7,240,44,90,0.489,9,25,0.36,6,14,0.429,30,54,84,17,6,5,8,14,103,153,2.13,0.75,2021,22,14.714285714285714,2.125,46,8,54,1.5555555555555556
2021-22,RegularSeason,1626147,420,Justin Anderson,1610612754,IND,16,316,36,95,0.379,15,59,0.254,15,19,0.789,4,42,46,33,8,6,8,22,102,124,4.13,1.0,2021,22,6.375,4.125,59,4,63,0.7301587301587301
2021-22,RegularSeason,1629109,421,Gary Clark,1610612740,NOP,38,378,33,88,0.375,28,70,0.4,7,10,0.7,23,67,90,18,13,7,10,20,101,161,1.8,1.3,2021,22,2.6578947368421053,1.8,55,3,58,1.5517241379310345
2021-22,RegularSeason,203506,422,Victor Oladipo,1610612748,MIA,8,173,35,73,0.479,15,36,0.417,14,19,0.737,3,20,23,28,5,1,16,13,99,97,1.75,0.31,2021,22,12.375,1.75,38,5,43,0.5348837209302325
2021-22,RegularSeason,1626246,423,Boban Marjanovic,1610612742,DAL,23,128,42,70,0.6,1,4,0.25,13,22,0.591,8,31,39,3,0,3,15,24,98,91,0.2,0.0,2021,22,4.260869565217392,0.2,28,9,37,1.054054054054054
2021-22,RegularSeason,1628400,423,Semi Ojeleye,1610612746,LAC,30,406,30,99,0.303,15,50,0.3,23,29,0.793,27,47,74,9,7,6,9,30,98,110,1.0,0.78,2021,22,3.2666666666666666,1.0,69,6,75,0.9866666666666667
2021-22,RegularSeason,1628408,425,PJ Dozier,1610612743,DEN,18,340,36,99,0.364,15,48,0.313,10,13,0.769,14,49,63,29,11,6,13,33,97,127,2.23,0.85,2021,22,5.388888888888889,2.230769230769231,63,3,66,0.9545454545454546
2021-22,RegularSeason,2772,426,Trevor Ariza,1610612747,LAL,24,462,33,99,0.333,20,74,0.27,10,18,0.556,10,72,82,27,13,6,11,20,96,139,2.46,1.18,2021,22,4.0,2.4545454545454546,66,8,74,1.1081081081081081
2021-22,RegularSeason,1626163,427,Frank Kaminsky,1610612756,PHX,9,181,36,66,0.545,5,15,0.333,18,20,0.9,11,30,41,13,8,7,5,14,95,127,2.6,1.6,2021,22,10.555555555555555,2.6,30,2,32,1.28125
2021-22,RegularSeason,1629833,427,Keljin Blevins,1610612757,POR,31,349,34,111,0.306,21,72,0.292,6,11,0.545,16,29,45,19,13,1,17,29,95,74,1.12,0.77,2021,22,3.064516129032258,1.1176470588235294,77,5,82,0.5487804878048781
2021-22,RegularSeason,1628995,429,Kevin Knox II,1610612737,ATL,30,222,31,85,0.365,15,54,0.278,16,22,0.727,14,30,44,10,4,2,7,19,93,86,1.43,0.57,2021,22,3.1,1.4285714285714286,54,6,60,0.7333333333333333
2021-22,RegularSeason,1629617,430,Reggie Perry,1610612757,POR,10,187,40,79,0.506,3,16,0.188,9,15,0.6,15,32,47,12,9,6,11,33,92,110,1.09,0.82,2021,22,9.2,1.0909090909090908,39,6,45,1.0444444444444445
2021-22,RegularSeason,1630579,431,Jericho Sims,1610612752,NYK,41,555,39,54,0.722,0,0,0.0,12,29,0.414,61,108,169,21,11,22,20,66,90,261,1.05,0.55,2021,22,2.1951219512195124,1.05,15,17,32,5.28125
2021-22,RegularSeason,1629008,432,Michael Porter Jr.,1610612743,DEN,9,265,37,103,0.359,10,48,0.208,5,9,0.556,9,50,59,17,10,2,12,16,89,95,1.42,0.83,2021,22,9.88888888888889,1.4166666666666667,66,4,70,0.8428571428571429
2021-22,RegularSeason,1630540,432,Miles McBride,1610612752,NYK,40,372,32,108,0.296,17,68,0.25,8,12,0.667,4,38,42,41,14,1,5,45,89,102,8.2,2.8,2021,22,2.225,8.2,76,4,80,0.525
2021-22,RegularSeason,1628981,434,Bruno Fernando,1610612745,HOU,30,153,36,55,0.655,1,2,0.5,15,24,0.625,18,37,55,7,1,11,14,24,88,120,0.5,0.07,2021,22,2.933333333333333,0.5,19,9,28,1.9642857142857142
2021-22,RegularSeason,1630686,435,Georgios Kalaitzakis,1610612760,OKC,13,213,31,67,0.463,10,26,0.385,14,30,0.467,6,15,21,12,11,2,20,19,86,60,0.6,0.55,2021,22,6.615384615384615,0.6,36,16,52,0.40384615384615385
2021-22,RegularSeason,203457,436,Nerlens Noel,1610612752,NYK,25,562,32,60,0.533,0,3,0.0,21,30,0.7,48,93,141,23,30,31,20,67,85,253,1.15,1.5,2021,22,3.4,1.15,28,9,37,3.810810810810811
2021-22,RegularSeason,202954,437,Brad Wanamaker,1610612764,WAS,23,320,28,77,0.364,4,17,0.235,23,25,0.92,6,33,39,55,7,6,23,45,83,116,2.39,0.3,2021,22,3.608695652173913,2.391304347826087,49,2,51,0.7647058823529411
2021-22,RegularSeason,1627774,438,Jake Layman,1610612750,MIN,34,231,30,73,0.411,8,35,0.229,13,18,0.722,6,30,36,9,7,5,10,12,81,80,0.9,0.7,2021,22,2.3823529411764706,0.9,43,5,48,0.75
2021-22,RegularSeason,1630551,438,Justin Champagnie,1610612761,TOR,36,281,31,67,0.463,10,28,0.357,9,9,1.0,37,35,72,11,8,4,8,32,81,132,1.38,1.0,2021,22,2.25,1.375,36,0,36,2.0
2021-22,RegularSeason,1629623,440,Lindell Wigginton,1610612749,MIL,19,199,26,61,0.426,9,26,0.346,19,35,0.543,3,22,25,23,5,1,12,17,80,71,1.92,0.42,2021,22,4.2105263157894735,1.9166666666666667,35,16,51,0.49019607843137253
2021-22,RegularSeason,1630219,440,Skylar Mays,1610612737,ATL,28,220,32,64,0.5,8,25,0.32,8,9,0.889,5,20,25,17,7,0,10,9,80,86,1.7,0.7,2021,22,2.857142857142857,1.7,32,1,33,0.7575757575757576
2021-22,RegularSeason,1628962,440,Udoka Azubuike,1610612762,UTA,17,195,37,49,0.755,0,0,0.0,6,11,0.545,18,53,71,0,1,11,12,25,80,134,0.0,0.08,2021,22,4.705882352941177,0.0,12,5,17,4.176470588235294
2021-22,RegularSeason,1630296,443,Braxton Key,1610612765,DET,11,197,33,72,0.458,6,21,0.286,7,13,0.538,13,37,50,11,10,11,11,26,79,105,1.0,0.91,2021,22,7.181818181818182,1.0,39,6,45,1.1111111111111112
2021-22,RegularSeason,1629620,444,Justin Robinson,1610612765,DET,25,304,28,93,0.301,18,61,0.295,4,8,0.5,4,17,21,32,9,1,17,27,78,55,1.88,0.53,2021,22,3.12,1.8823529411764706,65,4,69,0.30434782608695654
2021-22,RegularSeason,1630227,445,Daishen Nix,1610612745,HOU,24,261,27,67,0.403,7,26,0.269,16,30,0.533,7,26,33,40,15,0,26,21,77,85,1.54,0.58,2021,22,3.2083333333333335,1.5384615384615385,40,14,54,0.6111111111111112
2021-22,RegularSeason,1629644,445,KZ Okpala,1610612748,MIA,21,244,30,69,0.435,9,26,0.346,8,11,0.727,11,30,41,14,4,7,5,25,77,96,2.8,0.8,2021,22,3.6666666666666665,2.8,39,3,42,0.9761904761904762
2021-22,RegularSeason,202328,447,Greg Monroe,1610612750,MIN,14,195,32,57,0.561,0,0,0.0,12,23,0.522,30,34,64,22,8,10,12,24,76,132,1.83,0.67,2021,22,5.428571428571429,1.8333333333333333,25,11,36,1.7777777777777777
2021-22,RegularSeason,1629657,448,Kyle Guy,1610612748,MIA,19,186,26,65,0.4,14,40,0.35,8,12,0.667,4,13,17,17,7,1,13,12,74,60,1.31,0.54,2021,22,3.8947368421052633,1.3076923076923077,39,4,43,0.3953488372093023
2021-22,RegularSeason,1630792,449,Malcolm Hill,1610612741,CHI,19,212,24,52,0.462,13,36,0.361,11,14,0.786,11,24,35,8,7,3,3,24,72,91,2.67,2.33,2021,22,3.789473684210526,2.6666666666666665,28,3,31,1.1290322580645162
2021-22,RegularSeason,1629646,450,Charles Bassey,1610612755,PHI,23,168,30,47,0.638,0,4,0.0,9,12,0.75,22,40,62,7,5,17,8,32,69,132,0.88,0.63,2021,22,3.0,0.875,17,3,20,3.1
2021-22,RegularSeason,1627756,450,Denzel Valentine,1610612762,UTA,24,222,25,66,0.379,19,47,0.404,0,0,0.0,9,33,42,11,8,0,12,20,69,77,0.92,0.67,2021,22,2.875,0.9166666666666666,41,0,41,1.024390243902439
2021-22,RegularSeason,1628539,450,Mychal Mulder,1610612748,MIA,17,240,24,77,0.312,17,54,0.315,4,4,1.0,2,22,24,5,4,2,8,13,69,43,0.63,0.5,2021,22,4.0588235294117645,0.625,53,0,53,0.4528301886792453
2021-22,RegularSeason,1629185,453,Chris Chiozza,1610612744,GSW,34,372,24,81,0.296,17,53,0.321,2,3,0.667,9,27,36,65,13,0,32,32,67,91,2.03,0.41,2021,22,1.9705882352941178,2.03125,57,1,58,0.6206896551724138
2021-22,RegularSeason,1630550,453,JT Thor,1610612766,CHA,33,262,24,55,0.436,7,27,0.259,12,20,0.6,11,32,43,19,8,11,10,26,67,99,1.9,0.8,2021,22,2.0303030303030303,1.9,31,8,39,1.1025641025641026
2021-22,RegularSeason,1629076,453,Tyler Cook,1610612741,CHI,20,200,23,38,0.605,0,0,0.0,21,32,0.656,16,37,53,3,4,4,7,28,67,98,0.43,0.57,2021,22,3.35,0.42857142857142855,15,11,26,2.0384615384615383
2021-22,RegularSeason,1630573,456,Sam Hauser,1610612738,BOS,26,158,23,50,0.46,19,44,0.432,0,0,0.0,5,24,29,10,1,2,2,7,65,78,5.0,0.5,2021,22,2.5,5.0,27,0,27,1.0740740740740742
2021-22,RegularSeason,1628427,457,Vlatko Cancar,1610612743,DEN,15,176,23,41,0.561,7,12,0.583,9,14,0.643,8,23,31,17,2,3,9,18,62,83,1.89,0.22,2021,22,4.133333333333334,1.8888888888888888,18,5,23,1.3478260869565217
2021-22,RegularSeason,1630580,458,Joe Wieskamp,1610612759,SAS,29,205,20,56,0.357,14,43,0.326,7,13,0.538,4,10,14,9,4,3,2,14,61,47,4.5,2.0,2021,22,2.103448275862069,4.5,36,6,42,0.3333333333333333
2021-22,RegularSeason,1630186,459,Jahmi'us Ramsey,1610612758,SAC,19,134,24,58,0.414,5,18,0.278,7,14,0.5,4,9,13,7,1,1,5,10,60,36,1.4,0.2,2021,22,3.1578947368421053,1.4,34,7,41,0.3170731707317073
2021-22,RegularSeason,1628035,460,Alfonzo McKinnie,1610612741,CHI,17,206,24,61,0.393,9,27,0.333,2,8,0.25,13,20,33,5,2,3,7,26,59,52,0.71,0.29,2021,22,3.4705882352941178,0.7142857142857143,37,6,43,0.7674418604651163
2021-22,RegularSeason,1629875,461,Xavier Moon,1610612746,LAC,10,137,25,51,0.49,5,14,0.357,3,5,0.6,2,12,14,24,7,3,6,9,58,72,4.0,1.17,2021,22,5.8,4.0,26,2,28,0.5
2021-22,RegularSeason,1629603,462,Mamadi Diakite,1610612760,OKC,13,188,25,47,0.532,0,5,0.0,6,11,0.545,17,42,59,2,5,9,7,33,56,97,0.29,0.71,2021,22,4.3076923076923075,0.2857142857142857,22,5,27,2.185185185185185
2021-22,RegularSeason,203953,463,Jabari Parker,1610612738,BOS,12,112,18,38,0.474,8,16,0.5,9,9,1.0,5,23,28,6,4,1,8,13,53,64,0.75,0.5,2021,22,4.416666666666667,0.75,20,0,20,1.4
2021-22,RegularSeason,1630199,464,Cassius Stanley,1610612765,DET,9,155,19,46,0.413,4,17,0.235,10,10,1.0,5,14,19,4,5,2,6,17,52,49,0.67,0.83,2021,22,5.777777777777778,0.6666666666666666,27,0,27,0.7037037037037037
2021-22,RegularSeason,1630552,464,Jalen Johnson,1610612737,ATL,22,120,22,41,0.537,3,13,0.231,5,7,0.714,2,24,26,3,3,2,9,9,52,56,0.33,0.33,2021,22,2.3636363636363638,0.3333333333333333,19,2,21,1.2380952380952381
2021-22,RegularSeason,1630606,466,Javonte Smart,1610612748,MIA,17,200,19,60,0.317,8,27,0.296,5,6,0.833,5,19,24,16,6,3,11,12,51,47,1.46,0.55,2021,22,3.0,1.4545454545454546,41,1,42,0.5714285714285714
2021-22,RegularSeason,1629962,467,Devin Cannady,1610612753,ORL,5,145,15,44,0.341,15,37,0.405,5,7,0.714,1,5,6,10,5,3,5,9,50,38,2.0,1.0,2021,22,10.0,2.0,29,2,31,0.1935483870967742
2021-22,RegularSeason,1629755,467,Hassani Gravett,1610612753,ORL,8,171,18,38,0.474,11,26,0.423,3,4,0.75,1,20,21,20,5,1,9,13,50,67,2.22,0.56,2021,22,6.25,2.2222222222222223,20,1,21,1.0
2021-22,RegularSeason,1630691,467,Jamorko Pickett,1610612765,DET,13,176,18,50,0.36,13,39,0.333,1,2,0.5,6,26,32,7,0,7,5,12,50,58,1.4,0.0,2021,22,3.8461538461538463,1.4,32,1,33,0.9696969696969697
2021-22,RegularSeason,1630195,467,Leandro Bolmaro,1610612750,MIN,35,241,17,54,0.315,5,18,0.278,11,13,0.846,16,27,43,21,6,0,13,26,50,68,1.61,0.46,2021,22,1.4285714285714286,1.6153846153846154,37,2,39,1.1025641025641026
2021-22,RegularSeason,1630206,471,Jay Scrubb,1610612746,LAC,18,121,18,46,0.391,6,21,0.286,7,10,0.7,2,14,16,8,4,3,7,9,49,42,1.14,0.57,2021,22,2.7222222222222223,1.1428571428571428,28,3,31,0.5161290322580645
2021-22,RegularSeason,1629033,472,Theo Pinson,1610612742,DAL,19,148,14,39,0.359,10,30,0.333,10,10,1.0,2,19,21,17,5,2,5,12,48,63,3.4,1.0,2021,22,2.526315789473684,3.4,25,0,25,0.84
2021-22,RegularSeason,1630586,472,Usman Garuba,1610612745,HOU,24,239,19,44,0.432,5,20,0.25,5,7,0.714,21,62,83,17,10,11,6,28,48,136,2.83,1.67,2021,22,2.0,2.8333333333333335,25,2,27,3.074074074074074
2021-22,RegularSeason,1629719,474,Devontae Cacok,1610612759,SAS,15,121,21,31,0.677,0,0,0.0,4,7,0.571,8,34,42,6,8,7,3,16,46,93,2.0,2.67,2021,22,3.066666666666667,2.0,10,3,13,3.230769230769231
2021-22,RegularSeason,1629663,475,Louis King,1610612758,SAC,10,104,15,47,0.319,8,27,0.296,7,10,0.7,0,12,12,9,2,1,0,14,45,34,0.0,0.0,2021,22,4.5,inf,32,3,35,0.34285714285714286
2021-22,RegularSeason,1629674,475,Neemias Queta,1610612758,SAC,15,120,17,38,0.447,0,0,0.0,11,17,0.647,14,17,31,6,1,8,6,18,45,58,1.0,0.17,2021,22,3.0,1.0,21,6,27,1.1481481481481481
2021-22,RegularSeason,1630285,477,Zavier Simpson,1610612760,OKC,4,174,19,52,0.365,1,8,0.125,5,5,1.0,2,19,21,30,5,4,10,15,44,61,3.0,0.5,2021,22,11.0,3.0,33,0,33,0.6363636363636364
2021-22,RegularSeason,1629312,478,Haywood Highsmith,1610612748,MIA,19,163,16,46,0.348,9,28,0.321,2,5,0.4,10,16,26,6,2,3,3,13,43,44,2.0,0.67,2021,22,2.263157894736842,2.0,30,3,33,0.7878787878787878
2021-22,RegularSeason,1630243,478,Trevelin Queen,1610612745,HOU,10,74,15,33,0.455,9,24,0.375,4,4,1.0,7,9,16,4,5,1,7,6,43,44,0.57,0.71,2021,22,4.3,0.5714285714285714,18,0,18,0.8888888888888888
2021-22,RegularSeason,1628993,480,Alize Johnson,1610612740,NOP,23,167,17,39,0.436,0,4,0.0,7,12,0.583,28,33,61,9,5,0,12,18,41,77,0.75,0.42,2021,22,1.7826086956521738,0.75,22,5,27,2.259259259259259
2021-22,RegularSeason,1630698,481,Kevin Pangos,1610612739,CLE,24,166,15,46,0.326,6,26,0.231,3,4,0.75,2,9,11,30,3,0,7,11,39,44,4.29,0.43,2021,22,1.625,4.285714285714286,31,1,32,0.34375
2021-22,RegularSeason,204025,481,Tim Frazier,1610612739,CLE,12,208,14,45,0.311,6,17,0.353,5,9,0.556,5,14,19,34,3,1,15,27,39,46,2.27,0.2,2021,22,3.25,2.2666666666666666,31,4,35,0.5428571428571428
2021-22,RegularSeason,1629607,483,Jared Harper,1610612740,NOP,5,43,14,26,0.538,5,12,0.417,4,4,1.0,2,0,2,14,4,1,2,5,37,44,7.0,2.0,2021,22,7.4,7.0,12,0,12,0.16666666666666666
2021-22,RegularSeason,1629712,484,Didi Louzada,1610612757,POR,9,129,12,33,0.364,9,23,0.391,2,2,1.0,5,12,17,5,2,2,5,13,35,35,1.0,0.4,2021,22,3.888888888888889,1.0,21,0,21,0.8095238095238095
2021-22,RegularSeason,1627846,485,Abdel Nader,1610612756,PHX,14,145,12,35,0.343,4,14,0.286,6,10,0.6,4,23,27,7,8,4,11,20,34,42,0.64,0.73,2021,22,2.4285714285714284,0.6363636363636364,23,4,27,1.0
2021-22,RegularSeason,1626161,485,Willie Cauley-Stein,1610612755,PHI,20,183,16,35,0.457,1,2,0.5,1,2,0.5,13,27,40,10,6,3,7,19,34,66,1.43,0.86,2021,22,1.7,1.4285714285714286,19,1,20,2.0
2021-22,RegularSeason,1629626,487,Bol Bol,1610612753,ORL,14,81,15,27,0.556,1,4,0.25,2,5,0.4,4,16,20,5,1,2,4,4,33,42,1.25,0.25,2021,22,2.357142857142857,1.25,12,3,15,1.3333333333333333
2021-22,RegularSeason,202688,488,Brandon Knight,1610612742,DAL,5,65,10,25,0.4,4,17,0.235,8,8,1.0,0,8,8,8,1,0,4,5,32,30,2.0,0.25,2021,22,6.4,2.0,15,0,15,0.5333333333333333
2021-22,RegularSeason,1628982,488,Melvin Frazier Jr.,1610612760,OKC,3,120,13,48,0.271,1,21,0.048,5,7,0.714,5,8,13,1,1,0,3,8,32,7,0.33,0.33,2021,22,10.666666666666666,0.3333333333333333,35,2,37,0.35135135135135137
2021-22,RegularSeason,2617,488,Udonis Haslem,1610612748,MIA,13,83,14,31,0.452,1,4,0.25,3,3,1.0,4,21,25,4,1,1,5,15,32,41,0.8,0.2,2021,22,2.4615384615384617,0.8,17,0,17,1.4705882352941178
2021-22,RegularSeason,1630602,491,Chaundee Brown Jr.,1610612737,ATL,5,104,10,32,0.313,6,18,0.333,5,6,0.833,1,15,16,4,2,0,1,7,31,29,4.0,2.0,2021,22,6.2,4.0,22,1,23,0.6956521739130435
2021-22,RegularSeason,1628778,491,Paul Watson,1610612760,OKC,9,156,12,35,0.343,6,26,0.231,1,2,0.5,3,24,27,8,3,3,4,10,31,44,2.0,0.75,2021,22,3.4444444444444446,2.0,23,1,24,1.125
2021-22,RegularSeason,1629718,493,Charlie Brown Jr.,1610612755,PHI,22,178,10,39,0.256,1,12,0.083,9,10,0.9,14,18,32,6,10,4,5,18,30,47,1.2,2.0,2021,22,1.3636363636363635,1.2,29,1,30,1.0666666666666667
2021-22,RegularSeason,1628391,493,D.J. Wilson,1610612761,TOR,4,54,11,15,0.733,0,2,0.0,8,10,0.8,1,15,16,5,5,1,2,6,30,49,2.5,2.5,2021,22,7.5,2.5,4,2,6,2.6666666666666665
2021-22,RegularSeason,1628436,493,Luke Kornet,1610612738,BOS,15,103,13,27,0.481,0,5,0.0,4,6,0.667,13,16,29,9,3,3,0,9,30,58,0.0,0.0,2021,22,2.0,inf,14,2,16,1.8125
2021-22,RegularSeason,1629683,493,Quinndary Weatherspoon,1610612744,GSW,11,73,12,21,0.571,1,5,0.2,5,5,1.0,2,12,14,5,1,1,3,15,30,39,1.67,0.33,2021,22,2.727272727272727,1.6666666666666667,9,0,9,1.5555555555555556
2021-22,RegularSeason,1629653,497,Devon Dotson,1610612741,CHI,11,85,11,23,0.478,2,9,0.222,5,9,0.556,1,8,9,15,1,0,5,11,29,33,3.0,0.2,2021,22,2.6363636363636362,3.0,12,4,16,0.5625
2021-22,RegularSeason,203516,497,James Ennis III,1610612743,DEN,7,56,11,24,0.458,3,8,0.375,4,5,0.8,5,7,12,3,2,2,2,5,29,32,1.5,1.0,2021,22,4.142857142857143,1.5,13,1,14,0.8571428571428571
2021-22,RegularSeason,202334,499,Ed Davis,1610612739,CLE,31,201,11,16,0.688,0,0,0.0,6,14,0.429,14,50,64,7,3,9,5,33,28,93,1.4,0.6,2021,22,0.9032258064516129,1.4,5,8,13,4.923076923076923
2021-22,RegularSeason,1630222,500,Mason Jones,1610612747,LAL,4,51,7,15,0.467,1,4,0.25,12,15,0.8,1,9,10,4,2,0,1,8,27,31,4.0,2.0,2021,22,6.75,4.0,8,3,11,0.9090909090909091
2021-22,RegularSeason,1629168,501,BJ Johnson,1610612753,ORL,4,65,11,25,0.44,4,10,0.4,0,0,0.0,6,9,15,0,0,1,0,4,26,28,0.0,0.0,2021,22,6.5,,14,0,14,1.0714285714285714
2021-22,RegularSeason,1629735,501,Chris Silva,1610612748,MIA,10,91,8,15,0.533,0,0,0.0,10,12,0.833,13,23,36,7,0,1,8,20,26,53,0.88,0.0,2021,22,2.6,0.875,7,2,9,4.0
2021-22,RegularSeason,1630241,503,Sam Merrill,1610612763,MEM,6,58,8,24,0.333,7,23,0.304,2,4,0.5,1,6,7,4,0,0,2,3,25,16,2.0,0.0,2021,22,4.166666666666667,2.0,16,2,18,0.3888888888888889
2021-22,RegularSeason,1628419,504,Cameron Oliver,1610612737,ATL,2,43,10,15,0.667,1,3,0.333,2,3,0.667,2,4,6,3,1,1,0,5,23,28,0.0,0.0,2021,22,11.5,inf,5,1,6,1.0
2021-22,RegularSeason,1629035,504,Carsen Edwards,1610612765,DET,4,79,9,30,0.3,4,16,0.25,1,1,1.0,2,4,6,14,2,0,5,4,23,19,2.8,0.4,2021,22,5.75,2.8,21,0,21,0.2857142857142857
2021-22,RegularSeason,1630539,506,Kai Jones,1610612766,CHA,21,63,9,14,0.643,1,2,0.5,3,8,0.375,3,8,11,4,1,2,6,8,22,24,0.67,0.17,2021,22,1.0476190476190477,0.6666666666666666,5,5,10,1.1
2021-22,RegularSeason,1628411,506,Wes Iwundu,1610612737,ATL,3,82,8,18,0.444,3,5,0.6,3,4,0.75,3,10,13,0,1,0,1,8,22,24,0.0,1.0,2021,22,7.333333333333333,0.0,10,1,11,1.1818181818181819
2021-22,RegularSeason,1630271,508,Brodric Thomas,1610612738,BOS,12,60,8,18,0.444,2,9,0.222,3,5,0.6,2,8,10,11,1,1,6,7,21,26,1.83,0.17,2021,22,1.75,1.8333333333333333,10,2,12,0.8333333333333334
2021-22,RegularSeason,1630273,508,Freddie Gillespie,1610612753,ORL,9,119,9,22,0.409,0,1,0.0,3,7,0.429,13,23,36,5,3,9,5,18,21,52,1.0,0.6,2021,22,2.3333333333333335,1.0,13,4,17,2.1176470588235294
2021-22,RegularSeason,1630238,508,Malik Fitts,1610612738,BOS,15,63,8,19,0.421,5,10,0.5,0,0,0.0,2,15,17,5,0,0,2,4,21,30,2.5,0.0,2021,22,1.4,2.5,11,0,11,1.5454545454545454
2021-22,RegularSeason,1629730,508,Rayjon Tucker,1610612749,MIL,5,71,6,9,0.667,4,5,0.8,5,7,0.714,3,5,8,10,4,0,1,5,21,37,10.0,4.0,2021,22,4.2,10.0,3,2,5,1.6
2021-22,RegularSeason,1630225,512,Isaiah Todd,1610612764,WAS,12,74,7,26,0.269,4,16,0.25,2,6,0.333,3,9,12,4,4,2,4,4,20,15,1.0,1.0,2021,22,1.6666666666666667,1.0,19,4,23,0.5217391304347826
2021-22,RegularSeason,1630176,512,Vernon Carey Jr.,1610612764,WAS,7,44,7,13,0.538,0,0,0.0,6,13,0.462,8,4,12,0,2,1,3,4,20,19,0.0,0.67,2021,22,2.857142857142857,0.0,6,7,13,0.9230769230769231
2021-22,RegularSeason,1628476,514,Derrick Walton Jr.,1610612765,DET,3,108,6,26,0.231,3,13,0.231,4,4,1.0,2,8,10,21,7,4,11,8,19,30,1.91,0.64,2021,22,6.333333333333333,1.9090909090909092,20,0,20,0.5
2021-22,RegularSeason,1630288,514,Jeff Dowtin Jr.,1610612753,ORL,9,108,8,26,0.308,1,9,0.111,2,2,1.0,8,10,18,10,5,1,5,5,19,30,2.0,1.0,2021,22,2.111111111111111,2.0,18,0,18,1.0
2021-22,RegularSeason,1630466,516,Gabriel Deck,1610612760,OKC,7,56,8,14,0.571,2,4,0.5,0,0,0.0,1,5,6,5,1,0,2,2,18,22,2.5,0.5,2021,22,2.5714285714285716,2.5,6,0,6,1.0
2021-22,RegularSeason,203917,516,Nik Stauskas,1610612738,BOS,8,39,5,14,0.357,4,10,0.4,4,6,0.667,1,2,3,2,0,0,1,1,18,11,2.0,0.0,2021,22,2.25,2.0,9,2,11,0.2727272727272727
2021-22,RegularSeason,1630250,518,Marko Simonovic,1610612741,CHI,9,35,4,15,0.267,1,5,0.2,8,11,0.727,5,5,10,0,1,1,2,6,17,13,0.0,0.5,2021,22,1.8888888888888888,0.0,11,3,14,0.7142857142857143
2021-22,RegularSeason,204020,518,Tyler Johnson,1610612759,SAS,6,91,6,20,0.3,5,13,0.385,0,0,0.0,3,9,12,7,3,3,2,7,17,26,3.5,1.5,2021,22,2.8333333333333335,3.5,14,0,14,0.8571428571428571
2021-22,RegularSeason,1627820,518,Tyrone Wallace,1610612740,NOP,6,75,7,20,0.35,2,8,0.25,1,5,0.2,0,8,8,1,3,1,2,7,17,11,0.5,1.5,2021,22,2.8333333333333335,0.5,13,4,17,0.47058823529411764
2021-22,RegularSeason,1627853,521,Ryan Arcidiacono,1610612752,NYK,10,76,6,12,0.5,4,9,0.444,0,0,0.0,0,8,8,4,1,0,3,5,16,20,1.33,0.33,2021,22,1.6,1.3333333333333333,6,0,6,1.3333333333333333
2021-22,RegularSeason,1628382,522,Justin Jackson,1610612756,PHX,7,36,5,15,0.333,3,9,0.333,2,2,1.0,1,6,7,2,0,0,1,3,15,13,2.0,0.0,2021,22,2.142857142857143,2.0,10,0,10,0.7
2021-22,RegularSeason,1630612,522,RJ Nembhard Jr.,1610612739,CLE,14,63,6,18,0.333,0,2,0.0,3,4,0.75,3,4,7,12,1,0,3,2,15,19,4.0,0.33,2021,22,1.0714285714285714,4.0,12,1,13,0.5384615384615384
2021-22,RegularSeason,1630758,524,Aleem Ford,1610612753,ORL,5,74,6,20,0.3,2,15,0.133,0,0,0.0,2,13,15,2,1,0,4,7,14,14,0.5,0.25,2021,22,2.8,0.5,14,0,14,1.0714285714285714
2021-22,RegularSeason,1630787,524,Cameron McGriff,1610612757,POR,3,46,5,14,0.357,2,6,0.333,2,2,1.0,6,9,15,3,0,1,0,7,14,24,0.0,0.0,2021,22,4.666666666666667,inf,9,0,9,1.6666666666666667
2021-22,RegularSeason,1630216,524,Cassius Winston,1610612764,WAS,7,39,4,11,0.364,2,6,0.333,4,4,1.0,0,1,1,7,0,0,3,9,14,12,2.33,0.0,2021,22,2.0,2.3333333333333335,7,0,7,0.14285714285714285
2021-22,RegularSeason,204038,524,Langston Galloway,1610612749,MIL,7,107,6,26,0.231,2,16,0.125,0,0,0.0,3,15,18,12,1,0,6,7,14,19,2.0,0.17,2021,22,2.0,2.0,20,0,20,0.9
2021-22,RegularSeason,1627822,524,Petr Cornelie,1610612743,DEN,13,38,5,15,0.333,1,8,0.125,3,4,0.75,7,7,14,3,1,1,4,7,14,18,0.75,0.25,2021,22,1.0769230769230769,0.75,10,1,11,1.2727272727272727
2021-22,RegularSeason,1629635,524,Sekou Doumbouya,1610612747,LAL,2,16,5,8,0.625,1,2,0.5,3,4,0.75,2,4,6,0,3,2,2,1,14,19,0.0,1.5,2021,22,7.0,0.0,3,1,4,1.5
2021-22,RegularSeason,1630994,530,Gabriel Lundberg,1610612756,PHX,4,44,5,19,0.263,3,8,0.375,0,0,0.0,2,5,7,11,3,0,3,7,13,17,3.67,1.0,2021,22,3.25,3.6666666666666665,14,0,14,0.5
2021-22,RegularSeason,1630585,530,Marcus Garrett,1610612748,MIA,12,128,5,21,0.238,1,4,0.25,2,5,0.4,9,14,23,7,5,3,2,16,13,30,3.5,2.5,2021,22,1.0833333333333333,3.5,16,3,19,1.2105263157894737
2021-22,RegularSeason,1629619,530,Myles Powell,1610612755,PHI,11,52,5,17,0.294,1,6,0.167,2,2,1.0,1,5,6,3,1,0,3,8,13,8,1.0,0.33,2021,22,1.1818181818181819,1.0,12,0,12,0.5
2021-22,RegularSeason,1630582,530,Yves Pons,1610612763,MEM,12,71,5,16,0.313,3,9,0.333,0,2,0.0,5,7,12,1,1,4,1,6,13,17,1.0,1.0,2021,22,1.0833333333333333,1.0,11,2,13,0.9230769230769231
2021-22,RegularSeason,1629067,534,Isaac Bonga,1610612761,TOR,15,69,3,13,0.231,1,4,0.25,5,8,0.625,4,3,7,4,8,2,2,10,12,18,2.0,4.0,2021,22,0.8,2.0,10,3,13,0.5384615384615384
2021-22,RegularSeason,1630695,534,Micah Potter,1610612765,DET,3,31,5,11,0.455,0,2,0.0,2,2,1.0,4,5,9,0,1,1,1,4,12,16,0.0,1.0,2021,22,4.0,0.0,6,0,6,1.5
2021-22,RegularSeason,1629605,534,Tacko Fall,1610612739,CLE,11,59,5,12,0.417,0,0,0.0,2,7,0.286,7,16,23,2,0,6,3,3,12,28,0.67,0.0,2021,22,1.0909090909090908,0.6666666666666666,7,5,12,1.9166666666666667
2021-22,RegularSeason,1627767,537,Cheick Diallo,1610612765,DET,3,31,3,8,0.375,0,0,0.0,5,6,0.833,4,8,12,0,1,0,1,6,11,17,0.0,1.0,2021,22,3.6666666666666665,0.0,5,1,6,2.0
2021-22,RegularSeason,1629682,538,Tremont Waters,1610612764,WAS,3,50,4,14,0.286,2,9,0.222,0,0,0.0,0,4,4,7,5,0,4,4,10,12,1.75,1.25,2021,22,3.3333333333333335,1.75,10,0,10,0.4
2021-22,RegularSeason,1630187,539,Daniel Oturu,1610612761,TOR,3,27,3,6,0.5,0,1,0.0,3,5,0.6,1,4,5,0,0,2,0,1,9,11,0.0,0.0,2021,22,3.0,,3,2,5,1.0
2021-22,RegularSeason,1628221,540,Gabe York,1610612754,IND,2,21,2,7,0.286,1,6,0.167,3,5,0.6,0,2,2,4,2,1,1,4,8,9,4.0,2.0,2021,22,4.0,4.0,5,2,7,0.2857142857142857
2021-22,RegularSeason,1630644,540,Mac McClung,1610612747,LAL,2,24,3,6,0.5,1,3,0.333,1,1,1.0,0,3,3,1,1,1,3,5,8,8,0.33,0.33,2021,22,4.0,0.3333333333333333,3,0,3,1.0
2021-22,RegularSeason,1629005,540,Malik Newman,1610612739,CLE,1,8,3,5,0.6,0,1,0.0,2,2,1.0,0,1,1,1,0,0,1,0,8,7,1.0,0.0,2021,22,8.0,1.0,2,0,2,0.5
2021-22,RegularSeason,203524,540,Solomon Hill,1610612737,ATL,13,139,3,20,0.15,2,13,0.154,0,0,0.0,6,17,23,12,4,2,1,16,8,31,12.0,4.0,2021,22,0.6153846153846154,12.0,17,0,17,1.3529411764705883
2021-22,RegularSeason,1630647,544,Eugene Omoruyi,1610612742,DAL,4,18,2,5,0.4,1,2,0.5,2,4,0.5,2,5,7,2,0,0,0,2,7,11,0.0,0.0,2021,22,1.75,inf,3,2,5,1.4
2021-22,RegularSeason,1630218,544,Robert Woodard II,1610612759,SAS,12,42,2,16,0.125,1,4,0.25,2,2,1.0,5,6,11,3,1,1,1,3,7,8,3.0,1.0,2021,22,0.5833333333333334,3.0,14,0,14,0.7857142857142857
2021-22,RegularSeason,1630536,544,Sharife Cooper,1610612737,ATL,13,39,3,14,0.214,1,6,0.167,0,0,0.0,0,5,5,5,0,0,5,1,7,1,1.0,0.0,2021,22,0.5384615384615384,1.0,11,0,11,0.45454545454545453
2021-22,RegularSeason,1628591,547,Craig Sword,1610612764,WAS,3,19,3,4,0.75,0,1,0.0,0,0,0.0,0,0,0,1,4,0,1,7,6,9,1.0,4.0,2021,22,2.0,1.0,1,0,1,0.0
2021-22,RegularSeason,1629751,547,Dakota Mathias,1610612763,MEM,6,16,2,6,0.333,2,6,0.333,0,0,0.0,0,2,2,1,1,0,0,1,6,6,0.0,0.0,2021,22,1.0,inf,4,0,4,0.5
2021-22,RegularSeason,203658,547,Norvel Pelle,1610612762,UTA,3,19,3,5,0.6,0,0,0.0,0,0,0.0,3,3,6,0,0,1,2,1,6,9,0.0,0.0,2021,22,2.0,0.0,2,0,2,3.0
2021-22,RegularSeason,1628238,547,Paris Bass,1610612756,PHX,2,7,2,6,0.333,0,2,0.0,2,2,1.0,2,2,4,0,1,0,2,2,6,5,0.0,0.5,2021,22,3.0,0.0,4,0,4,1.0
2021-22,RegularSeason,1630286,547,Tre Scott,1610612739,CLE,2,11,3,6,0.5,0,1,0.0,0,0,0.0,1,1,2,0,1,1,0,2,6,7,0.0,0.0,2021,22,3.0,,3,0,3,0.6666666666666666
2021-22,RegularSeason,1630648,552,Jordan Schakel,1610612764,WAS,4,30,1,11,0.091,1,6,0.167,2,2,1.0,2,6,8,0,1,0,1,0,5,3,0.0,1.0,2021,22,1.25,0.0,10,0,10,0.8
2021-22,RegularSeason,1629752,552,Juwan Morgan,1610612738,BOS,2,31,2,3,0.667,1,2,0.5,0,0,0.0,2,2,4,1,0,0,0,3,5,9,0.0,0.0,2021,22,2.5,inf,1,0,1,4.0
2021-22,RegularSeason,1630593,552,McKinley Wright IV,1610612750,MIN,5,19,2,3,0.667,1,2,0.5,0,0,0.0,0,0,0,3,0,0,1,1,5,6,3.0,0.0,2021,22,1.0,3.0,1,0,1,0.0
2021-22,RegularSeason,1629671,552,Miye Oni,1610612762,UTA,16,44,2,9,0.222,1,8,0.125,0,1,0.0,1,6,7,5,0,0,1,7,5,8,5.0,0.0,2021,22,0.3125,5.0,7,1,8,0.875
2021-22,RegularSeason,1630589,552,Moses Wright,1610612742,DAL,4,15,1,4,0.25,0,1,0.0,3,3,1.0,1,2,3,2,0,1,0,0,5,8,0.0,0.0,2021,22,1.25,inf,3,0,3,1.0
2021-22,RegularSeason,1627782,552,Wayne Selden,1610612752,NYK,3,19,1,4,0.25,1,2,0.5,2,4,0.5,0,1,1,1,0,0,0,1,5,2,0.0,0.0,2021,22,1.6666666666666667,inf,3,2,5,0.2
2021-22,RegularSeason,1630270,552,Xavier Sneed,1610612762,UTA,9,39,2,10,0.2,1,8,0.125,0,0,0.0,2,4,6,1,0,0,0,2,5,4,0.0,0.0,2021,22,0.5555555555555556,inf,8,0,8,0.75
2021-22,RegularSeason,1630637,559,Carlik Jones,1610612743,DEN,5,23,1,9,0.111,0,1,0.0,2,2,1.0,1,2,3,5,1,0,3,0,4,2,1.67,0.33,2021,22,0.8,1.6666666666666667,8,0,8,0.375
2021-22,RegularSeason,1628990,559,Chandler Hutchison,1610612756,PHX,6,22,1,2,0.5,0,0,0.0,2,2,1.0,0,5,5,2,0,0,4,1,4,6,0.5,0.0,2021,22,0.6666666666666666,0.5,1,0,1,5.0
2021-22,RegularSeason,1628422,559,Damyean Dotson,1610612752,NYK,2,21,2,4,0.5,0,1,0.0,0,0,0.0,0,2,2,1,0,0,0,0,4,5,0.0,0.0,2021,22,2.0,inf,2,0,2,1.0
2021-22,RegularSeason,201954,559,Darren Collison,1610612747,LAL,3,37,2,7,0.286,0,3,0.0,0,0,0.0,0,4,4,2,1,0,1,5,4,5,2.0,1.0,2021,22,1.3333333333333333,2.0,5,0,5,0.8
2021-22,RegularSeason,1629203,559,Jemerrio Jones,1610612747,LAL,2,15,2,3,0.667,0,0,0.0,0,0,0.0,2,1,3,0,1,0,0,2,4,7,0.0,0.0,2021,22,2.0,,1,0,1,3.0
2021-22,RegularSeason,203816,559,Scotty Hopson,1610612760,OKC,1,18,2,4,0.5,0,1,0.0,0,0,0.0,0,1,1,1,0,0,2,1,4,2,0.5,0.0,2021,22,4.0,0.5,2,0,2,0.5
2021-22,RegularSeason,1627885,559,Shaquille Harrison,1610612751,BKN,2,23,2,6,0.333,0,2,0.0,0,0,0.0,1,3,4,3,1,1,2,3,4,7,1.5,0.5,2021,22,2.0,1.5,4,0,4,1.0
2021-22,RegularSeason,1629686,566,Deividas Sirvydis,1610612765,DET,3,27,1,10,0.1,1,7,0.143,0,0,0.0,0,6,6,1,3,1,0,4,3,5,0.0,0.0,2021,22,1.0,inf,9,0,9,0.6666666666666666
2021-22,RegularSeason,1626144,566,Emmanuel Mudiay,1610612758,SAC,2,11,0,2,0.0,0,0,0.0,3,4,0.75,0,0,0,4,1,0,1,1,3,4,4.0,1.0,2021,22,1.5,4.0,2,1,3,0.0
2021-22,RegularSeason,1630346,566,Matt Ryan,1610612738,BOS,1,5,1,5,0.2,1,5,0.2,0,0,0.0,0,0,0,0,1,0,0,0,3,0,0.0,0.0,2021,22,3.0,,4,0,4,0.0
2021-22,RegularSeason,1630306,566,Rob Edwards,1610612760,OKC,2,11,1,4,0.25,1,4,0.25,0,0,0.0,0,3,3,0,0,0,1,0,3,2,0.0,0.0,2021,22,1.5,0.0,3,0,3,1.0
2021-22,RegularSeason,1630565,570,Aaron Henry,1610612755,PHI,6,17,1,5,0.2,0,1,0.0,0,0,0.0,0,1,1,0,0,2,2,2,2,-1,0.0,0.0,2021,22,0.3333333333333333,0.0,4,0,4,0.25
2021-22,RegularSeason,1629958,570,Ahmad Caver,1610612754,IND,1,1,1,1,1.0,0,0,0.0,0,0,0.0,0,0,0,0,0,0,0,0,2,2,0.0,0.0,2021,22,2.0,,0,0,0,
2021-22,RegularSeason,1629610,570,DaQuan Jeffries,1610612763,MEM,3,9,1,2,0.5,0,1,0.0,0,0,0.0,0,2,2,1,0,0,0,1,2,4,0.0,0.0,2021,22,0.6666666666666666,inf,1,0,1,2.0
2021-22,RegularSeason,1630531,570,Jaden Springer,1610612755,PHI,2,6,1,1,1.0,0,0,0.0,0,0,0.0,1,1,2,0,0,2,1,0,2,5,0.0,0.0,2021,22,1.0,0.0,0,0,0,inf
2021-22,RegularSeason,1629600,570,Jarron Cumberland,1610612757,POR,3,12,1,2,0.5,0,1,0.0,0,0,0.0,1,2,3,1,0,0,0,2,2,5,0.0,0.0,2021,22,0.6666666666666666,inf,1,0,1,3.0
2021-22,RegularSeason,1628537,570,Jaylen Morris,1610612759,SAS,3,16,0,6,0.0,0,2,0.0,2,4,0.5,0,2,2,2,0,0,1,2,2,-3,2.0,0.0,2021,22,0.6666666666666666,2.0,6,2,8,0.25
2021-22,RegularSeason,2207,570,Joe Johnson,1610612738,BOS,1,2,1,1,1.0,0,0,0.0,0,0,0.0,0,0,0,0,0,0,0,0,2,2,0.0,0.0,2021,22,2.0,,0,0,0,
2021-22,RegularSeason,1630555,570,Joel Ayayi,1610612764,WAS,7,20,1,6,0.167,0,1,0.0,0,0,0.0,1,2,3,4,0,0,0,0,2,4,0.0,0.0,2021,22,0.2857142857142857,inf,5,0,5,0.6
2021-22,RegularSeason,1629783,570,Shaq Buchanan,1610612763,MEM,2,10,1,4,0.25,0,2,0.0,0,0,0.0,1,1,2,2,1,0,2,1,2,2,1.0,0.5,2021,22,1.0,1.0,3,0,3,0.6666666666666666
2021-22,RegularSeason,1630179,570,Tyrell Terry,1610612763,MEM,2,3,1,1,1.0,0,0,0.0,0,0,0.0,0,0,0,0,0,0,0,1,2,2,0.0,0.0,2021,22,1.0,,0,0,0,
2021-22,RegularSeason,1628994,580,George King,1610612742,DAL,4,19,0,5,0.0,0,4,0.0,1,2,0.5,0,5,5,0,0,0,1,4,1,-1,0.0,0.0,2021,22,0.25,0.0,5,1,6,0.8333333333333334
2021-22,RegularSeason,1630575,580,Scottie Lewis,1610612766,CHA,2,7,0,0,0.0,0,0,0.0,1,2,0.5,0,0,0,1,1,0,0,0,1,2,0.0,0.0,2021,22,0.5,inf,0,1,1,0.0
2021-22,RegularSeason,1630278,582,Ade Murkey,1610612758,SAC,1,1,0,0,0.0,0,0,0.0,0,0,0.0,0,0,0,0,0,0,0,0,0,0,0.0,0.0,2021,22,0.0,,0,0,0,
2021-22,RegularSeason,1630237,582,Anthony Lamb,1610612745,HOU,2,8,0,2,0.0,0,2,0.0,0,0,0.0,0,1,1,2,0,0,0,0,0,1,0.0,0.0,2021,22,0.0,inf,2,0,2,0.5
2021-22,RegularSeason,1629083,582,Arnoldas Kulboka,1610612766,CHA,2,5,0,1,0.0,0,1,0.0,0,0,0.0,0,0,0,0,0,0,0,1,0,-1,0.0,0.0,2021,22,0.0,,1,0,1,0.0
2021-22,RegularSeason,101139,582,CJ Miles,1610612738,BOS,1,2,0,0,0.0,0,0,0.0,0,0,0.0,0,0,0,0,0,0,0,1,0,0,0.0,0.0,2021,22,0.0,,0,0,0,
2021-22,RegularSeason,1627760,582,Cat Barber,1610612737,ATL,3,13,0,4,0.0,0,0,0.0,0,4,0.0,1,2,3,3,0,0,1,1,0,-3,3.0,0.0,2021,22,0.0,3.0,4,4,8,0.375
2021-22,RegularSeason,1630525,582,David Johnson,1610612761,TOR,2,2,0,1,0.0,0,1,0.0,0,0,0.0,0,0,0,0,0,0,0,0,0,-1,0.0,0.0,2021,22,0.0,,1,0,1,0.0
2021-22,RegularSeason,1630610,582,DeJon Jarreau,1610612754,IND,1,1,0,0,0.0,0,0,0.0,0,0,0.0,0,0,0,0,0,0,0,0,0,0,0.0,0.0,2021,22,0.0,,0,0,0,
2021-22,RegularSeason,1629150,582,Emanuel Terry,1610612756,PHX,3,18,0,5,0.0,0,0,0.0,0,0,0.0,8,7,15,2,1,0,5,4,0,8,0.4,0.2,2021,22,0.0,0.4,5,0,5,3.0
2021-22,RegularSeason,1630624,582,Feron Hunt,1610612752,NYK,2,8,0,2,0.0,0,0,0.0,0,0,0.0,1,0,1,1,1,0,1,1,0,0,1.0,1.0,2021,22,0.0,1.0,2,0,2,0.5
2021-22,RegularSeason,1630605,582,JaQuori McLaughlin,1610612742,DAL,4,11,0,2,0.0,0,1,0.0,0,0,0.0,0,0,0,2,0,0,0,1,0,0,0.0,0.0,2021,22,0.0,inf,2,0,2,0.0
2021-22,RegularSeason,1630693,582,Jaime Echenique,1610612764,WAS,1,3,0,0,0.0,0,0,0.0,0,0,0.0,0,0,0,0,0,0,0,0,0,0,0.0,0.0,2021,22,0.0,,0,0,0,
2021-22,RegularSeason,1629602,582,Javin DeLaurier,1610612749,MIL,1,3,0,0,0.0,0,0,0.0,0,0,0.0,0,1,1,0,1,0,0,1,0,2,0.0,0.0,2021,22,0.0,,0,0,0,inf
2021-22,RegularSeason,1630643,582,Jay Huff,1610612747,LAL,4,20,0,3,0.0,0,2,0.0,0,0,0.0,1,3,4,1,1,1,1,1,0,3,1.0,1.0,2021,22,0.0,1.0,3,0,3,1.3333333333333333
2021-22,RegularSeason,1629873,582,Jaysean Paige,1610612765,DET,1,7,0,3,0.0,0,2,0.0,0,0,0.0,0,1,1,1,0,0,1,2,0,-2,1.0,0.0,2021,22,0.0,1.0,3,0,3,0.3333333333333333
2021-22,RegularSeason,1630257,582,Jon Teske,1610612763,MEM,3,8,0,1,0.0,0,0,0.0,0,2,0.0,0,2,2,1,1,0,0,1,0,1,0.0,0.0,2021,22,0.0,inf,1,2,3,0.6666666666666666
2021-22,RegularSeason,1628395,582,Jordan Bell,1610612741,CHI,1,2,0,0,0.0,0,0,0.0,0,0,0.0,1,0,1,0,1,0,0,2,0,2,0.0,0.0,2021,22,0.0,,0,0,0,inf
2021-22,RegularSeason,1630692,582,Jordan Goodwin,1610612764,WAS,2,6,0,3,0.0,0,1,0.0,0,0,0.0,0,1,1,0,0,0,0,1,0,-2,0.0,0.0,2021,22,0.0,,3,0,3,0.3333333333333333
2021-22,RegularSeason,1630640,582,MJ Walker,1610612756,PHX,2,8,0,4,0.0,0,2,0.0,0,0,0.0,0,1,1,1,2,0,0,1,0,0,0.0,0.0,2021,22,0.0,inf,4,0,4,0.25
2021-22,RegularSeason,1629760,582,Matt Mooney,1610612752,NYK,1,2,0,1,0.0,0,1,0.0,0,0,0.0,0,0,0,0,1,0,1,0,0,-1,0.0,1.0,2021,22,0.0,0.0,1,0,1,0.0
2021-22,RegularSeason,1630207,582,Nate Hinton,1610612754,IND,2,2,0,1,0.0,0,0,0.0,0,0,0.0,0,0,0,0,0,0,1,0,0,-2,0.0,0.0,2021,22,0.0,0.0,1,0,1,0.0
2021-22,RegularSeason,1626155,582,Sam Dekker,1610612761,TOR,1,1,0,0,0.0,0,0,0.0,0,0,0.0,0,0,0,0,0,0,0,0,0,0,0.0,0.0,2021,22,0.0,,0,0,0,
2021-22,RegularSeason,1629309,582,Trayvon Palmer,1610612765,DET,1,17,0,1,0.0,0,0,0.0,0,0,0.0,0,2,2,0,0,0,1,2,0,0,0.0,0.0,2021,22,0.0,0.0,1,0,1,2.0
2021-22,RegularSeason,1629788,582,Tyler Hall,1610612752,NYK,1,2,0,0,0.0,0,0,0.0,0,0,0.0,0,0,0,0,0,0,0,0,0,0,0.0,0.0,2021,22,0.0,,0,0,0,
2021-22,RegularSeason,1629597,582,Zylan Cheatham,1610612762,UTA,1,5,0,3,0.0,0,2,0.0,0,0,0.0,0,0,0,0,0,0,0,0,0,-3,0.0,0.0,2021,22,0.0,,3,0,3,0.0
2021-22,Playoffs,1628369,1,Jayson Tatum,1610612738,BOS,24,983,201,472,0.426,77,196,0.393,136,170,0.8,24,137,161,148,29,21,100,72,615,569,1.48,0.29,2021,22,25.625,1.48,271,34,305,0.5278688524590164
2021-22,Playoffs,201939,2,Stephen Curry,1610612744,GSW,22,764,202,440,0.459,91,229,0.397,107,129,0.829,11,104,115,129,29,8,57,59,602,566,2.26,0.51,2021,22,27.363636363636363,2.263157894736842,238,22,260,0.4423076923076923
2021-22,Playoffs,1627759,3,Jaylen Brown,1610612738,BOS,24,920,197,419,0.47,60,161,0.373,100,131,0.763,33,133,166,85,27,10,74,71,554,515,1.15,0.36,2021,22,23.083333333333332,1.1486486486486487,222,31,253,0.6561264822134387
2021-22,Playoffs,1629029,4,Luka Doncic,1610612742,DAL,15,552,160,352,0.455,51,148,0.345,104,135,0.77,10,137,147,96,27,9,59,44,475,472,1.63,0.46,2021,22,31.666666666666668,1.6271186440677967,192,31,223,0.6591928251121076
2021-22,Playoffs,202710,5,Jimmy Butler,1610612748,MIA,17,629,166,328,0.506,23,68,0.338,111,132,0.841,41,84,125,78,35,11,25,25,466,507,3.12,1.4,2021,22,27.41176470588235,3.12,162,21,183,0.6830601092896175
2021-22,Playoffs,202691,6,Klay Thompson,1610612744,GSW,22,792,158,368,0.429,77,200,0.385,26,30,0.867,7,79,86,50,24,15,28,47,419,352,1.79,0.86,2021,22,19.045454545454547,1.7857142857142858,210,4,214,0.40186915887850466
2021-22,Playoffs,1628973,7,Jalen Brunson,1610612742,DAL,18,629,145,311,0.466,26,75,0.347,72,90,0.8,15,68,83,66,14,1,19,38,388,349,3.47,0.74,2021,22,21.555555555555557,3.473684210526316,166,18,184,0.45108695652173914
2021-22,Playoffs,203507,8,Giannis Antetokounmpo,1610612749,MIL,12,448,140,285,0.491,9,41,0.22,91,134,0.679,26,144,170,81,8,15,54,43,380,412,1.5,0.15,2021,22,31.666666666666668,1.5,145,43,188,0.9042553191489362
2021-22,Playoffs,1629673,9,Jordan Poole,1610612744,GSW,22,605,129,254,0.508,50,128,0.391,65,71,0.915,10,52,62,83,17,8,53,62,373,359,1.57,0.32,2021,22,16.954545454545453,1.5660377358490567,125,6,131,0.4732824427480916
2021-22,Playoffs,203952,10,Andrew Wiggins,1610612744,GSW,22,767,143,305,0.469,35,105,0.333,42,65,0.646,54,111,165,40,22,23,30,54,363,398,1.33,0.73,2021,22,16.5,1.3333333333333333,162,23,185,0.8918918918918919
2021-22,Playoffs,203935,11,Marcus Smart,1610612738,BOS,21,760,113,279,0.405,48,137,0.35,50,62,0.806,20,75,95,123,26,5,52,71,324,343,2.37,0.5,2021,22,15.428571428571429,2.3653846153846154,166,12,178,0.5337078651685393
2021-22,Playoffs,201143,12,Al Horford,1610612738,BOS,23,815,101,193,0.523,47,98,0.48,28,36,0.778,35,179,214,76,19,31,29,64,277,488,2.62,0.66,2021,22,12.043478260869565,2.6206896551724137,92,8,100,2.14
2021-22,Playoffs,1628389,13,Bam Adebayo,1610612748,MIA,18,614,104,175,0.594,0,1,0.0,58,76,0.763,37,107,144,48,18,13,38,55,266,362,1.26,0.47,2021,22,14.777777777777779,1.263157894736842,71,18,89,1.6179775280898876
2021-22,Playoffs,203915,14,Spencer Dinwiddie,1610612742,DAL,18,501,80,192,0.417,40,96,0.417,55,67,0.821,8,36,44,65,15,6,29,42,255,232,2.24,0.52,2021,22,14.166666666666666,2.2413793103448274,112,12,124,0.3548387096774194
2021-22,Playoffs,1630178,15,Tyrese Maxey,1610612755,PHI,12,485,88,182,0.484,26,69,0.377,47,50,0.94,6,36,42,47,9,2,21,24,249,231,2.24,0.43,2021,22,20.75,2.238095238095238,94,3,97,0.4329896907216495
2021-22,Playoffs,1629630,16,Ja Morant,1610612763,MEM,9,338,81,184,0.44,17,50,0.34,65,87,0.747,13,59,72,88,18,4,32,22,244,269,2.75,0.56,2021,22,27.11111111111111,2.75,103,22,125,0.576
2021-22,Playoffs,203954,17,Joel Embiid,1610612755,PHI,10,385,78,161,0.484,7,33,0.212,73,89,0.82,21,86,107,21,4,8,32,34,236,245,0.66,0.13,2021,22,23.6,0.65625,83,16,99,1.0808080808080809
2021-22,Playoffs,1629028,18,Deandre Ayton,1610612756,PHX,13,397,105,164,0.64,2,4,0.5,21,33,0.636,33,83,116,22,5,10,19,34,233,296,1.16,0.26,2021,22,17.923076923076923,1.1578947368421053,59,12,71,1.6338028169014085
2021-22,Playoffs,1626164,18,Devin Booker,1610612756,PHX,10,366,79,175,0.451,28,65,0.431,47,53,0.887,10,38,48,44,5,4,32,25,233,200,1.38,0.16,2021,22,23.3,1.375,96,6,102,0.47058823529411764
2021-22,Playoffs,201950,20,Jrue Holiday,1610612749,MIL,12,463,89,235,0.379,25,79,0.316,26,31,0.839,12,55,67,78,21,7,34,28,229,217,2.29,0.62,2021,22,19.083333333333332,2.2941176470588234,146,5,151,0.44370860927152317
2021-22,Playoffs,101108,21,Chris Paul,1610612756,PHX,13,448,87,155,0.561,19,49,0.388,35,37,0.946,7,47,54,108,19,2,31,40,228,310,3.48,0.61,2021,22,17.53846153846154,3.4838709677419355,68,2,70,0.7714285714285715
2021-22,Playoffs,1630217,22,Desmond Bane,1610612763,MEM,12,428,76,159,0.478,43,88,0.489,30,35,0.857,5,40,45,26,11,9,16,23,225,212,1.63,0.69,2021,22,18.75,1.625,83,5,88,0.5113636363636364
2021-22,Playoffs,201935,23,James Harden,1610612755,PHI,12,479,64,158,0.405,28,76,0.368,67,75,0.893,11,57,68,103,9,8,50,29,223,259,2.06,0.18,2021,22,18.583333333333332,2.06,94,8,102,0.6666666666666666
2021-22,Playoffs,1627827,24,Dorian Finney-Smith,1610612742,DAL,18,688,74,157,0.471,46,108,0.426,17,24,0.708,32,67,99,35,17,7,18,53,211,261,1.94,0.94,2021,22,11.722222222222221,1.9444444444444444,83,7,90,1.1
2021-22,Playoffs,1629684,25,Grant Williams,1610612738,BOS,24,654,65,150,0.433,35,89,0.393,42,52,0.808,23,68,91,19,8,18,20,83,207,228,0.95,0.4,2021,22,8.625,0.95,85,10,95,0.9578947368421052
2021-22,Playoffs,202699,26,Tobias Harris,1610612755,PHI,12,466,81,162,0.5,22,57,0.386,19,22,0.864,10,81,91,35,13,10,18,35,203,250,1.94,0.72,2021,22,16.916666666666668,1.9444444444444444,81,3,84,1.0833333333333333
2021-22,Playoffs,1628401,27,Derrick White,1610612738,BOS,23,585,64,176,0.364,26,83,0.313,42,51,0.824,8,62,70,61,21,13,29,46,196,211,2.1,0.72,2021,22,8.521739130434783,2.103448275862069,112,9,121,0.5785123966942148
2021-22,Playoffs,1629622,27,Max Strus,1610612748,MIA,18,523,68,182,0.374,47,142,0.331,13,18,0.722,15,58,73,38,14,8,20,55,196,190,1.9,0.7,2021,22,10.88888888888889,1.9,114,5,119,0.6134453781512605
2021-22,Playoffs,203493,29,Reggie Bullock Jr.,1610612742,DAL,18,707,61,151,0.404,52,131,0.397,16,18,0.889,8,74,82,30,22,1,8,48,190,225,3.75,2.75,2021,22,10.555555555555555,3.75,90,2,92,0.8913043478260869
2021-22,Playoffs,1629639,30,Tyler Herro,1610612748,MIA,15,381,74,181,0.409,16,70,0.229,25,27,0.926,7,51,58,42,9,6,27,21,189,168,1.56,0.33,2021,22,12.6,1.5555555555555556,107,2,109,0.5321100917431193
2021-22,Playoffs,1628991,31,Jaren Jackson Jr.,1610612763,MEM,12,332,59,156,0.378,27,72,0.375,40,53,0.755,26,55,81,11,9,30,17,53,185,189,0.65,0.53,2021,22,15.416666666666666,0.6470588235294118,97,13,110,0.7363636363636363
2021-22,Playoffs,203110,32,Draymond Green,1610612744,GSW,22,703,69,144,0.479,8,39,0.205,30,47,0.638,26,133,159,138,25,22,59,87,176,369,2.34,0.42,2021,22,8.0,2.3389830508474576,75,17,92,1.7282608695652173
2021-22,Playoffs,1628969,33,Mikal Bridges,1610612756,PHX,13,500,66,138,0.478,13,33,0.394,28,30,0.933,12,49,61,37,14,13,11,31,173,213,3.36,1.27,2021,22,13.307692307692308,3.3636363636363638,72,2,74,0.8243243243243243
2021-22,Playoffs,1627742,34,Brandon Ingram,1610612740,NOP,6,236,56,118,0.475,11,27,0.407,39,47,0.83,4,33,37,37,4,2,23,11,162,149,1.61,0.17,2021,22,27.0,1.608695652173913,62,8,70,0.5285714285714286
2021-22,Playoffs,1628415,35,Dillon Brooks,1610612763,MEM,11,335,60,172,0.349,25,72,0.347,16,25,0.64,8,22,30,30,11,3,22,36,161,92,1.36,0.5,2021,22,14.636363636363637,1.3636363636363635,112,9,121,0.24793388429752067
2021-22,Playoffs,203506,36,Victor Oladipo,1610612748,MIA,15,368,50,136,0.368,17,62,0.274,42,53,0.792,4,47,51,31,19,4,25,29,159,142,1.24,0.76,2021,22,10.6,1.24,86,11,97,0.5257731958762887
2021-22,Playoffs,1628467,37,Maxi Kleber,1610612742,DAL,18,457,54,106,0.509,34,78,0.436,15,21,0.714,15,67,82,20,4,15,11,49,157,209,1.82,0.36,2021,22,8.722222222222221,1.8181818181818181,52,6,58,1.4137931034482758
2021-22,Playoffs,203999,38,Nikola Jokic,1610612743,DEN,5,171,61,106,0.575,5,18,0.278,28,33,0.848,17,49,66,29,8,5,24,20,155,189,1.21,0.33,2021,22,31.0,1.2083333333333333,45,5,50,1.32
2021-22,Playoffs,1628378,39,Donovan Mitchell,1610612762,UTA,6,230,53,133,0.398,10,48,0.208,37,42,0.881,6,20,26,34,4,3,16,14,153,119,2.13,0.25,2021,22,25.5,2.125,80,5,85,0.3058823529411765
2021-22,Playoffs,1630162,40,Anthony Edwards,1610612750,MIN,6,227,50,110,0.455,23,57,0.404,28,34,0.824,4,21,25,18,7,7,15,22,151,127,1.2,0.47,2021,22,25.166666666666668,1.2,60,6,66,0.3787878787878788
2021-22,Playoffs,1629634,41,Brandon Clarke,1610612763,MEM,12,296,56,91,0.615,0,1,0.0,36,54,0.667,37,46,83,24,9,10,12,23,148,209,2.0,0.75,2021,22,12.333333333333334,2.0,35,18,53,1.5660377358490567
2021-22,Playoffs,1629216,42,Gabe Vincent,1610612748,MIA,18,423,50,131,0.382,25,81,0.309,19,20,0.95,3,32,35,57,14,5,25,41,144,148,2.28,0.56,2021,22,8.0,2.28,81,1,82,0.4268292682926829
2021-22,Playoffs,200782,43,P.J. Tucker,1610612748,MIA,18,509,54,109,0.495,23,51,0.451,11,16,0.688,35,67,102,32,14,5,13,50,142,222,2.46,1.08,2021,22,7.888888888888889,2.4615384615384617,55,5,60,1.7
2021-22,Playoffs,1629661,44,Cameron Johnson,1610612756,PHX,13,320,46,99,0.465,22,59,0.373,26,32,0.813,9,37,46,20,5,1,12,31,140,141,1.67,0.42,2021,22,10.76923076923077,1.6666666666666667,53,6,59,0.7796610169491526
2021-22,Playoffs,1627783,45,Pascal Siakam,1610612761,TOR,6,260,51,107,0.477,4,17,0.235,31,36,0.861,8,35,43,35,7,6,13,24,137,154,2.69,0.54,2021,22,22.833333333333332,2.6923076923076925,56,5,61,0.7049180327868853
2021-22,Playoffs,203468,46,CJ McCollum,1610612740,NOP,6,234,49,125,0.392,17,51,0.333,18,26,0.692,11,29,40,29,4,5,15,15,133,112,1.93,0.27,2021,22,22.166666666666668,1.9333333333333333,76,8,84,0.47619047619047616
2021-22,Playoffs,1626157,47,Karl-Anthony Towns,1610612750,MIN,6,222,39,80,0.488,10,22,0.455,43,50,0.86,11,54,65,13,4,12,27,25,131,150,0.48,0.15,2021,22,21.833333333333332,0.48148148148148145,41,7,48,1.3541666666666667
2021-22,Playoffs,1629057,47,Robert Williams III,1610612738,BOS,17,394,53,78,0.679,0,1,0.0,25,28,0.893,43,62,105,17,12,38,10,34,131,265,1.7,1.2,2021,22,7.705882352941177,1.7,25,3,28,3.75
2021-22,Playoffs,1626171,49,Bobby Portis,1610612749,MIL,12,298,48,115,0.417,14,47,0.298,17,22,0.773,25,95,120,9,5,3,16,26,127,176,0.56,0.31,2021,22,10.583333333333334,0.5625,67,5,72,1.6666666666666667
2021-22,Playoffs,201572,49,Brook Lopez,1610612749,MIL,12,332,50,102,0.49,6,28,0.214,21,23,0.913,27,44,71,8,6,18,11,32,127,165,0.73,0.55,2021,22,10.583333333333334,0.7272727272727273,52,2,54,1.3148148148148149
2021-22,Playoffs,1626172,49,Kevon Looney,1610612744,GSW,22,448,58,88,0.659,0,0,0.0,11,18,0.611,63,105,168,48,9,10,19,50,127,306,2.53,0.47,2021,22,5.7727272727272725,2.526315789473684,30,7,37,4.54054054054054
2021-22,Playoffs,203109,52,Jae Crowder,1610612756,PHX,13,383,42,105,0.4,19,63,0.302,19,26,0.731,8,53,61,31,13,7,19,47,122,145,1.63,0.68,2021,22,9.384615384615385,1.631578947368421,63,7,70,0.8714285714285714
2021-22,Playoffs,1626192,53,Pat Connaughton,1610612749,MIL,12,318,42,88,0.477,25,64,0.391,5,5,1.0,3,48,51,11,5,4,7,14,114,132,1.57,0.71,2021,22,9.5,1.5714285714285714,46,0,46,1.108695652173913
2021-22,Playoffs,1630202,53,Payton Pritchard,1610612738,BOS,24,309,43,102,0.422,24,72,0.333,4,6,0.667,10,36,46,38,6,2,9,23,114,136,4.22,0.67,2021,22,4.75,4.222222222222222,59,2,61,0.7540983606557377
2021-22,Playoffs,1626145,55,Tyus Jones,1610612763,MEM,12,262,39,99,0.394,18,45,0.4,14,15,0.933,4,35,39,54,14,2,13,8,110,145,4.15,1.08,2021,22,9.166666666666666,4.153846153846154,60,1,61,0.639344262295082
2021-22,Playoffs,202711,56,Bojan Bogdanovic,1610612762,UTA,6,214,39,81,0.481,11,33,0.333,19,24,0.792,3,22,25,10,2,0,12,24,108,86,0.83,0.17,2021,22,18.0,0.8333333333333334,42,5,47,0.5319148936170213
2021-22,Playoffs,1629631,57,De'Andre Hunter,1610612737,ATL,5,175,39,70,0.557,12,26,0.462,16,20,0.8,2,17,19,3,4,1,11,20,106,87,0.27,0.36,2021,22,21.2,0.2727272727272727,31,4,35,0.5428571428571428
2021-22,Playoffs,203903,58,Jordan Clarkson,1610612762,UTA,6,170,40,73,0.548,9,24,0.375,16,18,0.889,5,14,19,8,3,1,10,17,105,91,0.8,0.3,2021,22,17.5,0.8,33,2,35,0.5428571428571428
2021-22,Playoffs,201142,58,Kevin Durant,1610612751,BKN,4,176,32,83,0.386,7,21,0.333,34,38,0.895,2,21,23,25,4,1,21,15,105,82,1.19,0.19,2021,22,26.25,1.1904761904761905,51,4,55,0.41818181818181815
2021-22,Playoffs,201942,60,DeMar DeRozan,1610612741,CHI,5,203,39,95,0.411,0,9,0.0,26,30,0.867,1,26,27,24,9,2,11,12,104,95,2.18,0.82,2021,22,20.8,2.1818181818181817,56,4,60,0.45
2021-22,Playoffs,1628384,60,OG Anunoby,1610612761,TOR,6,217,39,82,0.476,14,41,0.341,12,16,0.75,7,17,24,15,6,1,10,18,104,93,1.5,0.6,2021,22,17.333333333333332,1.5,43,4,47,0.5106382978723404
2021-22,Playoffs,201980,62,Danny Green,1610612755,PHI,12,319,36,89,0.404,31,76,0.408,0,1,0.0,9,28,37,10,12,4,13,23,103,99,0.77,0.92,2021,22,8.583333333333334,0.7692307692307693,53,1,54,0.6851851851851852
2021-22,Playoffs,203490,63,Otto Porter Jr.,1610612744,GSW,19,371,38,77,0.494,19,47,0.404,7,9,0.778,12,53,65,34,17,6,12,34,102,171,2.83,1.42,2021,22,5.368421052631579,2.8333333333333335,39,2,41,1.5853658536585367
2021-22,Playoffs,1628960,64,Grayson Allen,1610612749,MIL,12,305,37,82,0.451,19,48,0.396,7,11,0.636,5,30,35,15,8,4,9,22,100,104,1.67,0.89,2021,22,8.333333333333334,1.6666666666666667,45,4,49,0.7142857142857143
2021-22,Playoffs,202696,65,Nikola Vucevic,1610612741,CHI,5,181,40,91,0.44,13,42,0.31,4,5,0.8,14,48,62,16,2,6,8,14,97,123,2.0,0.25,2021,22,19.4,2.0,51,1,52,1.1923076923076923
2021-22,Playoffs,1629018,66,Gary Trent Jr.,1610612761,TOR,6,199,31,82,0.378,13,39,0.333,17,19,0.895,1,9,10,8,6,3,3,11,92,63,2.67,2.0,2021,22,15.333333333333334,2.6666666666666665,51,2,53,0.18867924528301888
2021-22,Playoffs,202685,67,Jonas Valanciunas,1610612740,NOP,6,175,33,68,0.485,1,6,0.167,20,26,0.769,33,53,86,18,4,1,12,17,87,143,1.5,0.33,2021,22,14.5,1.5,35,6,41,2.097560975609756
2021-22,Playoffs,202681,68,Kyrie Irving,1610612751,BKN,4,170,28,63,0.444,8,21,0.381,21,21,1.0,6,15,21,21,7,5,9,13,85,95,2.33,0.78,2021,22,21.25,2.3333333333333335,35,0,35,0.6
2021-22,Playoffs,1630228,69,Jonathan Kuminga,1610612744,GSW,16,138,30,60,0.5,3,13,0.231,20,26,0.769,4,23,27,8,3,2,11,11,83,76,0.73,0.27,2021,22,5.1875,0.7272727272727273,30,6,36,0.75
2021-22,Playoffs,201580,70,JaVale McGee,1610612756,PHX,12,133,35,50,0.7,0,1,0.0,11,13,0.846,16,32,48,7,3,5,9,27,81,118,0.78,0.33,2021,22,6.75,0.7777777777777778,15,2,17,2.823529411764706
2021-22,Playoffs,1627780,71,Gary Payton II,1610612744,GSW,12,203,29,44,0.659,8,15,0.533,12,18,0.667,13,24,37,16,14,7,6,23,78,125,2.67,2.33,2021,22,6.5,2.6666666666666665,15,6,21,1.7619047619047619
2021-22,Playoffs,200768,71,Kyle Lowry,1610612748,MIA,10,295,25,86,0.291,13,54,0.241,15,19,0.789,3,33,36,47,12,7,19,29,78,96,2.47,0.63,2021,22,7.8,2.473684210526316,61,4,65,0.5538461538461539
2021-22,Playoffs,1629027,73,Trae Young,1610612737,ATL,5,187,22,69,0.319,7,38,0.184,26,33,0.788,5,20,25,30,3,0,31,13,77,50,0.97,0.1,2021,22,15.4,0.967741935483871,47,7,54,0.46296296296296297
2021-22,Playoffs,203897,73,Zach LaVine,1610612741,CHI,4,153,27,63,0.429,9,24,0.375,14,15,0.933,0,21,21,24,3,1,12,9,77,77,2.0,0.25,2021,22,19.25,2.0,36,1,37,0.5675675675675675
2021-22,Playoffs,1628997,75,Caleb Martin,1610612748,MIA,17,209,32,80,0.4,10,33,0.303,2,6,0.333,12,25,37,5,10,2,10,17,76,68,0.5,1.0,2021,22,4.470588235294118,0.5,48,4,52,0.7115384615384616
2021-22,Playoffs,202083,76,Wesley Matthews,1610612749,MIL,12,345,25,64,0.391,18,45,0.4,6,9,0.667,9,28,37,14,9,3,6,27,74,89,2.33,1.5,2021,22,6.166666666666667,2.3333333333333335,39,3,42,0.8809523809523809
2021-22,Playoffs,1629130,77,Duncan Robinson,1610612748,MIA,13,159,25,57,0.439,18,47,0.383,5,6,0.833,2,21,23,5,4,1,3,22,73,70,1.67,1.33,2021,22,5.615384615384615,1.6666666666666667,32,1,33,0.696969696969697
2021-22,Playoffs,202722,77,Dāvis Bertāns,1610612742,DAL,18,192,22,55,0.4,19,51,0.373,10,12,0.833,4,22,26,6,8,2,3,25,73,77,2.0,2.67,2021,22,4.055555555555555,2.0,33,2,35,0.7428571428571429
2021-22,Playoffs,1626156,79,D'Angelo Russell,1610612750,MIN,6,196,24,72,0.333,12,31,0.387,12,16,0.75,0,15,15,40,9,0,17,17,72,67,2.35,0.53,2021,22,12.0,2.3529411764705883,48,4,52,0.28846153846153844
2021-22,Playoffs,203937,79,Kyle Anderson,1610612763,MEM,12,221,29,51,0.569,3,12,0.25,11,18,0.611,10,42,52,21,11,7,10,22,72,124,2.1,1.1,2021,22,6.0,2.1,22,7,29,1.793103448275862
2021-22,Playoffs,203497,79,Rudy Gobert,1610612762,UTA,6,197,21,33,0.636,0,0,0.0,30,44,0.682,21,58,79,3,1,6,8,19,72,127,0.38,0.13,2021,22,12.0,0.375,12,14,26,3.0384615384615383
2021-22,Playoffs,1628420,82,Monte Morris,1610612743,DEN,5,156,25,51,0.49,11,26,0.423,9,12,0.75,1,10,11,27,6,0,8,14,70,77,3.38,0.75,2021,22,14.0,3.375,26,3,29,0.3793103448275862
2021-22,Playoffs,203932,83,Aaron Gordon,1610612743,DEN,5,160,23,54,0.426,3,15,0.2,20,28,0.714,18,18,36,13,2,6,8,14,69,79,1.63,0.25,2021,22,13.8,1.625,31,8,39,0.9230769230769231
2021-22,Playoffs,1628464,83,Daniel Theis,1610612738,BOS,16,200,30,51,0.588,3,14,0.214,6,8,0.75,13,39,52,11,4,8,11,25,69,110,1.0,0.36,2021,22,4.3125,1.0,21,2,23,2.260869565217391
2021-22,Playoffs,203115,83,Will Barton,1610612743,DEN,5,172,27,66,0.409,11,28,0.393,4,6,0.667,5,23,28,14,4,1,10,11,69,65,1.4,0.4,2021,22,13.8,1.4,39,2,41,0.6829268292682927
2021-22,Playoffs,1630533,83,Ziaire Williams,1610612763,MEM,10,168,23,52,0.442,11,36,0.306,12,13,0.923,4,12,16,5,5,0,2,14,69,63,2.5,2.5,2021,22,6.9,2.5,29,1,30,0.5333333333333333
2021-22,Playoffs,1628449,87,Chris Boucher,1610612761,TOR,6,130,26,42,0.619,6,15,0.4,9,10,0.9,12,23,35,1,1,7,2,13,67,92,0.5,0.5,2021,22,11.166666666666666,0.5,16,1,17,2.0588235294117645
2021-22,Playoffs,201976,88,Patrick Beverley,1610612750,MIN,6,194,21,49,0.429,9,26,0.346,15,22,0.682,4,15,19,29,7,7,12,28,66,81,2.42,0.58,2021,22,11.0,2.4166666666666665,28,7,35,0.5428571428571428
2021-22,Playoffs,1630529,89,Herbert Jones,1610612740,NOP,6,226,21,44,0.477,5,12,0.417,17,22,0.773,8,12,20,11,11,5,8,22,64,75,1.38,1.38,2021,22,10.666666666666666,1.375,23,5,28,0.7142857142857143
2021-22,Playoffs,1630173,90,Precious Achiuwa,1610612761,TOR,6,167,25,52,0.481,5,16,0.313,6,10,0.6,8,21,29,6,1,5,9,14,61,62,0.67,0.11,2021,22,10.166666666666666,0.6666666666666666,27,4,31,0.9354838709677419
2021-22,Playoffs,1629003,91,Shake Milton,1610612755,PHI,12,158,18,38,0.474,8,15,0.533,16,20,0.8,4,15,19,11,6,3,5,13,60,70,2.2,1.2,2021,22,5.0,2.2,20,4,24,0.7916666666666666
2021-22,Playoffs,1630172,92,Patrick Williams,1610612741,CHI,5,153,22,47,0.468,7,21,0.333,8,11,0.727,6,21,27,4,5,3,7,15,59,63,0.57,0.71,2021,22,11.8,0.5714285714285714,25,3,28,0.9642857142857143
2021-22,Playoffs,203939,93,Dwight Powell,1610612742,DAL,18,249,22,35,0.629,0,2,0.0,14,23,0.609,17,30,47,4,3,6,9,40,58,87,0.44,0.33,2021,22,3.2222222222222223,0.4444444444444444,13,9,22,2.1363636363636362
2021-22,Playoffs,1627777,93,Georges Niang,1610612755,PHI,12,198,20,48,0.417,16,43,0.372,2,2,1.0,4,14,18,11,3,0,7,30,58,55,1.57,0.43,2021,22,4.833333333333333,1.5714285714285714,28,0,28,0.6428571428571429
2021-22,Playoffs,203552,93,Seth Curry,1610612751,BKN,4,132,22,39,0.564,12,23,0.522,2,3,0.667,2,8,10,12,1,3,3,15,58,63,4.0,0.33,2021,22,14.5,4.0,17,1,18,0.5555555555555556
2021-22,Playoffs,203992,96,Bogdan Bogdanovic,1610612737,ATL,4,107,20,49,0.408,9,26,0.346,8,10,0.8,4,15,19,12,1,1,4,12,57,55,3.0,0.25,2021,22,14.25,3.0,29,2,31,0.6129032258064516
2021-22,Playoffs,1628971,97,Bruce Brown,1610612751,BKN,4,139,21,37,0.568,6,14,0.429,8,10,0.8,6,13,19,11,5,3,9,16,56,67,1.22,0.56,2021,22,14.0,1.2222222222222223,16,2,18,1.0555555555555556
2021-22,Playoffs,1629001,97,De'Anthony Melton,1610612763,MEM,10,170,21,65,0.323,11,44,0.25,3,4,0.75,9,22,31,16,10,5,14,9,56,59,1.14,0.71,2021,22,5.6,1.1428571428571428,44,1,45,0.6888888888888889
2021-22,Playoffs,1630183,97,Jaden McDaniels,1610612750,MIN,6,130,18,34,0.529,10,20,0.5,10,12,0.833,5,12,17,4,2,11,6,18,56,66,0.67,0.33,2021,22,9.333333333333334,0.6666666666666666,16,2,18,0.9444444444444444
2021-22,Playoffs,1627832,100,Fred VanVleet,1610612761,TOR,4,140,19,54,0.352,12,36,0.333,5,6,0.833,2,10,12,25,7,4,4,12,55,63,6.25,1.75,2021,22,13.75,6.25,35,1,36,0.3333333333333333
2021-22,Playoffs,1626204,100,Larry Nance Jr.,1610612740,NOP,6,130,22,39,0.564,2,9,0.222,9,11,0.818,19,16,35,11,3,2,6,15,55,81,1.83,0.5,2021,22,9.166666666666666,1.8333333333333333,17,2,19,1.8421052631578947
2021-22,Playoffs,201144,100,Mike Conley,1610612762,UTA,6,174,19,57,0.333,5,25,0.2,12,15,0.8,2,17,19,29,5,2,13,19,55,56,2.23,0.39,2021,22,9.166666666666666,2.230769230769231,38,3,41,0.4634146341463415
2021-22,Playoffs,1626166,103,Cameron Payne,1610612756,PHX,13,172,22,74,0.297,5,30,0.167,5,6,0.833,2,18,20,27,7,1,13,25,54,43,2.08,0.54,2021,22,4.153846153846154,2.076923076923077,52,1,53,0.37735849056603776
2021-22,Playoffs,202326,104,DeMarcus Cousins,1610612743,DEN,5,57,19,29,0.655,4,6,0.667,11,15,0.733,3,14,17,6,3,1,7,9,53,59,0.86,0.43,2021,22,10.6,0.8571428571428571,10,4,14,1.2142857142857142
2021-22,Playoffs,203473,104,Dewayne Dedmon,1610612748,MIA,14,138,21,45,0.467,1,10,0.1,10,12,0.833,15,27,42,5,1,3,7,36,53,71,0.71,0.14,2021,22,3.7857142857142856,0.7142857142857143,24,2,26,1.6153846153846154
2021-22,Playoffs,1629013,106,Landry Shamet,1610612756,PHX,12,192,19,48,0.396,9,26,0.346,5,7,0.714,3,17,20,15,6,0,7,10,52,55,2.14,0.86,2021,22,4.333333333333333,2.142857142857143,29,2,31,0.6451612903225806
2021-22,Playoffs,201568,107,Danilo Gallinari,1610612737,ATL,5,112,18,45,0.4,4,15,0.267,11,11,1.0,2,19,21,4,1,0,5,6,51,45,0.8,0.2,2021,22,10.2,0.8,27,0,27,0.7777777777777778
2021-22,Playoffs,1627736,107,Malik Beasley,1610612750,MIN,6,119,19,44,0.432,8,25,0.32,5,6,0.833,2,18,20,4,2,1,7,9,51,45,0.57,0.29,2021,22,8.5,0.5714285714285714,25,1,26,0.7692307692307693
2021-22,Playoffs,1630567,107,Scottie Barnes,1610612761,TOR,4,133,18,42,0.429,2,12,0.167,13,16,0.813,7,29,36,17,4,1,5,12,51,77,3.4,0.8,2021,22,12.75,3.4,24,3,27,1.3333333333333333
2021-22,Playoffs,1630631,110,Jose Alvarado,1610612740,NOP,6,117,16,33,0.485,6,16,0.375,10,13,0.769,2,6,8,9,7,1,7,18,48,46,1.29,1.0,2021,22,8.0,1.2857142857142858,17,3,20,0.4
2021-22,Playoffs,1628381,111,John Collins,1610612737,ATL,5,122,19,39,0.487,4,11,0.364,5,10,0.5,2,21,23,6,2,1,5,12,47,49,1.2,0.4,2021,22,9.4,1.2,20,5,25,0.92
2021-22,Playoffs,1630538,112,Bones Hyland,1610612743,DEN,5,87,13,36,0.361,8,23,0.348,12,14,0.857,1,9,10,16,1,0,6,12,46,42,2.67,0.17,2021,22,9.2,2.6666666666666665,23,2,25,0.4
2021-22,Playoffs,1628989,112,Kevin Huerter,1610612737,ATL,5,154,17,47,0.362,9,31,0.29,3,4,0.75,1,14,15,19,6,3,11,15,46,47,1.73,0.55,2021,22,9.2,1.7272727272727273,30,1,31,0.4838709677419355
2021-22,Playoffs,1630194,114,Paul Reed,1610612755,PHI,12,140,19,36,0.528,2,3,0.667,4,7,0.571,22,24,46,10,9,6,9,29,44,86,1.11,1.0,2021,22,3.6666666666666665,1.1111111111111112,17,3,20,2.3
2021-22,Playoffs,202357,115,Nemanja Bjelica,1610612744,GSW,15,150,18,34,0.529,3,8,0.375,4,7,0.571,6,25,31,17,4,2,7,21,43,71,2.43,0.57,2021,22,2.8666666666666667,2.4285714285714284,16,3,19,1.631578947368421
2021-22,Playoffs,1629632,116,Coby White,1610612741,CHI,5,98,15,45,0.333,8,29,0.276,4,5,0.8,0,17,17,9,1,0,6,5,42,32,1.5,0.17,2021,22,8.4,1.5,30,1,31,0.5483870967741935
2021-22,Playoffs,201609,116,Goran Dragic,1610612751,BKN,4,79,18,32,0.563,4,12,0.333,2,2,1.0,6,12,18,6,3,0,5,11,42,50,1.2,0.6,2021,22,10.5,1.2,14,0,14,1.2857142857142858
2021-22,Playoffs,1629651,116,Nic Claxton,1610612751,BKN,4,98,19,24,0.792,0,0,0.0,4,22,0.182,7,18,25,6,5,9,2,6,42,62,3.0,2.5,2021,22,10.5,3.0,5,18,23,1.0869565217391304
2021-22,Playoffs,1626153,119,Delon Wright,1610612737,ATL,5,137,15,29,0.517,5,13,0.385,6,9,0.667,11,13,24,14,4,1,5,2,41,62,2.8,0.8,2021,22,8.2,2.8,14,3,17,1.411764705882353
2021-22,Playoffs,1630541,119,Moses Moody,1610612744,GSW,13,105,15,28,0.536,7,13,0.538,4,6,0.667,2,6,8,4,3,3,3,4,41,41,1.33,1.0,2021,22,3.1538461538461537,1.3333333333333333,13,2,15,0.5333333333333333
2021-22,Playoffs,1630214,121,Xavier Tillman,1610612763,MEM,9,139,18,25,0.72,1,2,0.5,3,6,0.5,13,17,30,6,6,1,10,16,40,63,0.6,0.6,2021,22,4.444444444444445,0.6,7,3,10,3.0
2021-22,Playoffs,1626220,122,Royce O'Neale,1610612762,UTA,6,188,14,35,0.4,7,25,0.28,2,2,1.0,6,28,34,9,3,1,3,16,37,60,3.0,1.0,2021,22,6.166666666666667,3.0,21,0,21,1.619047619047619
2021-22,Playoffs,1629637,123,Jaxson Hayes,1610612740,NOP,6,83,14,25,0.56,0,3,0.0,7,11,0.636,4,11,15,1,0,2,4,11,35,34,0.25,0.0,2021,22,5.833333333333333,0.25,11,4,15,1.0
2021-22,Playoffs,1629020,124,Jarred Vanderbilt,1610612750,MIN,6,129,13,27,0.481,0,0,0.0,7,10,0.7,12,31,43,4,7,2,5,16,33,67,0.8,1.4,2021,22,5.5,0.8,14,3,17,2.5294117647058822
2021-22,Playoffs,1627814,125,Damion Lee,1610612744,GSW,16,124,13,34,0.382,4,16,0.25,2,3,0.667,5,21,26,7,1,0,6,8,32,38,1.17,0.17,2021,22,2.0,1.1666666666666667,21,1,22,1.1818181818181819
2021-22,Playoffs,203504,125,Trey Burke,1610612742,DAL,10,37,11,22,0.5,4,10,0.4,6,6,1.0,0,3,3,4,1,0,1,3,32,28,4.0,1.0,2021,22,3.2,4.0,11,0,11,0.2727272727272727
2021-22,Playoffs,1629162,127,Jordan McLaughlin,1610612750,MIN,5,83,12,17,0.706,4,7,0.571,3,4,0.75,0,12,12,17,5,0,2,5,31,57,8.5,2.5,2021,22,6.2,8.5,5,1,6,2.0
2021-22,Playoffs,1630530,127,Trey Murphy III,1610612740,NOP,6,120,9,22,0.409,9,19,0.474,4,5,0.8,3,12,15,3,3,1,1,9,31,38,3.0,3.0,2021,22,5.166666666666667,3.0,13,1,14,1.0714285714285714
2021-22,Playoffs,1627752,129,Taurean Prince,1610612750,MIN,5,65,10,27,0.37,4,14,0.286,6,7,0.857,1,7,8,6,2,1,4,5,30,25,1.5,0.5,2021,22,6.0,1.5,17,1,18,0.4444444444444444
2021-22,Playoffs,203114,130,Khris Middleton,1610612749,MIL,2,71,10,24,0.417,6,14,0.429,3,3,1.0,1,9,10,14,3,0,11,6,29,31,1.27,0.27,2021,22,14.5,1.2727272727272727,14,0,14,0.7142857142857143
2021-22,Playoffs,1627788,131,Furkan Korkmaz,1610612755,PHI,9,61,11,23,0.478,4,10,0.4,2,2,1.0,1,11,12,4,1,1,2,7,28,32,2.0,0.5,2021,22,3.111111111111111,2.0,12,0,12,1.0
2021-22,Playoffs,1629680,132,Matisse Thybulle,1610612755,PHI,9,137,11,24,0.458,4,14,0.286,1,3,0.333,2,7,9,4,7,7,2,15,27,37,2.0,3.5,2021,22,3.0,2.0,13,2,15,0.6
2021-22,Playoffs,1627863,133,Danuel House Jr.,1610612762,UTA,6,112,9,22,0.409,2,10,0.2,6,8,0.75,2,15,17,4,0,1,6,7,26,27,0.67,0.0,2021,22,4.333333333333333,0.6666666666666666,13,2,15,1.1333333333333333
2021-22,Playoffs,1630168,133,Onyeka Okongwu,1610612737,ATL,5,108,9,16,0.563,0,0,0.0,8,10,0.8,11,16,27,2,4,4,4,19,26,50,0.5,1.0,2021,22,5.2,0.5,7,2,9,3.0
2021-22,Playoffs,1627936,135,Alex Caruso,1610612741,CHI,4,113,9,23,0.391,7,18,0.389,0,0,0.0,2,9,11,17,5,4,1,11,25,47,17.0,5.0,2021,22,6.25,17.0,14,0,14,0.7857142857142857
2021-22,Playoffs,202687,135,Bismack Biyombo,1610612756,PHX,9,86,11,17,0.647,0,0,0.0,3,6,0.5,8,11,19,5,1,2,6,13,25,37,0.83,0.17,2021,22,2.7777777777777777,0.8333333333333334,6,3,9,2.111111111111111
2021-22,Playoffs,1630209,135,Omer Yurtseven,1610612748,MIA,9,38,12,18,0.667,0,2,0.0,1,3,0.333,1,6,7,3,0,1,0,2,25,28,0.0,0.0,2021,22,2.7777777777777777,inf,6,2,8,0.875
2021-22,Playoffs,201988,135,Patty Mills,1610612751,BKN,4,72,9,16,0.563,7,13,0.538,0,0,0.0,0,4,4,0,0,1,1,5,25,22,0.0,0.0,2021,22,6.25,0.0,7,0,7,0.5714285714285714
2021-22,Playoffs,1628984,139,Devonte' Graham,1610612740,NOP,6,60,6,18,0.333,5,14,0.357,7,8,0.875,2,7,9,4,1,1,4,3,24,22,1.0,0.25,2021,22,4.0,1.0,12,1,13,0.6923076923076923
2021-22,Playoffs,1629675,139,Naz Reid,1610612750,MIN,5,54,7,17,0.412,3,7,0.429,7,7,1.0,2,12,14,0,1,6,5,14,24,30,0.0,0.2,2021,22,4.8,0.0,10,0,10,1.4
2021-22,Playoffs,203500,139,Steven Adams,1610612763,MEM,7,114,9,21,0.429,0,0,0.0,6,11,0.545,15,30,45,15,1,1,4,12,24,65,3.75,0.25,2021,22,3.4285714285714284,3.75,12,5,17,2.6470588235294117
2021-22,Playoffs,1628373,142,Frank Ntilikina,1610612742,DAL,12,125,8,24,0.333,6,20,0.3,1,1,1.0,2,10,12,9,8,1,6,19,23,31,1.5,1.33,2021,22,1.9166666666666667,1.5,16,0,16,0.75
2021-22,Playoffs,1628975,142,Jevon Carter,1610612749,MIL,11,126,9,19,0.474,3,7,0.429,2,2,1.0,3,13,16,10,8,0,6,12,23,41,1.67,1.33,2021,22,2.090909090909091,1.6666666666666667,10,0,10,1.6
2021-22,Playoffs,1630182,142,Josh Green,1610612742,DAL,16,121,8,28,0.286,5,22,0.227,2,8,0.25,1,11,12,7,5,0,0,16,23,21,0.0,0.0,2021,22,1.4375,inf,20,6,26,0.46153846153846156
2021-22,Playoffs,1628995,145,Kevin Knox II,1610612737,ATL,2,9,7,11,0.636,6,10,0.6,2,2,1.0,0,2,2,0,2,0,3,0,22,19,0.0,0.67,2021,22,11.0,0.0,4,0,4,0.5
2021-22,Playoffs,1628988,146,Aaron Holiday,1610612756,PHX,6,20,8,14,0.571,5,7,0.714,0,1,0.0,3,0,3,9,3,1,0,1,21,30,0.0,0.0,2021,22,3.5,inf,6,1,7,0.42857142857142855
2021-22,Playoffs,203085,146,Austin Rivers,1610612743,DEN,5,108,8,18,0.444,4,12,0.333,1,1,1.0,0,3,3,6,7,1,4,15,21,24,1.5,1.75,2021,22,4.2,1.5,10,0,10,0.3
2021-22,Playoffs,1630245,148,Ayo Dosunmu,1610612741,CHI,5,86,8,26,0.308,3,13,0.231,1,1,1.0,4,9,13,11,1,0,3,5,20,24,3.67,0.33,2021,22,4.0,3.6666666666666665,18,0,18,0.7222222222222222
2021-22,Playoffs,1627854,148,Bryn Forbes,1610612743,DEN,5,76,6,15,0.4,4,11,0.364,4,5,0.8,1,2,3,7,1,0,2,7,20,19,3.5,0.5,2021,22,4.0,3.5,9,1,10,0.3
2021-22,Playoffs,203210,148,JaMychal Green,1610612743,DEN,5,69,6,16,0.375,1,5,0.2,7,7,1.0,3,9,12,2,0,1,2,12,20,23,1.0,0.0,2021,22,4.0,1.0,10,0,10,1.2
2021-22,Playoffs,201152,148,Thaddeus Young,1610612761,TOR,6,87,9,18,0.5,1,7,0.143,1,4,0.25,7,11,18,10,5,1,3,8,20,39,3.33,1.67,2021,22,3.3333333333333335,3.3333333333333335,9,3,12,1.5
2021-22,Playoffs,1628470,148,Torrey Craig,1610612756,PHX,9,69,8,22,0.364,3,10,0.3,1,2,0.5,5,10,15,5,4,2,4,6,20,27,1.25,1.0,2021,22,2.2222222222222223,1.25,14,1,15,1.0
2021-22,Playoffs,1627884,153,Derrick Jones Jr.,1610612741,CHI,5,59,7,17,0.412,3,11,0.273,2,3,0.667,3,4,7,2,1,0,3,8,19,15,0.67,0.33,2021,22,3.8,0.6666666666666666,10,1,11,0.6363636363636364
2021-22,Playoffs,201145,153,Jeff Green,1610612743,DEN,5,113,6,17,0.353,3,8,0.375,4,5,0.8,7,11,18,2,3,2,2,6,19,30,1.0,1.5,2021,22,3.8,1.0,11,1,12,1.5
2021-22,Playoffs,203920,155,Khem Birch,1610612761,TOR,6,63,8,16,0.5,2,4,0.5,0,0,0.0,4,5,9,3,1,1,3,13,18,21,1.0,0.33,2021,22,3.0,1.0,8,0,8,1.125
2021-22,Playoffs,1630230,155,Naji Marshall,1610612740,NOP,6,56,7,10,0.7,0,0,0.0,4,4,1.0,3,3,6,5,1,1,3,5,18,25,1.67,0.33,2021,22,3.0,1.6666666666666667,3,0,3,2.0
2021-22,Playoffs,203083,157,Andre Drummond,1610612751,BKN,4,60,6,11,0.545,0,0,0.0,3,5,0.6,3,9,12,3,5,3,6,12,15,25,0.5,0.83,2021,22,3.75,0.5,5,2,7,1.7142857142857142
2021-22,Playoffs,1627823,158,Juancho Hernangomez,1610612762,UTA,6,56,5,18,0.278,4,12,0.333,0,0,0.0,2,10,12,5,2,0,2,4,14,18,2.5,1.0,2021,22,2.3333333333333335,2.5,13,0,13,0.9230769230769231
2021-22,Playoffs,1627737,158,Marquese Chriss,1610612742,DAL,8,30,4,8,0.5,1,2,0.5,5,6,0.833,4,5,9,0,0,0,1,3,14,17,0.0,0.0,2021,22,1.75,0.0,4,1,5,1.8
2021-22,Playoffs,1630688,160,Ish Wainright,1610612756,PHX,7,26,5,12,0.417,3,6,0.5,0,0,0.0,7,4,11,1,1,1,3,2,13,17,0.33,0.33,2021,22,1.8571428571428572,0.3333333333333333,7,0,7,1.5714285714285714
2021-22,Playoffs,203917,160,Nik Stauskas,1610612738,BOS,13,24,3,12,0.25,3,10,0.3,4,4,1.0,0,4,4,4,0,0,0,0,13,12,0.0,0.0,2021,22,1.0,inf,9,0,9,0.4444444444444444
2021-22,Playoffs,1630174,162,Aaron Nesmith,1610612738,BOS,15,52,4,17,0.235,1,11,0.091,3,4,0.75,4,11,15,3,2,4,1,6,12,21,3.0,2.0,2021,22,0.8,3.0,13,1,14,1.0714285714285714
2021-22,Playoffs,1628972,162,Troy Brown Jr.,1610612741,CHI,3,37,5,17,0.294,2,11,0.182,0,0,0.0,1,7,8,3,2,0,3,2,12,10,1.0,0.67,2021,22,4.0,1.0,12,0,12,0.6666666666666666
2021-22,Playoffs,2738,164,Andre Iguodala,1610612744,GSW,7,61,4,9,0.444,1,3,0.333,2,3,0.667,3,4,7,12,0,2,4,11,11,22,3.0,0.0,2021,22,1.5714285714285714,3.0,5,1,6,1.1666666666666667
2021-22,Playoffs,202355,164,Hassan Whiteside,1610612762,UTA,6,65,5,12,0.417,0,0,0.0,1,4,0.25,8,23,31,0,2,8,0,9,11,42,0.0,0.0,2021,22,1.8333333333333333,,7,3,10,3.1
2021-22,Playoffs,1629308,164,Juan Toscano-Anderson,1610612744,GSW,14,49,4,10,0.4,2,5,0.4,1,3,0.333,0,10,10,8,2,1,8,3,11,16,1.0,0.25,2021,22,0.7857142857142857,1.0,6,2,8,1.25
2021-22,Playoffs,1628425,164,Sterling Brown,1610612742,DAL,9,26,3,10,0.3,0,4,0.0,5,7,0.714,1,7,8,3,4,2,3,0,11,16,1.0,1.33,2021,22,1.2222222222222223,1.0,7,2,9,0.8888888888888888
2021-22,Playoffs,201599,168,DeAndre Jordan,1610612755,PHI,3,31,5,5,1.0,0,0,0.0,0,0,0.0,1,6,7,1,0,2,2,4,10,18,0.5,0.0,2021,22,3.3333333333333335,0.5,0,0,0,inf
2021-22,Playoffs,1628396,168,Tony Bradley,1610612741,CHI,2,8,5,5,1.0,0,0,0.0,0,0,0.0,0,4,4,1,0,0,0,0,10,15,0.0,0.0,2021,22,5.0,inf,0,0,0,inf
2021-22,Playoffs,1629312,170,Haywood Highsmith,1610612748,MIA,8,31,3,7,0.429,3,5,0.6,0,0,0.0,2,3,5,3,0,0,3,2,9,10,1.0,0.0,2021,22,1.125,1.0,4,0,4,1.25
2021-22,Playoffs,1629723,170,John Konchar,1610612763,MEM,8,56,3,11,0.273,1,6,0.167,2,2,1.0,3,16,19,5,3,1,1,7,9,28,5.0,3.0,2021,22,1.125,5.0,8,0,8,2.375
2021-22,Playoffs,201586,170,Serge Ibaka,1610612749,MIL,6,22,4,16,0.25,0,3,0.0,1,2,0.5,2,8,10,0,0,0,2,1,9,4,0.0,0.0,2021,22,1.5,0.0,12,1,13,0.7692307692307693
2021-22,Playoffs,201933,173,Blake Griffin,1610612751,BKN,2,25,2,7,0.286,2,5,0.4,2,2,1.0,2,2,4,4,1,1,1,3,8,12,4.0,1.0,2021,22,4.0,4.0,5,0,5,0.8
2021-22,Playoffs,1629672,173,Eric Paschall,1610612762,UTA,4,24,3,6,0.5,1,2,0.5,1,1,1.0,1,4,5,0,1,0,0,3,8,11,0.0,0.0,2021,22,2.0,,3,0,3,1.6666666666666667
2021-22,Playoffs,1630238,173,Malik Fitts,1610612738,BOS,9,16,3,4,0.75,2,2,1.0,0,0,0.0,0,2,2,0,0,0,0,0,8,9,0.0,0.0,2021,22,0.8888888888888888,,1,0,1,2.0
2021-22,Playoffs,1630625,176,Dalano Banton,1610612761,TOR,4,8,2,2,1.0,0,0,0.0,3,6,0.5,2,0,2,1,1,0,1,0,7,7,1.0,1.0,2021,22,1.75,1.0,0,3,3,0.6666666666666666
2021-22,Playoffs,1629633,176,Jarrett Culver,1610612763,MEM,3,22,3,10,0.3,0,2,0.0,1,2,0.5,2,5,7,1,2,0,2,4,7,7,0.5,1.0,2021,22,2.3333333333333335,0.5,7,1,8,0.875
2021-22,Playoffs,1629750,176,Javonte Green,1610612741,CHI,5,72,3,17,0.176,0,6,0.0,1,2,0.5,8,7,15,2,9,0,4,8,7,14,0.5,2.25,2021,22,1.4,0.5,14,1,15,1.0
2021-22,Playoffs,1628436,176,Luke Kornet,1610612738,BOS,9,19,3,4,0.75,1,1,1.0,0,0,0.0,1,4,5,1,0,0,1,1,7,11,1.0,0.0,2021,22,0.7777777777777778,1.0,1,0,1,5.0
2021-22,Playoffs,1630531,180,Jaden Springer,1610612755,PHI,5,13,3,6,0.5,0,1,0.0,0,0,0.0,0,4,4,2,0,0,0,1,6,9,0.0,0.0,2021,22,1.2,inf,3,0,3,1.3333333333333333
2021-22,Playoffs,1629669,180,Jaylen Nowell,1610612750,MIN,1,12,3,10,0.3,0,5,0.0,0,0,0.0,0,0,0,1,1,0,0,1,6,1,0.0,0.0,2021,22,6.0,inf,7,0,7,0.0
2021-22,Playoffs,201588,182,George Hill,1610612749,MIL,5,76,1,5,0.2,1,2,0.5,2,2,1.0,1,5,6,3,0,0,1,10,5,9,3.0,0.0,2021,22,1.0,3.0,4,0,4,1.5
2021-22,Playoffs,1630198,182,Isaiah Joe,1610612755,PHI,7,15,2,5,0.4,1,3,0.333,0,0,0.0,0,2,2,0,0,0,3,1,5,1,0.0,0.0,2021,22,0.7142857142857143,0.0,3,0,3,0.6666666666666666
2021-22,Playoffs,1630492,182,Luca Vildoza,1610612749,MIL,7,17,2,6,0.333,1,5,0.2,0,0,0.0,1,1,2,4,2,0,0,2,5,9,0.0,0.0,2021,22,0.7142857142857143,inf,4,0,4,0.5
2021-22,Playoffs,1629638,182,Nickeil Alexander-Walker,1610612762,UTA,1,5,2,2,1.0,0,0,0.0,1,1,1.0,0,1,1,1,1,0,0,0,5,8,0.0,0.0,2021,22,5.0,inf,0,0,0,inf
2021-22,Playoffs,1630573,182,Sam Hauser,1610612738,BOS,7,15,1,4,0.25,1,3,0.333,2,2,1.0,0,1,1,2,0,0,0,0,5,5,0.0,0.0,2021,22,0.7142857142857143,inf,3,0,3,0.3333333333333333
2021-22,Playoffs,203648,182,Thanasis Antetokounmpo,1610612749,MIL,8,20,2,3,0.667,0,0,0.0,1,3,0.333,1,3,4,1,1,0,0,4,5,8,0.0,0.0,2021,22,0.625,inf,1,2,3,1.3333333333333333
2021-22,Playoffs,1627789,182,Timothe Luwawu-Cabarrot,1610612737,ATL,4,22,2,4,0.5,1,3,0.333,0,0,0.0,0,3,3,2,0,0,1,6,5,7,2.0,0.0,2021,22,1.25,2.0,2,0,2,1.5
2021-22,Playoffs,1628427,182,Vlatko Cancar,1610612743,DEN,2,9,2,3,0.667,1,2,0.5,0,0,0.0,0,2,2,1,0,0,2,0,5,5,0.5,0.0,2021,22,2.5,0.5,1,0,1,2.0
2021-22,Playoffs,1626246,190,Boban Marjanovic,1610612742,DAL,3,6,1,4,0.25,0,0,0.0,2,2,1.0,0,3,3,0,1,0,2,0,4,3,0.0,0.5,2021,22,1.3333333333333333,0.0,3,0,3,1.0
2021-22,Playoffs,203991,190,Clint Capela,1610612737,ATL,2,40,2,6,0.333,0,0,0.0,0,0,0.0,4,11,15,0,1,1,1,2,4,16,0.0,1.0,2021,22,2.0,0.0,4,0,4,3.75
2021-22,Playoffs,203901,190,Elfrid Payton,1610612756,PHX,2,8,2,3,0.667,0,0,0.0,0,0,0.0,0,0,0,3,0,0,0,0,4,6,0.0,0.0,2021,22,2.0,inf,1,0,1,0.0
2021-22,Playoffs,202328,190,Greg Monroe,1610612750,MIN,2,7,2,5,0.4,0,0,0.0,0,0,0.0,1,1,2,1,2,0,1,1,4,5,1.0,2.0,2021,22,2.0,1.0,3,0,3,0.6666666666666666
2021-22,Playoffs,1629670,190,Jordan Nwora,1610612749,MIL,8,20,2,9,0.222,0,4,0.0,0,2,0.0,0,3,3,2,0,0,0,0,4,0,0.0,0.0,2021,22,0.5,inf,7,2,9,0.3333333333333333
2021-22,Playoffs,202684,190,Tristan Thompson,1610612741,CHI,5,38,2,5,0.4,0,0,0.0,0,0,0.0,2,6,8,2,1,0,5,4,4,7,0.4,0.2,2021,22,0.8,0.4,3,0,3,2.6666666666666665
2021-22,Playoffs,1629139,190,Yuta Watanabe,1610612761,TOR,4,10,2,6,0.333,0,1,0.0,0,0,0.0,0,0,0,0,0,0,1,0,4,-1,0.0,0.0,2021,22,1.0,0.0,4,0,4,0.0
2021-22,Playoffs,203476,197,Gorgui Dieng,1610612737,ATL,2,10,1,2,0.5,0,1,0.0,1,1,1.0,1,2,3,0,0,0,0,0,3,5,0.0,0.0,2021,22,1.5,,1,0,1,3.0
2021-22,Playoffs,1630192,197,Zeke Nnaji,1610612743,DEN,2,9,1,1,1.0,1,1,1.0,0,0,0.0,0,0,0,0,0,0,0,2,3,3,0.0,0.0,2021,22,1.5,,0,0,0,
2021-22,Playoffs,1629646,199,Charles Bassey,1610612755,PHI,3,12,1,2,0.5,0,0,0.0,0,1,0.0,1,4,5,1,0,1,0,1,2,7,0.0,0.0,2021,22,0.6666666666666666,inf,1,1,2,2.5
2021-22,Playoffs,1629067,199,Isaac Bonga,1610612761,TOR,1,3,0,0,0.0,0,0,0.0,2,2,1.0,0,1,1,0,0,0,0,1,2,3,0.0,0.0,2021,22,2.0,,0,0,0,inf
2021-22,Playoffs,1629730,199,Rayjon Tucker,1610612749,MIL,8,19,1,3,0.333,0,1,0.0,0,0,0.0,1,2,3,0,0,0,0,2,2,3,0.0,0.0,2021,22,0.25,,2,0,2,1.5
2021-22,Playoffs,1630219,199,Skylar Mays,1610612737,ATL,2,9,1,1,1.0,0,0,0.0,0,0,0.0,0,1,1,1,1,0,0,1,2,5,0.0,0.0,2021,22,1.0,inf,0,0,0,inf
2021-22,Playoffs,1626195,199,Willy Hernangomez,1610612740,NOP,1,2,1,4,0.25,0,1,0.0,0,0,0.0,2,0,2,0,0,0,0,1,2,1,0.0,0.0,2021,22,2.0,,3,0,3,0.6666666666666666
2021-22,Playoffs,1629752,204,Juwan Morgan,1610612738,BOS,9,15,0,1,0.0,0,1,0.0,1,2,0.5,2,1,3,0,0,0,0,1,1,2,0.0,0.0,2021,22,0.1111111111111111,,1,1,2,1.5
2021-22,Playoffs,1629004,204,Svi Mykhailiuk,1610612761,TOR,3,5,0,2,0.0,0,2,0.0,1,1,1.0,0,1,1,0,0,0,0,1,1,0,0.0,0.0,2021,22,0.3333333333333333,,2,0,2,0.5
2021-22,Playoffs,1629717,206,Armoni Brooks,1610612761,TOR,4,8,0,4,0.0,0,4,0.0,0,0,0.0,0,2,2,0,0,0,0,0,0,-2,0.0,0.0,2021,22,0.0,,4,0,4,0.5
2021-22,Playoffs,1630560,206,Cam Thomas,1610612751,BKN,1,0,0,0,0.0,0,0,0.0,0,0,0.0,0,0,0,0,0,0,0,0,0,0,0.0,0.0,2021,22,0.0,,0,0,0,
2021-22,Playoffs,1630549,206,Day'Ron Sharpe,1610612751,BKN,1,0,0,0,0.0,0,0,0.0,0,0,0.0,0,0,0,0,0,0,0,0,0,0,0.0,0.0,2021,22,0.0,,0,0,0,
2021-22,Playoffs,1630267,206,Facundo Campazzo,1610612743,DEN,4,13,0,2,0.0,0,2,0.0,0,0,0.0,0,3,3,2,0,0,2,3,0,1,1.0,0.0,2021,22,0.0,1.0,2,0,2,1.5
2021-22,Playoffs,202066,206,Garrett Temple,1610612740,NOP,1,2,0,0,0.0,0,0,0.0,0,0,0.0,0,1,1,0,0,0,0,0,0,1,0.0,0.0,2021,22,0.0,,0,0,0,inf
2021-22,Playoffs,1630552,206,Jalen Johnson,1610612737,ATL,2,9,0,3,0.0,0,1,0.0,0,0,0.0,0,0,0,0,0,0,1,0,0,-4,0.0,0.0,2021,22,0.0,0.0,3,0,3,0.0
2021-22,Playoffs,1630215,206,Jared Butler,1610612762,UTA,1,5,0,2,0.0,0,0,0.0,0,0,0.0,0,1,1,0,0,0,0,0,0,-1,0.0,0.0,2021,22,0.0,,2,0,2,0.5
2021-22,Playoffs,1629006,206,Josh Okogie,1610612750,MIN,1,2,0,0,0.0,0,0,0.0,0,0,0.0,0,0,0,0,0,0,0,0,0,0,0.0,0.0,2021,22,0.0,,0,0,0,
2021-22,Playoffs,1630556,206,Kessler Edwards,1610612751,BKN,2,7,0,0,0.0,0,0,0.0,0,0,0.0,0,0,0,1,1,0,1,3,0,1,1.0,1.0,2021,22,0.0,1.0,0,0,0,
2021-22,Playoffs,1630201,206,Malachi Flynn,1610612761,TOR,6,36,0,7,0.0,0,3,0.0,0,0,0.0,2,1,3,3,1,0,1,6,0,-1,3.0,1.0,2021,22,0.0,3.0,7,0,7,0.42857142857142855
2021-22,Playoffs,202693,206,Markieff Morris,1610612748,MIA,2,3,0,1,0.0,0,0,0.0,0,0,0.0,0,1,1,0,0,0,1,2,0,-1,0.0,0.0,2021,22,0.0,0.0,1,0,1,1.0
2021-22,Playoffs,200794,206,Paul Millsap,1610612755,PHI,1,6,0,0,0.0,0,0,0.0,0,0,0.0,0,1,1,1,0,0,0,1,0,2,0.0,0.0,2021,22,0.0,inf,0,0,0,inf
2022-23,RegularSeason,1628369,1,Jayson Tatum,1610612738,BOS,74,2732,727,1559,0.466,240,686,0.35,531,622,0.854,78,571,649,342,78,51,213,160,2225,2209,1.61,0.37,2022,23,30.06756756756757,1.6056338028169015,832,91,923,0.7031419284940412
2022-23,RegularSeason,203954,2,Joel Embiid,1610612755,PHI,66,2284,728,1328,0.548,66,200,0.33,661,771,0.857,113,557,670,274,66,112,226,205,2183,2369,1.21,0.29,2022,23,33.07575757575758,1.2123893805309736,600,110,710,0.9436619718309859
2022-23,RegularSeason,1629029,3,Luka Doncic,1610612742,DAL,66,2391,719,1449,0.496,185,541,0.342,515,694,0.742,54,515,569,529,90,33,236,166,2138,2214,2.24,0.38,2022,23,32.39393939393939,2.2415254237288136,730,179,909,0.6259625962596259
2022-23,RegularSeason,1628983,4,Shai Gilgeous-Alexander,1610612760,OKC,68,2416,704,1381,0.51,58,168,0.345,669,739,0.905,59,270,329,371,112,65,192,192,2135,2073,1.93,0.58,2022,23,31.397058823529413,1.9322916666666667,677,70,747,0.4404283801874163
2022-23,RegularSeason,203507,5,Giannis Antetokounmpo,1610612749,MIL,63,2024,707,1278,0.553,47,171,0.275,498,772,0.645,137,605,742,359,52,51,246,197,1959,2072,1.46,0.21,2022,23,31.095238095238095,1.4593495934959348,571,274,845,0.8781065088757396
2022-23,RegularSeason,1630162,6,Anthony Edwards,1610612750,MIN,79,2841,707,1541,0.459,213,578,0.369,319,422,0.756,47,411,458,350,125,58,259,186,1946,1741,1.35,0.48,2022,23,24.632911392405063,1.3513513513513513,834,103,937,0.4887940234791889
2022-23,RegularSeason,203944,7,Julius Randle,1610612752,NYK,77,2737,658,1432,0.459,218,636,0.343,402,531,0.757,141,626,767,316,49,21,216,233,1936,1970,1.46,0.23,2022,23,25.142857142857142,1.462962962962963,774,129,903,0.8493909191583611
2022-23,RegularSeason,1628378,8,Donovan Mitchell,1610612739,CLE,68,2432,679,1402,0.484,245,635,0.386,319,368,0.867,63,226,289,301,99,27,180,168,1922,1686,1.67,0.55,2022,23,28.264705882352942,1.6722222222222223,723,49,772,0.3743523316062176
2022-23,RegularSeason,1629027,9,Trae Young,1610612737,ATL,73,2541,597,1390,0.429,154,460,0.335,566,639,0.886,56,161,217,741,80,9,300,104,1914,1795,2.47,0.27,2022,23,26.21917808219178,2.47,793,73,866,0.25057736720554274
2022-23,RegularSeason,203897,10,Zach LaVine,1610612741,CHI,77,2768,673,1388,0.485,204,544,0.375,363,428,0.848,42,303,345,327,69,18,194,159,1913,1698,1.69,0.36,2022,23,24.844155844155843,1.6855670103092784,715,65,780,0.4423076923076923
2022-23,RegularSeason,203081,11,Damian Lillard,1610612757,POR,58,2107,556,1202,0.463,244,658,0.371,510,558,0.914,44,233,277,425,50,18,191,109,1866,1751,2.23,0.26,2022,23,32.172413793103445,2.225130890052356,646,48,694,0.39913544668587897
2022-23,RegularSeason,1628368,12,De'Aaron Fox,1610612758,SAC,73,2435,682,1331,0.512,119,367,0.324,343,440,0.78,40,266,306,447,83,23,181,172,1826,1758,2.47,0.46,2022,23,25.013698630136986,2.4696132596685083,649,97,746,0.4101876675603217
2022-23,RegularSeason,201942,13,DeMar DeRozan,1610612741,CHI,74,2682,657,1303,0.504,46,142,0.324,456,523,0.872,34,309,343,377,83,36,153,186,1816,1789,2.46,0.54,2022,23,24.54054054054054,2.4640522875816995,646,67,713,0.48106591865357645
2022-23,RegularSeason,1627759,14,Jaylen Brown,1610612738,BOS,67,2405,679,1383,0.491,163,487,0.335,263,344,0.765,78,381,459,232,75,26,197,172,1784,1594,1.18,0.38,2022,23,26.62686567164179,1.1776649746192893,704,81,785,0.5847133757961783
2022-23,RegularSeason,1627783,15,Pascal Siakam,1610612761,TOR,71,2652,630,1313,0.48,93,287,0.324,367,474,0.774,131,425,556,415,65,36,169,228,1720,1833,2.46,0.39,2022,23,24.225352112676056,2.455621301775148,683,107,790,0.7037974683544304
2022-23,RegularSeason,1628374,16,Lauri Markkanen,1610612762,UTA,66,2272,571,1145,0.499,200,511,0.391,349,399,0.875,130,440,570,123,42,38,127,137,1691,1713,0.97,0.33,2022,23,25.62121212121212,0.968503937007874,574,50,624,0.9134615384615384
2022-23,RegularSeason,203999,17,Nikola Jokic,1610612743,DEN,69,2323,646,1022,0.632,57,149,0.383,341,415,0.822,167,650,817,678,87,47,247,174,1690,2622,2.75,0.35,2022,23,24.492753623188406,2.7449392712550607,376,74,450,1.8155555555555556
2022-23,RegularSeason,1630224,18,Jalen Green,1610612745,HOU,76,2602,566,1359,0.416,187,554,0.338,364,463,0.786,43,241,284,281,59,18,200,131,1683,1233,1.41,0.29,2022,23,22.144736842105264,1.405,793,99,892,0.3183856502242152
2022-23,RegularSeason,1629673,19,Jordan Poole,1610612744,GSW,82,2458,550,1278,0.43,214,637,0.336,361,415,0.87,32,193,225,369,63,21,252,214,1675,1319,1.46,0.25,2022,23,20.426829268292682,1.4642857142857142,728,54,782,0.2877237851662404
2022-23,RegularSeason,1628969,20,Mikal Bridges,1610612751,BKN,83,2963,593,1267,0.468,169,442,0.382,316,353,0.895,79,285,364,273,91,61,127,159,1671,1622,2.15,0.72,2022,23,20.132530120481928,2.1496062992125986,674,37,711,0.5119549929676512
2022-23,RegularSeason,201939,21,Stephen Curry,1610612744,GSW,56,1941,559,1133,0.493,273,639,0.427,257,281,0.915,39,302,341,352,52,20,179,117,1648,1636,1.97,0.29,2022,23,29.428571428571427,1.9664804469273742,574,24,598,0.5702341137123745
2022-23,RegularSeason,1628973,22,Jalen Brunson,1610612752,NYK,68,2379,587,1195,0.491,134,322,0.416,325,392,0.829,40,201,241,421,61,15,142,152,1633,1554,2.96,0.43,2022,23,24.014705882352942,2.964788732394366,608,67,675,0.35703703703703704
2022-23,RegularSeason,202681,23,Kyrie Irving,1610612742,DAL,60,2241,594,1203,0.494,188,496,0.379,247,273,0.905,59,245,304,331,66,45,128,165,1623,1606,2.59,0.52,2022,23,27.05,2.5859375,609,26,635,0.47874015748031495
2022-23,RegularSeason,1629630,24,Ja Morant,1610612763,MEM,61,1948,566,1214,0.466,92,300,0.307,372,497,0.748,61,296,357,493,66,16,206,100,1596,1549,2.39,0.32,2022,23,26.16393442622951,2.3932038834951457,648,125,773,0.46183699870633893
2022-23,RegularSeason,2544,25,LeBron James,1610612747,LAL,55,1954,609,1219,0.5,121,377,0.321,251,327,0.768,65,392,457,375,50,32,178,88,1590,1640,2.11,0.28,2022,23,28.90909090909091,2.106741573033708,610,76,686,0.6661807580174927
2022-23,RegularSeason,203468,26,CJ McCollum,1610612740,NOP,75,2649,587,1344,0.437,211,543,0.389,183,238,0.769,55,273,328,429,70,38,183,153,1568,1438,2.34,0.38,2022,23,20.906666666666666,2.3442622950819674,757,55,812,0.4039408866995074
2022-23,RegularSeason,1628389,27,Bam Adebayo,1610612748,MIA,75,2598,602,1114,0.54,1,12,0.083,324,402,0.806,184,504,688,240,88,61,187,208,1529,1829,1.28,0.47,2022,23,20.386666666666667,1.2834224598930482,512,78,590,1.1661016949152543
2022-23,RegularSeason,1627749,28,Dejounte Murray,1610612737,ATL,74,2693,612,1319,0.464,133,387,0.344,158,190,0.832,53,336,389,448,112,19,160,106,1515,1584,2.8,0.7,2022,23,20.472972972972972,2.8,707,32,739,0.5263870094722598
2022-23,RegularSeason,1627734,29,Domantas Sabonis,1610612758,SAC,79,2736,577,938,0.615,31,83,0.373,325,438,0.742,251,722,973,573,65,39,230,279,1510,2456,2.49,0.28,2022,23,19.11392405063291,2.491304347826087,361,113,474,2.0527426160337554
2022-23,RegularSeason,202691,30,Klay Thompson,1610612744,GSW,69,2279,546,1252,0.436,301,731,0.412,116,132,0.879,39,247,286,163,49,29,123,130,1509,1191,1.32,0.4,2022,23,21.869565217391305,1.3252032520325203,706,16,722,0.3961218836565097
2022-23,RegularSeason,204001,31,Kristaps Porzingis,1610612764,WAS,65,2120,507,1018,0.498,137,356,0.385,354,416,0.851,114,432,546,174,58,100,137,196,1505,1673,1.27,0.42,2022,23,23.153846153846153,1.27007299270073,511,62,573,0.9528795811518325
2022-23,RegularSeason,1629636,32,Darius Garland,1610612739,CLE,69,2447,522,1129,0.462,169,412,0.41,277,321,0.863,28,157,185,538,85,9,199,148,1490,1457,2.7,0.43,2022,23,21.594202898550726,2.7035175879396984,607,44,651,0.28417818740399386
2022-23,RegularSeason,1630532,33,Franz Wagner,1610612753,ORL,80,2609,542,1118,0.485,130,360,0.361,271,322,0.842,70,259,329,283,77,17,167,183,1485,1397,1.7,0.46,2022,23,18.5625,1.6946107784431137,576,51,627,0.5247208931419458
2022-23,RegularSeason,1626164,34,Devin Booker,1610612756,PHX,53,1835,527,1067,0.494,111,316,0.351,306,358,0.855,46,194,240,293,51,18,145,159,1471,1336,2.02,0.35,2022,23,27.754716981132077,2.0206896551724136,540,52,592,0.40540540540540543
2022-23,RegularSeason,202710,35,Jimmy Butler,1610612748,MIA,64,2138,479,888,0.539,36,103,0.35,472,555,0.85,141,234,375,340,117,21,101,80,1466,1726,3.37,1.16,2022,23,22.90625,3.366336633663366,409,83,492,0.7621951219512195
2022-23,RegularSeason,203076,36,Anthony Davis,1610612747,LAL,56,1905,542,962,0.563,19,74,0.257,348,444,0.784,195,507,702,148,59,114,122,146,1451,1836,1.21,0.48,2022,23,25.910714285714285,1.2131147540983607,420,96,516,1.3604651162790697
2022-23,RegularSeason,202696,37,Nikola Vucevic,1610612741,CHI,82,2746,597,1148,0.52,121,347,0.349,132,158,0.835,159,744,903,265,60,57,139,179,1447,2016,1.91,0.43,2022,23,17.646341463414632,1.9064748201438848,551,26,577,1.5649913344887347
2022-23,RegularSeason,1631094,38,Paolo Banchero,1610612753,ORL,72,2430,479,1122,0.427,85,285,0.298,394,534,0.738,84,413,497,269,60,39,200,160,1437,1319,1.34,0.3,2022,23,19.958333333333332,1.345,643,140,783,0.6347381864623244
2022-23,RegularSeason,1629628,39,RJ Barrett,1610612752,NYK,73,2476,510,1176,0.434,121,390,0.31,290,392,0.74,60,308,368,201,31,15,164,179,1431,1114,1.23,0.19,2022,23,19.602739726027398,1.225609756097561,666,102,768,0.4791666666666667
2022-23,RegularSeason,1629640,40,Keldon Johnson,1610612759,SAS,63,2063,503,1113,0.452,134,407,0.329,245,327,0.749,56,262,318,183,46,11,134,125,1385,1117,1.37,0.34,2022,23,21.984126984126984,1.3656716417910448,610,82,692,0.4595375722543353
2022-23,RegularSeason,203915,41,Spencer Dinwiddie,1610612751,BKN,79,2725,460,1050,0.438,181,490,0.369,268,330,0.812,28,242,270,515,67,24,145,187,1369,1448,3.55,0.46,2022,23,17.329113924050635,3.5517241379310347,590,62,652,0.41411042944785276
2022-23,RegularSeason,201142,42,Kevin Durant,1610612756,PHX,47,1672,483,862,0.56,93,230,0.404,307,334,0.919,17,296,313,235,34,67,156,99,1366,1453,1.51,0.22,2022,23,29.06382978723404,1.5064102564102564,379,27,406,0.770935960591133
2022-23,RegularSeason,1628398,43,Kyle Kuzma,1610612764,WAS,64,2239,512,1142,0.448,160,481,0.333,173,237,0.73,55,408,463,239,36,29,190,145,1357,1240,1.26,0.19,2022,23,21.203125,1.2578947368421052,630,64,694,0.6671469740634006
2022-23,RegularSeason,1629639,44,Tyler Herro,1610612748,MIA,67,2335,487,1109,0.439,203,537,0.378,170,182,0.934,27,333,360,280,51,16,158,101,1347,1262,1.77,0.32,2022,23,20.104477611940297,1.7721518987341771,622,12,634,0.5678233438485805
2022-23,RegularSeason,1627741,45,Buddy Hield,1610612754,IND,80,2482,475,1038,0.458,288,677,0.425,106,129,0.822,67,333,400,225,92,26,139,156,1344,1362,1.62,0.66,2022,23,16.8,1.618705035971223,563,23,586,0.6825938566552902
2022-23,RegularSeason,1627832,46,Fred VanVleet,1610612761,TOR,69,2535,437,1112,0.393,207,606,0.342,254,283,0.898,30,250,280,495,123,38,140,193,1335,1427,3.54,0.88,2022,23,19.347826086956523,3.5357142857142856,675,29,704,0.3977272727272727
2022-23,RegularSeason,202331,47,Paul George,1610612746,LAC,56,1939,459,1004,0.457,158,426,0.371,256,294,0.871,45,297,342,288,83,20,176,159,1332,1306,1.64,0.47,2022,23,23.785714285714285,1.6363636363636365,545,38,583,0.5866209262435678
2022-23,RegularSeason,1626179,48,Terry Rozier,1610612766,CHA,63,2221,493,1188,0.415,165,505,0.327,178,220,0.809,51,208,259,319,74,16,134,119,1329,1126,2.38,0.55,2022,23,21.095238095238095,2.3805970149253732,695,42,737,0.3514246947082768
2022-23,RegularSeason,1629014,49,Anfernee Simons,1610612757,POR,62,2171,467,1045,0.447,212,562,0.377,160,179,0.894,18,143,161,253,42,14,128,142,1306,1051,1.98,0.33,2022,23,21.06451612903226,1.9765625,578,19,597,0.2696817420435511
2022-23,RegularSeason,1631097,50,Bennedict Mathurin,1610612754,IND,78,2222,413,951,0.434,100,310,0.323,376,454,0.828,87,231,318,116,48,13,152,162,1302,1029,0.76,0.32,2022,23,16.692307692307693,0.7631578947368421,538,78,616,0.5162337662337663
2022-23,RegularSeason,1627750,51,Jamal Murray,1610612743,DEN,65,2133,473,1041,0.454,172,432,0.398,180,216,0.833,48,209,257,400,66,16,145,103,1298,1288,2.76,0.46,2022,23,19.96923076923077,2.7586206896551726,568,36,604,0.42549668874172186
2022-23,RegularSeason,203924,52,Jerami Grant,1610612757,POR,63,2246,434,913,0.475,144,359,0.401,278,342,0.813,53,230,283,150,51,53,116,152,1290,1168,1.29,0.44,2022,23,20.476190476190474,1.293103448275862,479,64,543,0.5211786372007366
2022-23,RegularSeason,201950,52,Jrue Holiday,1610612749,MIL,67,2183,490,1023,0.479,158,411,0.384,152,177,0.859,79,262,341,495,79,25,197,116,1290,1475,2.51,0.4,2022,23,19.253731343283583,2.512690355329949,533,25,558,0.6111111111111112
2022-23,RegularSeason,1630596,54,Evan Mobley,1610612739,CLE,79,2715,525,947,0.554,22,102,0.216,205,304,0.674,187,524,711,224,60,119,146,218,1277,1724,1.53,0.41,2022,23,16.164556962025316,1.5342465753424657,422,99,521,1.36468330134357
2022-23,RegularSeason,202711,55,Bojan Bogdanovic,1610612765,DET,59,1893,430,882,0.488,145,353,0.411,268,303,0.884,36,187,223,152,34,8,135,113,1273,1068,1.13,0.25,2022,23,21.576271186440678,1.125925925925926,452,35,487,0.45790554414784396
2022-23,RegularSeason,203903,56,Jordan Clarkson,1610612762,UTA,61,1988,458,1031,0.444,155,459,0.338,200,245,0.816,72,174,246,270,33,13,186,120,1271,1029,1.45,0.18,2022,23,20.83606557377049,1.4516129032258065,573,45,618,0.39805825242718446
2022-23,RegularSeason,1626156,57,D'Angelo Russell,1610612747,LAL,71,2304,445,948,0.469,194,490,0.396,179,216,0.829,35,180,215,437,70,29,186,140,1263,1288,2.35,0.38,2022,23,17.788732394366196,2.349462365591398,503,37,540,0.39814814814814814
2022-23,RegularSeason,1630581,58,Josh Giddey,1610612760,OKC,76,2367,539,1118,0.482,76,234,0.325,106,145,0.731,148,451,599,469,57,31,211,143,1260,1587,2.22,0.27,2022,23,16.57894736842105,2.2227488151658767,579,39,618,0.9692556634304207
2022-23,RegularSeason,1630217,59,Desmond Bane,1610612763,MEM,58,1841,450,939,0.479,166,407,0.408,181,205,0.883,43,248,291,254,56,22,126,150,1247,1231,2.02,0.44,2022,23,21.5,2.015873015873016,489,24,513,0.5672514619883041
2022-23,RegularSeason,201572,60,Brook Lopez,1610612749,MIL,78,2372,477,899,0.531,136,364,0.374,149,190,0.784,157,363,520,99,37,193,107,203,1239,1518,0.93,0.35,2022,23,15.884615384615385,0.9252336448598131,422,41,463,1.123110151187905
2022-23,RegularSeason,202695,60,Kawhi Leonard,1610612746,LAC,52,1748,446,871,0.512,104,250,0.416,243,279,0.871,57,281,338,204,72,28,88,84,1239,1332,2.32,0.82,2022,23,23.826923076923077,2.3181818181818183,425,36,461,0.7331887201735358
2022-23,RegularSeason,203084,62,Harrison Barnes,1610612758,SAC,82,2662,374,791,0.473,132,353,0.374,350,413,0.847,87,279,366,128,57,10,86,103,1230,1225,1.49,0.66,2022,23,15.0,1.4883720930232558,417,63,480,0.7625
2022-23,RegularSeason,1630178,63,Tyrese Maxey,1610612755,PHI,60,2016,439,913,0.481,160,369,0.434,180,213,0.845,23,153,176,212,49,8,80,132,1218,1076,2.65,0.61,2022,23,20.3,2.65,474,33,507,0.34714003944773175
2022-23,RegularSeason,201935,64,James Harden,1610612755,PHI,58,2135,371,842,0.441,161,418,0.385,313,361,0.867,40,314,354,618,71,31,195,112,1216,1576,3.17,0.36,2022,23,20.96551724137931,3.169230769230769,471,48,519,0.6820809248554913
2022-23,RegularSeason,1630193,65,Immanuel Quickley,1610612752,NYK,81,2344,419,936,0.448,168,454,0.37,203,248,0.819,58,279,337,279,80,14,100,166,1209,1257,2.79,0.8,2022,23,14.925925925925926,2.79,517,45,562,0.599644128113879
2022-23,RegularSeason,1631093,66,Jaden Ivey,1610612765,DET,74,2304,409,983,0.416,120,350,0.343,266,356,0.747,73,215,288,387,61,17,237,242,1204,1056,1.63,0.26,2022,23,16.27027027027027,1.6329113924050633,574,90,664,0.43373493975903615
2022-23,RegularSeason,1629028,67,Deandre Ayton,1610612756,PHX,67,2035,522,887,0.589,7,24,0.292,152,200,0.76,172,495,667,115,37,53,120,190,1203,1542,0.96,0.31,2022,23,17.955223880597014,0.9583333333333334,365,48,413,1.6150121065375302
2022-23,RegularSeason,1630567,68,Scottie Barnes,1610612761,TOR,77,2678,463,1016,0.456,63,224,0.281,190,246,0.772,179,333,512,371,83,61,154,170,1179,1443,2.41,0.54,2022,23,15.311688311688311,2.409090909090909,553,56,609,0.8407224958949097
2022-23,RegularSeason,1628991,69,Jaren Jackson Jr.,1610612763,MEM,63,1788,416,822,0.506,100,282,0.355,241,306,0.788,108,318,426,60,65,189,107,227,1173,1335,0.56,0.61,2022,23,18.61904761904762,0.5607476635514018,406,65,471,0.9044585987261147
2022-23,RegularSeason,203078,70,Bradley Beal,1610612764,WAS,50,1673,444,878,0.506,80,219,0.365,192,228,0.842,41,155,196,271,45,33,145,107,1160,1090,1.87,0.31,2022,23,23.2,1.8689655172413793,434,36,470,0.41702127659574467
2022-23,RegularSeason,1630169,70,Tyrese Haliburton,1610612754,IND,56,1883,412,841,0.49,161,402,0.4,175,201,0.871,33,172,205,585,91,25,141,69,1160,1470,4.15,0.65,2022,23,20.714285714285715,4.148936170212766,429,26,455,0.45054945054945056
2022-23,RegularSeason,201566,72,Russell Westbrook,1610612746,LAC,73,2126,432,991,0.436,89,286,0.311,206,314,0.656,89,334,423,551,76,33,255,162,1159,1320,2.16,0.3,2022,23,15.876712328767123,2.16078431372549,559,108,667,0.6341829085457271
2022-23,RegularSeason,1629018,73,Gary Trent Jr.,1610612761,TOR,66,2118,405,935,0.433,166,450,0.369,172,205,0.839,30,143,173,106,104,14,55,102,1148,927,1.93,1.89,2022,23,17.393939393939394,1.9272727272727272,530,33,563,0.30728241563055064
2022-23,RegularSeason,1630530,73,Trey Murphy III,1610612740,NOP,79,2448,387,800,0.484,202,497,0.406,172,190,0.905,59,222,281,112,89,43,61,155,1148,1181,1.84,1.46,2022,23,14.531645569620252,1.8360655737704918,413,18,431,0.6519721577726219
2022-23,RegularSeason,1629023,75,P.J. Washington,1610612766,CHA,73,2380,434,978,0.444,149,428,0.348,127,174,0.73,73,285,358,175,66,79,110,193,1144,1121,1.59,0.6,2022,23,15.67123287671233,1.5909090909090908,544,47,591,0.6057529610829103
2022-23,RegularSeason,1628989,76,Kevin Huerter,1610612758,SAC,75,2203,420,866,0.485,205,510,0.402,95,131,0.725,42,209,251,221,80,24,97,181,1140,1137,2.28,0.82,2022,23,15.2,2.2783505154639174,446,36,482,0.520746887966805
2022-23,RegularSeason,1629645,77,Kevin Porter Jr.,1610612745,HOU,59,2024,391,884,0.442,141,385,0.366,207,264,0.784,76,238,314,338,82,17,188,156,1130,1143,1.8,0.44,2022,23,19.152542372881356,1.797872340425532,493,57,550,0.5709090909090909
2022-23,RegularSeason,1628384,78,OG Anunoby,1610612761,TOR,67,2386,421,885,0.476,142,367,0.387,140,167,0.838,95,237,332,131,128,50,132,200,1124,1142,0.99,0.97,2022,23,16.776119402985074,0.9924242424242424,464,27,491,0.6761710794297352
2022-23,RegularSeason,202685,79,Jonas Valanciunas,1610612740,NOP,79,1968,446,816,0.547,38,109,0.349,185,224,0.826,225,579,804,140,20,52,159,245,1115,1563,0.88,0.13,2022,23,14.113924050632912,0.8805031446540881,370,39,409,1.9657701711491442
2022-23,RegularSeason,1626174,80,Christian Wood,1610612742,DAL,67,1738,396,769,0.515,105,279,0.376,217,281,0.772,87,404,491,121,30,72,121,169,1114,1270,1.0,0.25,2022,23,16.62686567164179,1.0,373,64,437,1.1235697940503433
2022-23,RegularSeason,1626167,81,Myles Turner,1610612754,IND,62,1825,402,733,0.548,93,249,0.373,216,276,0.783,88,378,466,89,36,140,103,215,1113,1350,0.86,0.35,2022,23,17.951612903225808,0.8640776699029126,331,60,391,1.1918158567774937
2022-23,RegularSeason,1627742,82,Brandon Ingram,1610612740,NOP,45,1538,404,835,0.484,64,164,0.39,240,272,0.882,23,223,246,262,32,19,148,116,1112,1060,1.77,0.22,2022,23,24.711111111111112,1.7702702702702702,431,32,463,0.531317494600432
2022-23,RegularSeason,203932,83,Aaron Gordon,1610612743,DEN,68,2055,429,761,0.564,60,173,0.347,191,314,0.608,164,282,446,203,54,51,98,129,1109,1310,2.07,0.55,2022,23,16.308823529411764,2.0714285714285716,332,123,455,0.9802197802197802
2022-23,RegularSeason,1630578,83,Alperen Sengun,1610612745,HOU,75,2171,442,799,0.553,19,57,0.333,206,288,0.715,242,436,678,291,70,70,193,258,1109,1586,1.51,0.36,2022,23,14.786666666666667,1.5077720207253886,357,82,439,1.5444191343963554
2022-23,RegularSeason,202699,85,Tobias Harris,1610612755,PHI,74,2436,423,845,0.501,126,324,0.389,113,129,0.876,67,357,424,186,68,40,89,149,1085,1276,2.09,0.76,2022,23,14.662162162162161,2.0898876404494384,422,16,438,0.9680365296803652
2022-23,RegularSeason,1629008,86,Michael Porter Jr.,1610612743,DEN,62,1798,398,817,0.487,188,454,0.414,96,120,0.8,64,277,341,65,37,29,68,119,1080,1041,0.96,0.54,2022,23,17.419354838709676,0.9558823529411765,419,24,443,0.7697516930022573
2022-23,RegularSeason,1630180,87,Saddiq Bey,1610612737,ATL,77,2129,353,836,0.422,151,418,0.361,205,238,0.861,98,264,362,118,70,13,71,123,1062,1038,1.66,0.99,2022,23,13.792207792207792,1.6619718309859155,483,33,516,0.7015503875968992
2022-23,RegularSeason,1631114,88,Jalen Williams,1610612760,OKC,75,2276,414,794,0.521,73,205,0.356,155,191,0.812,84,253,337,248,103,35,123,191,1056,1240,2.02,0.84,2022,23,14.08,2.016260162601626,380,36,416,0.8100961538461539
2022-23,RegularSeason,1628415,89,Dillon Brooks,1610612763,MEM,73,2214,392,991,0.396,143,439,0.326,120,154,0.779,45,199,244,189,65,16,104,240,1047,824,1.82,0.63,2022,23,14.342465753424657,1.8173076923076923,599,34,633,0.3854660347551343
2022-23,RegularSeason,1628370,90,Malik Monk,1610612758,SAC,77,1719,357,796,0.448,143,398,0.359,184,207,0.889,32,171,203,298,49,20,146,125,1041,1003,2.04,0.34,2022,23,13.519480519480519,2.041095890410959,439,23,462,0.4393939393939394
2022-23,RegularSeason,1630231,91,KJ Martin,1610612745,HOU,82,2292,410,720,0.569,68,216,0.315,151,222,0.68,126,326,452,123,41,30,91,147,1039,1213,1.35,0.45,2022,23,12.670731707317072,1.3516483516483517,310,71,381,1.1863517060367454
2022-23,RegularSeason,1629631,92,De'Andre Hunter,1610612737,ATL,67,2126,379,822,0.461,100,286,0.35,171,207,0.826,46,238,284,94,35,17,82,199,1029,898,1.15,0.43,2022,23,15.35820895522388,1.146341463414634,443,36,479,0.592901878914405
2022-23,RegularSeason,1627736,93,Malik Beasley,1610612747,LAL,81,2093,370,937,0.395,235,658,0.357,50,65,0.769,35,248,283,124,65,9,90,107,1025,834,1.38,0.72,2022,23,12.654320987654321,1.3777777777777778,567,15,582,0.48625429553264604
2022-23,RegularSeason,1626181,94,Norman Powell,1610612746,LAC,60,1567,340,710,0.479,114,287,0.397,225,277,0.812,24,151,175,109,50,18,101,125,1019,848,1.08,0.49,2022,23,16.983333333333334,1.0792079207920793,370,52,422,0.4146919431279621
2022-23,RegularSeason,203501,94,Tim Hardaway Jr.,1610612742,DAL,71,2152,340,847,0.401,212,550,0.385,127,165,0.77,21,230,251,129,49,12,60,120,1019,855,2.15,0.82,2022,23,14.352112676056338,2.15,507,38,545,0.46055045871559636
2022-23,RegularSeason,1628401,96,Derrick White,1610612738,BOS,82,2319,350,758,0.462,149,391,0.381,168,192,0.875,52,241,293,321,54,76,95,177,1017,1234,3.38,0.57,2022,23,12.402439024390244,3.3789473684210525,408,24,432,0.6782407407407407
2022-23,RegularSeason,1629652,97,Luguentz Dort,1610612760,OKC,74,2272,339,873,0.388,135,409,0.33,200,259,0.772,128,216,344,154,75,23,92,243,1013,924,1.67,0.81,2022,23,13.68918918918919,1.673913043478261,534,59,593,0.5801011804384486
2022-23,RegularSeason,1631095,98,Jabari Smith Jr.,1610612745,HOU,79,2451,364,892,0.408,120,391,0.307,162,206,0.786,122,447,569,101,43,74,104,227,1010,1121,0.97,0.41,2022,23,12.784810126582279,0.9711538461538461,528,44,572,0.9947552447552448
2022-23,RegularSeason,1627763,99,Malcolm Brogdon,1610612738,BOS,67,1744,354,732,0.484,132,297,0.444,160,184,0.87,42,238,280,248,45,18,98,109,1000,1091,2.53,0.46,2022,23,14.925373134328359,2.5306122448979593,378,24,402,0.6965174129353234
2022-23,RegularSeason,1626171,100,Bobby Portis,1610612749,MIL,70,1818,398,803,0.496,95,257,0.37,96,125,0.768,154,518,672,105,29,16,81,115,987,1294,1.3,0.36,2022,23,14.1,1.2962962962962963,405,29,434,1.5483870967741935
2022-23,RegularSeason,1631099,101,Keegan Murray,1610612758,SAC,80,2382,354,782,0.453,206,501,0.411,62,81,0.765,89,282,371,98,61,42,60,162,976,1041,1.63,1.02,2022,23,12.2,1.6333333333333333,428,19,447,0.8299776286353467
2022-23,RegularSeason,1626162,102,Kelly Oubre Jr.,1610612766,CHA,48,1548,353,819,0.431,108,339,0.319,158,208,0.76,65,184,249,54,68,18,64,141,972,781,0.84,1.06,2022,23,20.25,0.84375,466,50,516,0.48255813953488375
2022-23,RegularSeason,1628386,103,Jarrett Allen,1610612739,CLE,68,2220,403,626,0.644,1,10,0.1,162,221,0.733,221,445,666,113,54,84,93,153,969,1511,1.22,0.58,2022,23,14.25,1.2150537634408602,223,59,282,2.3617021276595747
2022-23,RegularSeason,1629651,104,Nic Claxton,1610612751,BKN,76,2271,414,587,0.705,0,2,0.0,133,246,0.541,184,518,702,144,65,189,96,212,961,1679,1.5,0.68,2022,23,12.644736842105264,1.5,173,113,286,2.4545454545454546
2022-23,RegularSeason,1630183,105,Jaden McDaniels,1610612750,MIN,79,2417,370,716,0.517,107,269,0.398,106,144,0.736,92,215,307,148,74,76,112,272,953,1062,1.32,0.66,2022,23,12.063291139240507,1.3214285714285714,346,38,384,0.7994791666666666
2022-23,RegularSeason,203497,106,Rudy Gobert,1610612750,MIN,70,2148,360,546,0.659,0,3,0.0,219,340,0.644,231,583,814,87,56,95,122,210,939,1562,0.71,0.46,2022,23,13.414285714285715,0.7131147540983607,186,121,307,2.6514657980456025
2022-23,RegularSeason,1628381,107,John Collins,1610612737,ATL,71,2130,359,707,0.508,70,240,0.292,143,178,0.803,77,385,462,85,42,73,79,220,931,1131,1.08,0.53,2022,23,13.112676056338028,1.0759493670886076,348,35,383,1.206266318537859
2022-23,RegularSeason,1628971,108,Bruce Brown,1610612743,DEN,80,2279,358,741,0.483,91,254,0.358,116,153,0.758,63,265,328,268,87,51,123,190,923,1114,2.18,0.71,2022,23,11.5375,2.178861788617886,383,37,420,0.780952380952381
2022-23,RegularSeason,1629622,108,Max Strus,1610612748,MIA,80,2272,324,790,0.41,197,563,0.35,78,89,0.876,49,209,258,171,42,12,70,166,923,859,2.44,0.6,2022,23,11.5375,2.442857142857143,466,11,477,0.5408805031446541
2022-23,RegularSeason,1627747,110,Caris LeVert,1610612739,CLE,74,2237,320,742,0.431,127,324,0.392,130,180,0.722,53,229,282,287,72,24,116,170,897,974,2.47,0.62,2022,23,12.121621621621621,2.4741379310344827,422,50,472,0.597457627118644
2022-23,RegularSeason,1627751,110,Jakob Poeltl,1610612761,TOR,72,1906,389,618,0.629,0,1,0.0,119,201,0.592,236,417,653,197,66,86,125,195,897,1463,1.58,0.53,2022,23,12.458333333333334,1.576,229,82,311,2.09967845659164
2022-23,RegularSeason,1630200,112,Tre Jones,1610612759,SAS,68,1984,341,743,0.459,45,158,0.285,148,172,0.86,56,189,245,448,89,9,110,98,875,1130,4.07,0.81,2022,23,12.867647058823529,4.072727272727272,402,24,426,0.5751173708920188
2022-23,RegularSeason,1628976,113,Wendell Carter Jr.,1610612753,ORL,57,1690,322,613,0.525,80,225,0.356,144,195,0.738,120,377,497,132,30,33,106,159,868,1112,1.25,0.28,2022,23,15.228070175438596,1.2452830188679245,291,51,342,1.4532163742690059
2022-23,RegularSeason,203486,114,Mason Plumlee,1610612746,LAC,79,2053,329,484,0.68,0,0,0.0,199,313,0.636,229,471,700,245,46,47,117,217,857,1509,2.09,0.39,2022,23,10.848101265822784,2.094017094017094,155,114,269,2.6022304832713754
2022-23,RegularSeason,201569,115,Eric Gordon,1610612746,LAC,69,1966,291,653,0.446,132,356,0.371,142,173,0.821,16,118,134,183,43,25,104,78,856,744,1.76,0.41,2022,23,12.405797101449275,1.7596153846153846,362,31,393,0.34096692111959287
2022-23,RegularSeason,203482,116,Kelly Olynyk,1610612762,UTA,68,1942,278,557,0.499,93,236,0.394,198,232,0.853,82,338,420,252,60,37,168,232,847,1135,1.5,0.36,2022,23,12.455882352941176,1.5,279,34,313,1.34185303514377
2022-23,RegularSeason,1630163,117,LaMelo Ball,1610612766,CHA,36,1268,296,721,0.411,144,383,0.376,102,122,0.836,42,189,231,304,46,11,129,118,838,856,2.36,0.36,2022,23,23.27777777777778,2.356589147286822,425,20,445,0.5191011235955056
2022-23,RegularSeason,1628365,118,Markelle Fultz,1610612753,ORL,60,1778,349,679,0.514,27,87,0.31,112,143,0.783,69,165,234,341,87,26,139,131,837,1025,2.45,0.63,2022,23,13.95,2.4532374100719423,330,31,361,0.6481994459833795
2022-23,RegularSeason,1630559,119,Austin Reaves,1610612747,LAL,64,1843,259,490,0.529,86,216,0.398,229,265,0.864,33,160,193,215,33,19,99,108,833,927,2.17,0.33,2022,23,13.015625,2.1717171717171717,231,36,267,0.7228464419475655
2022-23,RegularSeason,1630172,119,Patrick Williams,1610612741,CHI,82,2323,314,677,0.464,115,277,0.415,90,105,0.857,78,249,327,100,72,70,101,147,833,923,0.99,0.71,2022,23,10.158536585365853,0.9900990099009901,363,15,378,0.8650793650793651
2022-23,RegularSeason,203471,121,Dennis Schroder,1610612747,LAL,67,1986,270,650,0.415,74,225,0.329,216,252,0.857,21,144,165,298,50,10,112,145,830,825,2.66,0.45,2022,23,12.388059701492537,2.6607142857142856,380,36,416,0.39663461538461536
2022-23,RegularSeason,1626145,122,Tyus Jones,1610612763,MEM,80,1939,311,710,0.438,121,326,0.371,80,100,0.8,28,172,200,417,83,6,74,32,823,1036,5.63,1.12,2022,23,10.2875,5.635135135135135,399,20,419,0.477326968973747
2022-23,RegularSeason,203484,123,Kentavious Caldwell-Pope,1610612743,DEN,76,2381,292,632,0.462,135,319,0.423,103,125,0.824,35,173,208,183,112,35,86,145,822,912,2.13,1.3,2022,23,10.81578947368421,2.127906976744186,340,22,362,0.574585635359116
2022-23,RegularSeason,1630557,124,Corey Kispert,1610612764,WAS,74,2093,291,585,0.497,163,384,0.424,75,88,0.852,33,174,207,87,32,9,55,97,820,793,1.58,0.58,2022,23,11.08108108108108,1.5818181818181818,294,13,307,0.6742671009771987
2022-23,RegularSeason,101108,125,Chris Paul,1610612756,PHX,59,1889,294,668,0.44,98,261,0.375,133,160,0.831,27,224,251,524,91,22,114,126,819,1192,4.6,0.8,2022,23,13.88135593220339,4.5964912280701755,374,27,401,0.6259351620947631
2022-23,RegularSeason,1627826,126,Ivica Zubac,1610612746,LAC,76,2169,326,514,0.634,0,2,0.0,166,238,0.697,236,520,756,77,29,98,117,219,818,1401,0.66,0.25,2022,23,10.763157894736842,0.6581196581196581,188,72,260,2.9076923076923076
2022-23,RegularSeason,1629656,127,Quentin Grimes,1610612752,NYK,71,2121,282,602,0.468,157,407,0.386,78,98,0.796,49,180,229,150,47,26,69,177,799,842,2.17,0.68,2022,23,11.253521126760564,2.1739130434782608,320,20,340,0.6735294117647059
2022-23,RegularSeason,201144,128,Mike Conley,1610612750,MIN,67,2028,261,610,0.428,135,351,0.385,141,169,0.834,33,149,182,450,73,14,103,139,798,1037,4.37,0.71,2022,23,11.91044776119403,4.368932038834951,349,28,377,0.4827586206896552
2022-23,RegularSeason,1630168,129,Onyeka Okongwu,1610612737,ATL,80,1849,317,497,0.638,4,13,0.308,153,196,0.781,217,359,576,81,56,107,81,251,791,1307,1.0,0.69,2022,23,9.8875,1.0,180,43,223,2.5829596412556053
2022-23,RegularSeason,1631101,130,Shaedon Sharpe,1610612757,POR,80,1779,306,648,0.472,102,283,0.36,75,105,0.714,63,173,236,94,38,24,83,136,789,726,1.13,0.46,2022,23,9.8625,1.1325301204819278,342,30,372,0.6344086021505376
2022-23,RegularSeason,1630165,131,Killian Hayes,1610612765,DET,76,2154,307,815,0.377,80,286,0.28,92,112,0.821,28,193,221,470,104,28,173,219,786,908,2.72,0.6,2022,23,10.342105263157896,2.7167630057803467,508,20,528,0.4185606060606061
2022-23,RegularSeason,1630175,132,Cole Anthony,1610612753,ORL,60,1552,277,610,0.454,75,206,0.364,152,170,0.894,47,241,288,235,37,31,91,158,781,930,2.58,0.41,2022,23,13.016666666666667,2.5824175824175826,333,18,351,0.8205128205128205
2022-23,RegularSeason,1629675,132,Naz Reid,1610612750,MIN,68,1251,310,577,0.537,75,217,0.346,86,127,0.677,73,260,333,77,42,53,92,176,781,886,0.84,0.46,2022,23,11.485294117647058,0.8369565217391305,267,41,308,1.0811688311688312
2022-23,RegularSeason,1629001,134,De'Anthony Melton,1610612755,PHI,77,2150,277,651,0.425,157,403,0.39,69,87,0.793,69,243,312,197,126,41,102,191,780,962,1.93,1.24,2022,23,10.12987012987013,1.9313725490196079,374,18,392,0.7959183673469388
2022-23,RegularSeason,203991,135,Clint Capela,1610612737,ATL,65,1730,350,536,0.653,0,1,0.0,79,131,0.603,258,459,717,58,45,79,54,139,779,1386,1.07,0.83,2022,23,11.984615384615385,1.0740740740740742,186,52,238,3.0126050420168067
2022-23,RegularSeason,1631106,136,Tari Eason,1610612745,HOU,82,1767,296,660,0.448,59,172,0.343,109,145,0.752,195,301,496,88,96,47,101,189,760,986,0.87,0.95,2022,23,9.268292682926829,0.8712871287128713,364,36,400,1.24
2022-23,RegularSeason,203992,137,Bogdan Bogdanovic,1610612737,ATL,54,1509,273,611,0.447,146,360,0.406,64,77,0.831,23,142,165,150,43,18,65,86,756,716,2.31,0.66,2022,23,14.0,2.3076923076923075,338,13,351,0.4700854700854701
2022-23,RegularSeason,1629667,138,Jalen McDaniels,1610612755,PHI,80,1913,281,617,0.455,77,232,0.332,116,138,0.841,63,283,346,130,83,34,93,209,755,897,1.4,0.89,2022,23,9.4375,1.3978494623655915,336,22,358,0.9664804469273743
2022-23,RegularSeason,1629627,139,Zion Williamson,1610612740,NOP,29,956,285,469,0.608,7,19,0.368,177,248,0.714,58,144,202,133,32,16,99,65,754,783,1.34,0.32,2022,23,26.0,1.3434343434343434,184,71,255,0.792156862745098
2022-23,RegularSeason,1628960,140,Grayson Allen,1610612749,MIL,72,1972,245,557,0.44,146,366,0.399,114,126,0.905,61,176,237,163,62,14,72,117,750,830,2.26,0.86,2022,23,10.416666666666666,2.263888888888889,312,12,324,0.7314814814814815
2022-23,RegularSeason,1628404,141,Josh Hart,1610612752,NYK,76,2454,275,520,0.529,61,164,0.372,132,176,0.75,142,451,593,290,88,21,117,195,743,1329,2.48,0.75,2022,23,9.776315789473685,2.4786324786324787,245,44,289,2.0519031141868513
2022-23,RegularSeason,1630174,142,Aaron Nesmith,1610612754,IND,73,1816,252,590,0.427,115,314,0.366,119,142,0.838,62,215,277,98,55,34,75,235,738,766,1.31,0.73,2022,23,10.10958904109589,1.3066666666666666,338,23,361,0.7673130193905817
2022-23,RegularSeason,202330,143,Gordon Hayward,1610612766,CHA,50,1577,276,581,0.475,52,160,0.325,129,159,0.811,33,182,215,206,42,12,99,70,733,774,2.08,0.42,2022,23,14.66,2.080808080808081,305,30,335,0.6417910447761194
2022-23,RegularSeason,1628380,144,Zach Collins,1610612759,SAS,63,1441,284,548,0.518,55,147,0.374,108,142,0.761,116,286,402,180,37,49,129,199,731,972,1.4,0.29,2022,23,11.603174603174603,1.3953488372093024,264,34,298,1.348993288590604
2022-23,RegularSeason,202694,145,Marcus Morris Sr.,1610612746,LAC,65,1825,274,643,0.426,112,308,0.364,68,87,0.782,29,229,258,114,42,21,56,136,728,719,2.04,0.75,2022,23,11.2,2.0357142857142856,369,19,388,0.6649484536082474
2022-23,RegularSeason,1629632,146,Coby White,1610612741,CHI,74,1730,263,594,0.443,128,344,0.372,61,70,0.871,16,196,212,204,54,6,74,122,715,777,2.76,0.73,2022,23,9.662162162162161,2.7567567567567566,331,9,340,0.6235294117647059
2022-23,RegularSeason,1629611,147,Terance Mann,1610612746,LAC,81,1872,272,524,0.519,77,198,0.389,92,118,0.78,77,199,276,184,42,22,80,149,713,879,2.3,0.53,2022,23,8.802469135802468,2.3,252,26,278,0.9928057553956835
2022-23,RegularSeason,1628449,148,Chris Boucher,1610612761,TOR,76,1523,261,529,0.493,62,189,0.328,128,168,0.762,157,264,421,29,47,64,41,143,712,924,0.71,1.15,2022,23,9.368421052631579,0.7073170731707317,268,40,308,1.3668831168831168
2022-23,RegularSeason,1629614,149,Andrew Nembhard,1610612754,IND,75,2074,284,644,0.441,92,263,0.35,49,62,0.79,35,164,199,341,70,13,126,179,709,833,2.71,0.56,2022,23,9.453333333333333,2.7063492063492065,360,13,373,0.5335120643431636
2022-23,RegularSeason,1629060,150,Rui Hachimura,1610612747,LAL,63,1466,284,584,0.486,51,160,0.319,88,119,0.739,53,230,283,58,19,26,53,72,707,709,1.09,0.36,2022,23,11.222222222222221,1.0943396226415094,300,31,331,0.8549848942598187
2022-23,RegularSeason,1629655,151,Daniel Gafford,1610612764,WAS,78,1604,289,395,0.732,0,0,0.0,127,187,0.679,163,270,433,84,33,99,85,187,705,1103,0.99,0.39,2022,23,9.038461538461538,0.9882352941176471,106,60,166,2.608433734939759
2022-23,RegularSeason,1629669,152,Jaylen Nowell,1610612750,MIN,65,1252,280,625,0.448,67,232,0.289,77,99,0.778,36,134,170,132,42,5,65,101,704,621,2.03,0.65,2022,23,10.830769230769231,2.0307692307692307,345,22,367,0.46321525885558584
2022-23,RegularSeason,1630170,153,Devin Vassell,1610612759,SAS,38,1178,261,595,0.439,103,266,0.387,78,100,0.78,8,140,148,136,43,17,57,57,703,634,2.39,0.75,2022,23,18.5,2.3859649122807016,334,22,356,0.4157303370786517
2022-23,RegularSeason,203935,153,Marcus Smart,1610612738,BOS,61,1957,250,602,0.415,115,342,0.336,88,118,0.746,46,145,191,382,93,23,143,172,703,867,2.67,0.65,2022,23,11.524590163934427,2.6713286713286712,352,30,382,0.5
2022-23,RegularSeason,1630230,155,Naji Marshall,1610612740,NOP,77,1792,247,571,0.433,66,218,0.303,138,175,0.789,48,231,279,189,54,14,97,113,698,776,1.95,0.56,2022,23,9.064935064935066,1.9484536082474226,324,37,361,0.7728531855955678
2022-23,RegularSeason,1629659,155,Talen Horton-Tucker,1610612762,UTA,65,1313,257,613,0.419,58,203,0.286,126,168,0.75,41,169,210,246,41,29,126,108,698,700,1.95,0.33,2022,23,10.738461538461538,1.9523809523809523,356,42,398,0.5276381909547738
2022-23,RegularSeason,1630166,157,Deni Avdija,1610612764,WAS,76,2020,253,579,0.437,69,232,0.297,122,165,0.739,74,413,487,211,65,29,123,209,697,997,1.72,0.53,2022,23,9.171052631578947,1.7154471544715446,326,43,369,1.3197831978319783
2022-23,RegularSeason,1630583,158,Santi Aldama,1610612763,MEM,77,1682,247,525,0.47,94,266,0.353,108,144,0.75,85,286,371,97,45,48,60,143,696,883,1.62,0.75,2022,23,9.03896103896104,1.6166666666666667,278,36,314,1.1815286624203822
2022-23,RegularSeason,203994,159,Jusuf Nurkic,1610612757,POR,52,1391,262,505,0.519,43,119,0.361,127,192,0.661,114,357,471,149,43,44,119,185,694,974,1.25,0.36,2022,23,13.346153846153847,1.2521008403361344,243,65,308,1.5292207792207793
2022-23,RegularSeason,202704,160,Reggie Jackson,1610612743,DEN,68,1657,263,640,0.411,96,288,0.333,71,78,0.91,25,119,144,233,47,6,115,114,693,624,2.03,0.41,2022,23,10.191176470588236,2.026086956521739,377,7,384,0.375
2022-23,RegularSeason,1630198,161,Isaiah Joe,1610612760,OKC,73,1395,224,508,0.441,161,394,0.409,82,100,0.82,27,148,175,88,48,8,39,105,691,669,2.26,1.23,2022,23,9.465753424657533,2.2564102564102564,284,18,302,0.5794701986754967
2022-23,RegularSeason,1630245,162,Ayo Dosunmu,1610612741,CHI,80,2098,281,570,0.493,59,189,0.312,66,82,0.805,45,175,220,206,62,26,99,182,687,797,2.08,0.63,2022,23,8.5875,2.080808080808081,289,16,305,0.7213114754098361
2022-23,RegularSeason,1629012,163,Collin Sexton,1610612762,UTA,48,1145,237,468,0.506,48,122,0.393,163,199,0.819,37,68,105,138,27,6,85,112,685,609,1.62,0.32,2022,23,14.270833333333334,1.6235294117647059,231,36,267,0.39325842696629215
2022-23,RegularSeason,1628997,164,Caleb Martin,1610612748,MIA,71,2078,254,548,0.464,84,236,0.356,91,113,0.805,88,256,344,117,71,31,78,145,683,852,1.5,0.91,2022,23,9.619718309859154,1.5,294,22,316,1.0886075949367089
2022-23,RegularSeason,1631117,165,Walker Kessler,1610612762,UTA,74,1703,298,414,0.72,1,3,0.333,82,159,0.516,231,389,620,69,26,173,58,169,679,1316,1.19,0.45,2022,23,9.175675675675675,1.1896551724137931,116,77,193,3.2124352331606216
2022-23,RegularSeason,1628978,166,Donte DiVincenzo,1610612744,GSW,72,1894,235,540,0.435,150,378,0.397,58,71,0.817,80,245,325,252,97,10,112,133,678,932,2.25,0.87,2022,23,9.416666666666666,2.25,305,13,318,1.0220125786163523
2022-23,RegularSeason,1631103,167,Malaki Branham,1610612759,SAS,66,1550,269,611,0.44,77,255,0.302,58,70,0.829,28,153,181,127,33,7,76,115,673,591,1.67,0.43,2022,23,10.196969696969697,1.6710526315789473,342,12,354,0.5112994350282486
2022-23,RegularSeason,1626220,168,Royce O'Neale,1610612751,BKN,76,2409,229,593,0.386,163,419,0.389,50,69,0.725,55,329,384,283,65,49,114,239,671,955,2.48,0.57,2022,23,8.828947368421053,2.482456140350877,364,19,383,1.0026109660574412
2022-23,RegularSeason,1626224,169,Cedi Osman,1610612739,CLE,77,1548,239,530,0.451,116,312,0.372,75,108,0.694,25,151,176,115,35,11,52,122,669,630,2.21,0.67,2022,23,8.688311688311689,2.2115384615384617,291,33,324,0.5432098765432098
2022-23,RegularSeason,1630228,170,Jonathan Kuminga,1610612744,GSW,67,1394,261,497,0.525,54,146,0.37,90,138,0.652,70,161,231,125,41,31,95,157,666,715,1.32,0.43,2022,23,9.940298507462687,1.3157894736842106,236,48,284,0.8133802816901409
2022-23,RegularSeason,1630538,171,Bones Hyland,1610612746,LAC,56,1086,228,571,0.399,117,315,0.371,86,102,0.843,20,115,135,172,39,15,82,96,659,579,2.1,0.48,2022,23,11.767857142857142,2.097560975609756,343,16,359,0.37604456824512533
2022-23,RegularSeason,203926,172,Doug McDermott,1610612759,SAS,64,1314,239,523,0.457,123,298,0.413,53,70,0.757,23,115,138,91,13,6,58,118,654,543,1.57,0.22,2022,23,10.21875,1.5689655172413792,284,17,301,0.4584717607973422
2022-23,RegularSeason,1626196,172,Josh Richardson,1610612740,NOP,65,1530,239,554,0.431,107,293,0.365,69,81,0.852,41,134,175,174,69,20,86,117,654,679,2.02,0.8,2022,23,10.061538461538461,2.0232558139534884,315,12,327,0.5351681957186545
2022-23,RegularSeason,1629022,172,Lonnie Walker IV,1610612747,LAL,56,1297,236,527,0.448,91,249,0.365,91,106,0.858,14,95,109,64,30,17,46,71,654,522,1.39,0.65,2022,23,11.678571428571429,1.391304347826087,291,15,306,0.3562091503267974
2022-23,RegularSeason,202692,175,Alec Burks,1610612765,DET,51,1122,200,459,0.436,99,239,0.414,153,188,0.814,19,139,158,114,38,8,58,98,652,618,1.97,0.66,2022,23,12.784313725490197,1.9655172413793103,259,35,294,0.5374149659863946
2022-23,RegularSeason,1628975,176,Jevon Carter,1610612749,MIL,81,1812,239,565,0.423,142,337,0.421,31,38,0.816,35,167,202,197,66,29,78,158,651,734,2.53,0.85,2022,23,8.037037037037036,2.5256410256410255,326,7,333,0.6066066066066066
2022-23,RegularSeason,1629661,177,Cameron Johnson,1610612751,BKN,42,1200,223,474,0.47,103,255,0.404,101,120,0.842,34,151,185,78,50,14,37,83,650,670,2.11,1.35,2022,23,15.476190476190476,2.108108108108108,251,19,270,0.6851851851851852
2022-23,RegularSeason,204456,177,T.J. McConnell,1610612754,IND,75,1526,283,521,0.543,26,59,0.441,58,68,0.853,45,189,234,397,81,10,143,105,650,981,2.78,0.57,2022,23,8.666666666666666,2.7762237762237763,238,10,248,0.9435483870967742
2022-23,RegularSeason,1630529,179,Herbert Jones,1610612740,NOP,66,1951,235,501,0.469,56,167,0.335,123,161,0.764,97,172,269,162,103,42,88,208,649,833,1.84,1.17,2022,23,9.833333333333334,1.8409090909090908,266,38,304,0.8848684210526315
2022-23,RegularSeason,1628966,180,Keita Bates-Diop,1610612759,SAS,67,1453,236,465,0.508,56,142,0.394,119,150,0.793,65,183,248,103,46,20,56,63,647,748,1.84,0.82,2022,23,9.656716417910447,1.8392857142857142,229,31,260,0.9538461538461539
2022-23,RegularSeason,203937,180,Kyle Anderson,1610612750,MIN,69,1957,252,495,0.509,43,105,0.41,100,136,0.735,66,302,368,335,78,63,103,146,647,1109,3.25,0.76,2022,23,9.376811594202898,3.2524271844660193,243,36,279,1.3189964157706093
2022-23,RegularSeason,1630188,182,Jalen Smith,1610612754,IND,68,1279,242,508,0.476,54,191,0.283,104,137,0.759,129,265,394,66,21,60,72,153,642,812,0.92,0.29,2022,23,9.441176470588236,0.9166666666666666,266,33,299,1.3177257525083612
2022-23,RegularSeason,1629216,183,Gabe Vincent,1610612748,MIA,68,1759,228,567,0.402,117,350,0.334,68,78,0.872,27,118,145,167,62,5,92,154,641,579,1.81,0.67,2022,23,9.426470588235293,1.815217391304348,339,10,349,0.4154727793696275
2022-23,RegularSeason,1629684,183,Grant Williams,1610612738,BOS,79,2045,216,476,0.454,115,291,0.395,94,122,0.77,87,276,363,131,41,31,82,192,641,837,1.6,0.5,2022,23,8.113924050632912,1.5975609756097562,260,28,288,1.2604166666666667
2022-23,RegularSeason,1631100,185,AJ Griffin,1610612737,ATL,72,1401,248,533,0.465,101,259,0.39,42,47,0.894,37,116,153,73,42,12,42,87,639,587,1.74,1.0,2022,23,8.875,1.7380952380952381,285,5,290,0.5275862068965518
2022-23,RegularSeason,1627777,186,Georges Niang,1610612755,PHI,78,1512,222,502,0.442,154,384,0.401,39,45,0.867,19,166,185,77,30,14,54,145,637,603,1.43,0.56,2022,23,8.166666666666666,1.4259259259259258,280,6,286,0.6468531468531469
2022-23,RegularSeason,1629003,186,Shake Milton,1610612755,PHI,76,1567,241,503,0.479,56,148,0.378,99,116,0.853,39,152,191,240,25,13,94,123,637,733,2.55,0.27,2022,23,8.381578947368421,2.5531914893617023,262,17,279,0.6845878136200717
2022-23,RegularSeason,1628420,188,Monte Morris,1610612764,WAS,62,1696,247,515,0.48,78,204,0.382,64,77,0.831,26,184,210,326,43,13,60,75,636,887,5.43,0.72,2022,23,10.258064516129032,5.433333333333334,268,13,281,0.7473309608540926
2022-23,RegularSeason,1629626,189,Bol Bol,1610612753,ORL,70,1505,261,478,0.546,30,113,0.265,82,108,0.759,69,336,405,69,30,85,112,92,634,868,0.62,0.27,2022,23,9.057142857142857,0.6160714285714286,217,26,243,1.6666666666666667
2022-23,RegularSeason,203952,190,Andrew Wiggins,1610612744,GSW,37,1190,250,529,0.473,89,225,0.396,44,72,0.611,61,125,186,85,45,28,48,107,633,622,1.77,0.94,2022,23,17.10810810810811,1.7708333333333333,279,28,307,0.6058631921824105
2022-23,RegularSeason,1629020,191,Jarred Vanderbilt,1610612747,LAL,78,1880,247,451,0.548,29,90,0.322,96,139,0.691,170,412,582,184,83,21,97,190,619,1145,1.9,0.86,2022,23,7.935897435897436,1.8969072164948453,204,43,247,2.3562753036437245
2022-23,RegularSeason,203110,192,Draymond Green,1610612744,GSW,73,2298,250,474,0.527,40,131,0.305,77,108,0.713,66,459,525,500,74,60,204,229,617,1317,2.45,0.36,2022,23,8.452054794520548,2.450980392156863,224,31,255,2.0588235294117645
2022-23,RegularSeason,201143,193,Al Horford,1610612738,BOS,63,1921,228,479,0.476,145,325,0.446,15,21,0.714,73,317,390,189,30,61,37,121,616,992,5.11,0.81,2022,23,9.777777777777779,5.108108108108108,251,6,257,1.517509727626459
2022-23,RegularSeason,200768,194,Kyle Lowry,1610612748,MIA,55,1718,196,485,0.404,107,310,0.345,116,135,0.859,43,182,225,281,57,21,103,143,615,788,2.73,0.55,2022,23,11.181818181818182,2.7281553398058254,289,19,308,0.7305194805194806
2022-23,RegularSeason,1631110,195,Jeremy Sochan,1610612759,SAS,56,1458,250,552,0.453,33,134,0.246,81,116,0.698,95,200,295,142,43,23,97,138,614,683,1.46,0.44,2022,23,10.964285714285714,1.4639175257731958,302,35,337,0.8753709198813057
2022-23,RegularSeason,1631105,196,Jalen Duren,1610612765,DET,67,1670,258,398,0.648,0,2,0.0,96,157,0.611,229,366,595,75,44,59,92,182,612,1092,0.81,0.48,2022,23,9.134328358208956,0.8152173913043478,140,61,201,2.9601990049751246
2022-23,RegularSeason,1630560,197,Cam Thomas,1610612751,BKN,57,948,201,456,0.441,51,133,0.383,151,174,0.868,8,87,95,78,20,7,63,55,604,463,1.24,0.32,2022,23,10.596491228070175,1.2380952380952381,255,23,278,0.34172661870503596
2022-23,RegularSeason,1627814,197,Damion Lee,1610612756,PHX,74,1506,200,452,0.442,110,247,0.445,94,104,0.904,39,186,225,99,30,7,78,118,604,625,1.27,0.39,2022,23,8.162162162162161,1.2692307692307692,252,10,262,0.8587786259541985
2022-23,RegularSeason,1626157,199,Karl-Anthony Towns,1610612750,MIN,29,957,212,428,0.495,60,164,0.366,118,135,0.874,48,188,236,140,20,17,86,111,602,696,1.63,0.23,2022,23,20.75862068965517,1.627906976744186,216,17,233,1.0128755364806867
2022-23,RegularSeason,1629021,200,Moritz Wagner,1610612753,ORL,57,1109,198,396,0.5,51,163,0.313,153,182,0.841,69,190,259,84,37,13,68,136,600,698,1.24,0.54,2022,23,10.526315789473685,1.2352941176470589,198,29,227,1.1409691629955947
2022-23,RegularSeason,1628470,201,Torrey Craig,1610612756,PHX,79,1948,228,500,0.456,100,253,0.395,32,45,0.711,145,281,426,117,50,62,73,179,588,885,1.6,0.69,2022,23,7.443037974683544,1.6027397260273972,272,13,285,1.4947368421052631
2022-23,RegularSeason,1628418,202,Thomas Bryant,1610612743,DEN,59,1082,230,369,0.623,26,59,0.441,93,126,0.738,86,253,339,31,16,30,38,102,579,785,0.82,0.42,2022,23,9.813559322033898,0.8157894736842105,139,33,172,1.9709302325581395
2022-23,RegularSeason,1626172,203,Kevon Looney,1610612744,GSW,82,1958,242,384,0.63,0,1,0.0,94,155,0.606,274,486,760,207,52,50,45,225,578,1399,4.6,1.16,2022,23,7.048780487804878,4.6,142,61,203,3.7438423645320196
2022-23,RegularSeason,1630191,204,Isaiah Stewart,1610612765,DET,50,1414,195,441,0.442,67,205,0.327,110,149,0.738,115,288,403,70,20,34,68,133,567,741,1.03,0.29,2022,23,11.34,1.0294117647058822,246,39,285,1.4140350877192982
2022-23,RegularSeason,203925,205,Joe Harris,1610612751,BKN,74,1527,201,440,0.457,142,333,0.426,18,28,0.643,23,141,164,101,34,13,41,140,562,584,2.46,0.83,2022,23,7.594594594594595,2.4634146341463414,239,10,249,0.6586345381526104
2022-23,RegularSeason,1626168,205,Trey Lyles,1610612758,SAC,74,1247,187,408,0.458,87,240,0.363,101,124,0.815,68,232,300,66,27,31,64,97,562,678,1.03,0.42,2022,23,7.594594594594595,1.03125,221,23,244,1.2295081967213115
2022-23,RegularSeason,203493,207,Reggie Bullock Jr.,1610612742,DAL,78,2365,192,470,0.409,151,397,0.38,26,37,0.703,32,251,283,108,54,13,36,166,561,694,3.0,1.5,2022,23,7.1923076923076925,3.0,278,11,289,0.9792387543252595
2022-23,RegularSeason,203552,207,Seth Curry,1610612751,BKN,61,1211,208,449,0.463,94,232,0.405,51,55,0.927,13,87,100,99,36,7,51,96,561,507,1.94,0.71,2022,23,9.19672131147541,1.9411764705882353,241,4,245,0.40816326530612246
2022-23,RegularSeason,1629634,209,Brandon Clarke,1610612763,MEM,56,1090,229,349,0.656,1,6,0.167,99,137,0.723,92,218,310,72,34,37,55,131,558,798,1.31,0.62,2022,23,9.964285714285714,1.309090909090909,120,38,158,1.9620253164556962
2022-23,RegularSeason,1627827,210,Dorian Finney-Smith,1610612751,BKN,66,2009,196,501,0.391,114,338,0.337,45,59,0.763,114,202,316,100,55,36,62,144,551,677,1.61,0.89,2022,23,8.348484848484848,1.6129032258064515,305,14,319,0.9905956112852664
2022-23,RegularSeason,1630631,211,Jose Alvarado,1610612740,NOP,61,1310,201,489,0.411,83,247,0.336,65,80,0.813,28,113,141,186,67,10,81,125,550,570,2.3,0.83,2022,23,9.01639344262295,2.2962962962962963,288,15,303,0.46534653465346537
2022-23,RegularSeason,1630182,212,Josh Green,1610612742,DAL,60,1539,205,382,0.537,68,169,0.402,68,94,0.723,55,127,182,103,42,5,72,156,546,603,1.43,0.58,2022,23,9.1,1.4305555555555556,177,26,203,0.896551724137931
2022-23,RegularSeason,1628379,212,Luke Kennard,1610612763,MEM,59,1315,188,382,0.492,133,269,0.494,37,39,0.949,15,143,158,91,32,5,46,82,546,590,1.98,0.7,2022,23,9.254237288135593,1.9782608695652173,194,2,196,0.8061224489795918
2022-23,RegularSeason,1629670,214,Jordan Nwora,1610612754,IND,62,1188,194,445,0.436,86,211,0.408,68,86,0.791,51,178,229,88,24,14,66,74,542,562,1.33,0.36,2022,23,8.741935483870968,1.3333333333333333,251,18,269,0.8513011152416357
2022-23,RegularSeason,1628972,215,Troy Brown Jr.,1610612747,LAL,76,1860,200,465,0.43,107,281,0.381,34,39,0.872,62,246,308,95,59,16,49,120,541,700,1.94,1.2,2022,23,7.118421052631579,1.9387755102040816,265,5,270,1.1407407407407408
2022-23,RegularSeason,1628984,216,Devonte' Graham,1610612759,SAS,73,1338,161,431,0.374,119,338,0.352,98,131,0.748,19,103,122,196,45,16,53,79,539,562,3.7,0.85,2022,23,7.383561643835616,3.69811320754717,270,33,303,0.40264026402640263
2022-23,RegularSeason,1630208,217,Nick Richards,1610612766,CHA,65,1218,197,313,0.629,1,1,1.0,137,183,0.749,147,269,416,38,11,71,59,154,532,847,0.64,0.19,2022,23,8.184615384615384,0.6440677966101694,116,46,162,2.567901234567901
2022-23,RegularSeason,1629006,218,Josh Okogie,1610612756,PHX,72,1351,162,414,0.391,66,197,0.335,139,192,0.724,109,142,251,105,56,34,63,114,529,607,1.67,0.89,2022,23,7.347222222222222,1.6666666666666667,252,53,305,0.8229508196721311
2022-23,RegularSeason,1630591,219,Jalen Suggs,1610612753,ORL,53,1246,186,444,0.419,66,202,0.327,86,119,0.723,55,106,161,155,67,27,94,120,524,549,1.65,0.71,2022,23,9.88679245283019,1.648936170212766,258,33,291,0.5532646048109966
2022-23,RegularSeason,1628977,220,Hamidou Diallo,1610612765,DET,56,996,215,375,0.573,5,21,0.238,87,148,0.588,57,137,194,55,53,16,71,124,522,548,0.78,0.75,2022,23,9.321428571428571,0.7746478873239436,160,61,221,0.8778280542986425
2022-23,RegularSeason,203082,220,Terrence Ross,1610612756,PHX,63,1331,200,465,0.43,95,258,0.368,27,34,0.794,22,132,154,95,35,10,43,97,522,501,2.21,0.81,2022,23,8.285714285714286,2.2093023255813953,265,7,272,0.5661764705882353
2022-23,RegularSeason,1629234,222,Drew Eubanks,1610612757,POR,78,1584,214,334,0.641,7,18,0.389,83,125,0.664,132,286,418,103,40,102,67,169,518,952,1.54,0.6,2022,23,6.641025641025641,1.537313432835821,120,42,162,2.580246913580247
2022-23,RegularSeason,1630544,223,Tre Mann,1610612760,OKC,67,1183,197,501,0.393,81,257,0.315,42,55,0.764,27,128,155,120,40,11,62,99,517,464,1.94,0.65,2022,23,7.7164179104477615,1.935483870967742,304,13,317,0.4889589905362776
2022-23,RegularSeason,1630573,224,Sam Hauser,1610612738,BOS,80,1290,180,396,0.455,140,335,0.418,12,17,0.706,35,169,204,71,29,21,30,99,512,586,2.37,0.97,2022,23,6.4,2.3666666666666667,216,5,221,0.9230769230769231
2022-23,RegularSeason,201567,225,Kevin Love,1610612748,MIA,62,1239,165,424,0.389,99,296,0.334,80,91,0.879,59,340,399,116,16,12,70,97,509,712,1.66,0.23,2022,23,8.209677419354838,1.6571428571428573,259,11,270,1.4777777777777779
2022-23,RegularSeason,1630173,226,Precious Achiuwa,1610612761,TOR,55,1141,196,404,0.485,29,108,0.269,87,124,0.702,100,228,328,50,31,30,59,102,508,643,0.85,0.53,2022,23,9.236363636363636,0.847457627118644,208,37,245,1.3387755102040817
2022-23,RegularSeason,203939,227,Dwight Powell,1610612742,DAL,76,1458,197,269,0.732,0,5,0.0,112,168,0.667,149,165,314,69,48,26,65,209,506,770,1.06,0.74,2022,23,6.657894736842105,1.0615384615384615,72,56,128,2.453125
2022-23,RegularSeason,1628963,228,Marvin Bagley III,1610612765,DET,42,990,202,382,0.529,19,66,0.288,81,108,0.75,94,175,269,36,19,30,46,81,504,605,0.78,0.41,2022,23,12.0,0.782608695652174,180,27,207,1.2995169082125604
2022-23,RegularSeason,203114,229,Khris Middleton,1610612749,MIL,33,801,177,406,0.436,51,162,0.315,92,102,0.902,28,112,140,163,23,5,71,68,497,518,2.3,0.32,2022,23,15.06060606060606,2.295774647887324,229,10,239,0.5857740585774058
2022-23,RegularSeason,1630167,229,Obi Toppin,1610612752,NYK,67,1051,187,419,0.446,85,247,0.344,38,47,0.809,29,158,187,66,23,12,38,68,497,506,1.74,0.6,2022,23,7.417910447761194,1.736842105263158,232,9,241,0.7759336099585062
2022-23,RegularSeason,1629134,231,Kendrick Nunn,1610612764,WAS,70,963,191,450,0.424,79,223,0.354,35,41,0.854,15,94,109,90,28,7,66,66,496,399,1.36,0.42,2022,23,7.085714285714285,1.3636363636363635,259,6,265,0.41132075471698115
2022-23,RegularSeason,1626166,232,Cameron Payne,1610612756,PHX,48,968,188,453,0.415,68,185,0.368,49,64,0.766,12,94,106,214,33,8,81,88,493,493,2.64,0.41,2022,23,10.270833333333334,2.6419753086419755,265,15,280,0.37857142857142856
2022-23,RegularSeason,1627752,232,Taurean Prince,1610612750,MIN,54,1193,177,379,0.467,74,194,0.381,65,77,0.844,15,117,132,84,28,15,69,123,493,469,1.22,0.41,2022,23,9.12962962962963,1.2173913043478262,202,12,214,0.616822429906542
2022-23,RegularSeason,1630171,234,Isaac Okoro,1610612739,CLE,76,1653,175,354,0.494,62,171,0.363,78,103,0.757,52,135,187,87,56,30,42,158,490,604,2.07,1.33,2022,23,6.447368421052632,2.0714285714285716,179,25,204,0.9166666666666666
2022-23,RegularSeason,1630598,235,Aaron Wiggins,1610612760,OKC,70,1297,186,363,0.512,48,122,0.393,59,71,0.831,68,142,210,80,39,15,55,110,479,579,1.46,0.71,2022,23,6.8428571428571425,1.4545454545454546,177,12,189,1.1111111111111112
2022-23,RegularSeason,201587,236,Nicolas Batum,1610612746,LAC,78,1710,160,381,0.42,124,317,0.391,34,48,0.708,62,237,299,121,54,44,50,149,478,711,2.42,1.08,2022,23,6.128205128205129,2.42,221,14,235,1.2723404255319148
2022-23,RegularSeason,1628372,237,Dennis Smith Jr.,1610612766,CHA,54,1390,186,452,0.412,24,111,0.216,78,106,0.736,27,140,167,261,75,25,82,122,474,626,3.18,0.92,2022,23,8.777777777777779,3.182926829268293,266,28,294,0.5680272108843537
2022-23,RegularSeason,1630534,238,Ochai Agbaji,1610612762,UTA,59,1209,165,386,0.427,81,228,0.355,56,69,0.812,43,78,121,67,16,15,41,99,467,411,1.63,0.39,2022,23,7.915254237288136,1.6341463414634145,221,13,234,0.5170940170940171
2022-23,RegularSeason,1631223,239,David Roddy,1610612763,MEM,70,1259,180,420,0.429,65,212,0.307,41,65,0.631,50,143,193,59,29,19,57,107,466,445,1.03,0.51,2022,23,6.6571428571428575,1.0350877192982457,240,24,264,0.7310606060606061
2022-23,RegularSeason,1626192,239,Pat Connaughton,1610612749,MIL,61,1443,165,421,0.392,109,322,0.339,27,41,0.659,50,233,283,77,37,11,33,69,466,571,2.33,1.12,2022,23,7.639344262295082,2.3333333333333335,256,14,270,1.048148148148148
2022-23,RegularSeason,1630570,241,Trendon Watford,1610612757,POR,62,1182,181,323,0.56,25,64,0.391,72,100,0.72,42,196,238,130,32,12,71,118,459,630,1.83,0.45,2022,23,7.403225806451613,1.8309859154929577,142,28,170,1.4
2022-23,RegularSeason,1629111,242,Jock Landale,1610612756,PHX,69,979,178,337,0.528,21,84,0.25,79,105,0.752,119,161,280,68,16,30,59,126,456,606,1.15,0.27,2022,23,6.608695652173913,1.152542372881356,159,26,185,1.5135135135135136
2022-23,RegularSeason,1630543,243,Isaiah Jackson,1610612754,IND,63,1042,179,318,0.563,2,14,0.143,95,146,0.651,113,169,282,51,31,93,51,154,455,671,1.0,0.61,2022,23,7.222222222222222,1.0,139,51,190,1.4842105263157894
2022-23,RegularSeason,1630558,244,Davion Mitchell,1610612758,SAC,80,1447,181,399,0.454,63,197,0.32,25,31,0.806,16,89,105,185,44,15,62,112,450,513,2.98,0.71,2022,23,5.625,2.9838709677419355,218,6,224,0.46875
2022-23,RegularSeason,1630164,244,James Wiseman,1610612765,DET,45,867,189,339,0.558,4,20,0.2,68,97,0.701,73,194,267,30,7,27,51,108,450,551,0.59,0.14,2022,23,10.0,0.5882352941176471,150,29,179,1.4916201117318435
2022-23,RegularSeason,203506,246,Victor Oladipo,1610612748,MIA,42,1106,160,403,0.397,70,212,0.33,59,79,0.747,16,112,128,146,57,12,87,99,449,442,1.68,0.66,2022,23,10.69047619047619,1.6781609195402298,243,20,263,0.4866920152091255
2022-23,RegularSeason,1626204,247,Larry Nance Jr.,1610612740,NOP,65,1381,186,305,0.61,14,42,0.333,55,79,0.696,106,248,354,119,56,37,42,133,441,822,2.83,1.33,2022,23,6.7846153846153845,2.8333333333333335,119,24,143,2.4755244755244754
2022-23,RegularSeason,201145,248,Jeff Green,1610612743,DEN,56,1091,160,328,0.488,30,104,0.288,87,117,0.744,38,106,144,69,18,17,46,99,437,441,1.5,0.39,2022,23,7.803571428571429,1.5,168,30,198,0.7272727272727273
2022-23,RegularSeason,1629011,249,Mitchell Robinson,1610612752,NYK,59,1589,188,280,0.671,0,0,0.0,59,122,0.484,267,288,555,53,56,109,41,160,435,1012,1.29,1.37,2022,23,7.372881355932203,1.2926829268292683,92,63,155,3.5806451612903225
2022-23,RegularSeason,1629056,250,Terence Davis,1610612758,SAC,64,841,154,364,0.423,89,243,0.366,34,43,0.791,20,119,139,67,43,12,53,104,431,420,1.26,0.81,2022,23,6.734375,1.2641509433962264,210,9,219,0.634703196347032
2022-23,RegularSeason,1630214,251,Xavier Tillman,1610612763,MEM,61,1180,188,306,0.614,4,15,0.267,49,89,0.551,121,186,307,96,58,29,44,97,429,717,2.18,1.32,2022,23,7.032786885245901,2.1818181818181817,118,40,158,1.9430379746835442
2022-23,RegularSeason,202709,252,Cory Joseph,1610612765,DET,62,1227,150,351,0.427,70,180,0.389,57,72,0.792,21,85,106,217,34,9,56,88,427,521,3.88,0.61,2022,23,6.887096774193548,3.875,201,15,216,0.49074074074074076
2022-23,RegularSeason,1629026,253,Kenrich Williams,1610612760,OKC,53,1206,179,346,0.517,50,134,0.373,17,39,0.436,97,164,261,105,45,14,32,112,425,629,3.28,1.41,2022,23,8.018867924528301,3.28125,167,22,189,1.380952380952381
2022-23,RegularSeason,1630702,254,Jaden Hardy,1610612742,DAL,48,708,146,333,0.438,63,156,0.404,65,79,0.823,11,78,89,65,17,7,46,64,420,351,1.41,0.37,2022,23,8.75,1.4130434782608696,187,14,201,0.4427860696517413
2022-23,RegularSeason,1630237,255,Anthony Lamb,1610612744,GSW,62,1195,148,314,0.471,73,199,0.367,46,60,0.767,56,159,215,96,28,20,54,134,415,540,1.78,0.52,2022,23,6.693548387096774,1.7777777777777777,166,14,180,1.1944444444444444
2022-23,RegularSeason,1628995,255,Kevin Knox II,1610612757,POR,63,952,152,332,0.458,65,186,0.349,46,60,0.767,34,143,177,33,24,12,50,95,415,417,0.66,0.48,2022,23,6.587301587301587,0.66,180,14,194,0.9123711340206185
2022-23,RegularSeason,201976,255,Patrick Beverley,1610612741,CHI,67,1817,144,360,0.4,80,239,0.335,47,65,0.723,44,203,247,194,63,41,60,187,415,666,3.23,1.05,2022,23,6.1940298507462686,3.2333333333333334,216,18,234,1.0555555555555556
2022-23,RegularSeason,1630692,258,Jordan Goodwin,1610612764,WAS,62,1105,158,353,0.448,38,118,0.322,53,69,0.768,57,148,205,168,58,26,57,95,407,596,2.95,1.02,2022,23,6.564516129032258,2.9473684210526314,195,16,211,0.9715639810426541
2022-23,RegularSeason,1628392,259,Isaiah Hartenstein,1610612752,NYK,82,1628,175,327,0.535,8,37,0.216,48,71,0.676,209,327,536,102,53,64,66,213,406,920,1.54,0.8,2022,23,4.951219512195122,1.5454545454545454,152,23,175,3.0628571428571427
2022-23,RegularSeason,203083,260,Andre Drummond,1610612741,CHI,67,849,166,274,0.606,0,3,0.0,67,125,0.536,138,306,444,33,45,27,75,117,399,707,0.44,0.6,2022,23,5.955223880597015,0.44,108,58,166,2.674698795180723
2022-23,RegularSeason,1629052,261,Oshae Brissett,1610612754,IND,65,1083,123,319,0.386,48,155,0.31,104,145,0.717,62,156,218,44,33,13,34,79,398,435,1.29,0.97,2022,23,6.123076923076923,1.2941176470588236,196,41,237,0.919831223628692
2022-23,RegularSeason,203914,262,Gary Harris,1610612753,ORL,48,1184,138,307,0.45,94,218,0.431,27,30,0.9,21,77,98,59,45,12,28,93,397,411,2.11,1.61,2022,23,8.270833333333334,2.107142857142857,169,3,172,0.5697674418604651
2022-23,RegularSeason,1630552,263,Jalen Johnson,1610612737,ATL,70,1042,158,322,0.491,30,104,0.288,49,78,0.628,51,231,282,83,38,34,41,113,395,598,2.02,0.93,2022,23,5.642857142857143,2.024390243902439,164,29,193,1.461139896373057
2022-23,RegularSeason,1629629,264,Cam Reddish,1610612757,POR,40,990,139,312,0.446,45,144,0.313,64,75,0.853,18,70,88,57,39,14,47,72,387,354,1.21,0.83,2022,23,9.675,1.2127659574468086,173,11,184,0.4782608695652174
2022-23,RegularSeason,1631109,264,Mark Williams,1610612766,CHA,43,828,160,251,0.637,0,0,0.0,67,97,0.691,93,211,304,18,28,45,40,94,387,621,0.45,0.7,2022,23,9.0,0.45,91,30,121,2.512396694214876
2022-23,RegularSeason,202322,266,John Wall,1610612746,LAC,34,755,138,338,0.408,33,109,0.303,77,113,0.681,14,78,92,178,27,12,80,59,386,379,2.23,0.34,2022,23,11.352941176470589,2.225,200,36,236,0.3898305084745763
2022-23,RegularSeason,203488,267,Mike Muscala,1610612738,BOS,63,945,131,292,0.449,81,207,0.391,40,52,0.769,37,166,203,50,15,24,23,98,383,479,2.17,0.65,2022,23,6.079365079365079,2.1739130434782608,161,12,173,1.1734104046242775
2022-23,RegularSeason,203115,268,Will Barton,1610612761,TOR,56,993,138,364,0.379,66,180,0.367,37,47,0.787,15,122,137,112,28,13,48,56,379,385,2.33,0.58,2022,23,6.767857142857143,2.3333333333333335,226,10,236,0.5805084745762712
2022-23,RegularSeason,1628410,269,Edmond Sumner,1610612751,BKN,53,736,124,269,0.461,31,87,0.356,99,108,0.917,13,66,79,68,31,10,50,83,378,362,1.36,0.62,2022,23,7.132075471698113,1.36,145,9,154,0.512987012987013
2022-23,RegularSeason,1627936,270,Alex Caruso,1610612741,CHI,67,1575,130,286,0.455,55,151,0.364,59,73,0.808,42,154,196,193,98,46,77,159,374,660,2.51,1.27,2022,23,5.582089552238806,2.5064935064935066,156,14,170,1.1529411764705881
2022-23,RegularSeason,1630528,271,Josh Christopher,1610612745,HOU,64,786,153,329,0.465,21,89,0.236,45,60,0.75,20,51,71,73,33,15,60,59,372,313,1.22,0.55,2022,23,5.8125,1.2166666666666666,176,15,191,0.3717277486910995
2022-23,RegularSeason,1629117,271,Wenyen Gabriel,1610612747,LAL,68,1024,155,260,0.596,10,36,0.278,52,84,0.619,116,170,286,36,26,35,46,144,372,572,0.78,0.56,2022,23,5.470588235294118,0.782608695652174,105,32,137,2.0875912408759123
2022-23,RegularSeason,1626153,273,Delon Wright,1610612764,WAS,50,1221,138,291,0.474,41,119,0.345,52,60,0.867,58,122,180,194,92,17,44,59,369,647,4.41,2.09,2022,23,7.38,4.409090909090909,153,8,161,1.1180124223602483
2022-23,RegularSeason,203210,274,JaMychal Green,1610612744,GSW,57,797,136,252,0.54,42,111,0.378,52,67,0.776,72,133,205,51,25,23,52,105,366,487,0.98,0.48,2022,23,6.421052631578948,0.9807692307692307,116,15,131,1.5648854961832062
2022-23,RegularSeason,201609,275,Goran Dragic,1610612749,MIL,58,870,141,335,0.421,52,145,0.359,31,45,0.689,16,65,81,151,13,4,63,65,365,343,2.4,0.21,2022,23,6.293103448275862,2.3968253968253967,194,14,208,0.3894230769230769
2022-23,RegularSeason,1629723,276,John Konchar,1610612763,MEM,72,1494,138,320,0.431,60,177,0.339,28,36,0.778,64,246,310,100,77,25,37,112,364,649,2.7,2.08,2022,23,5.055555555555555,2.7027027027027026,182,8,190,1.631578947368421
2022-23,RegularSeason,1629638,277,Nickeil Alexander-Walker,1610612750,MIN,59,884,131,295,0.444,61,159,0.384,40,60,0.667,15,86,101,108,32,21,55,88,363,386,1.96,0.58,2022,23,6.1525423728813555,1.9636363636363636,164,20,184,0.5489130434782609
2022-23,RegularSeason,1630537,278,Chris Duarte,1610612754,IND,46,897,123,333,0.369,55,174,0.316,61,72,0.847,19,96,115,64,25,9,41,65,362,313,1.56,0.61,2022,23,7.869565217391305,1.5609756097560976,210,11,221,0.5203619909502263
2022-23,RegularSeason,203967,278,Dario Saric,1610612760,OKC,57,806,127,277,0.458,45,115,0.391,63,76,0.829,53,154,207,74,20,7,55,99,362,452,1.34,0.36,2022,23,6.350877192982456,1.3454545454545455,150,13,163,1.2699386503067485
2022-23,RegularSeason,203500,280,Steven Adams,1610612763,MEM,42,1133,157,263,0.597,0,1,0.0,47,129,0.364,214,271,485,97,36,46,79,98,361,758,1.23,0.46,2022,23,8.595238095238095,1.2278481012658229,106,82,188,2.5797872340425534
2022-23,RegularSeason,1631128,281,Christian Braun,1610612743,DEN,76,1181,143,289,0.495,34,96,0.354,40,64,0.625,48,133,181,59,41,17,35,101,360,453,1.69,1.17,2022,23,4.7368421052631575,1.6857142857142857,146,24,170,1.0647058823529412
2022-23,RegularSeason,1629642,282,Nassir Little,1610612757,POR,54,976,134,303,0.442,58,158,0.367,33,46,0.717,27,114,141,50,20,20,36,66,359,372,1.39,0.56,2022,23,6.648148148148148,1.3888888888888888,169,13,182,0.7747252747252747
2022-23,RegularSeason,1630587,283,Isaiah Livers,1610612765,DET,52,1199,120,288,0.417,74,203,0.365,32,39,0.821,28,115,143,41,28,28,30,103,346,381,1.37,0.93,2022,23,6.653846153846154,1.3666666666666667,168,7,175,0.8171428571428572
2022-23,RegularSeason,1629013,283,Landry Shamet,1610612756,PHX,40,807,113,300,0.377,75,199,0.377,45,51,0.882,11,56,67,93,26,5,36,61,346,308,2.58,0.72,2022,23,8.65,2.5833333333333335,187,6,193,0.3471502590673575
2022-23,RegularSeason,1630205,285,Lamar Stevens,1610612739,CLE,62,1121,129,288,0.448,30,95,0.316,40,57,0.702,48,159,207,33,27,19,27,79,328,411,1.22,1.0,2022,23,5.290322580645161,1.2222222222222223,159,17,176,1.1761363636363635
2022-23,RegularSeason,1631323,285,Simone Fontecchio,1610612762,UTA,52,766,115,312,0.369,63,191,0.33,35,44,0.795,31,55,86,42,15,8,39,62,328,234,1.08,0.39,2022,23,6.3076923076923075,1.0769230769230769,197,9,206,0.4174757281553398
2022-23,RegularSeason,1628964,287,Mo Bamba,1610612747,LAL,49,768,117,241,0.485,48,124,0.387,41,62,0.661,58,167,225,46,13,43,30,105,323,475,1.53,0.43,2022,23,6.591836734693878,1.5333333333333334,124,21,145,1.5517241379310345
2022-23,RegularSeason,1629139,288,Yuta Watanabe,1610612751,BKN,58,928,114,232,0.491,60,135,0.444,34,47,0.723,30,111,141,48,25,17,22,80,322,400,2.18,1.14,2022,23,5.551724137931035,2.1818181818181817,118,13,131,1.0763358778625953
2022-23,RegularSeason,1629002,289,Chimezie Metu,1610612758,SAC,66,689,129,219,0.589,9,38,0.237,54,73,0.74,47,151,198,40,22,21,32,81,321,461,1.25,0.69,2022,23,4.863636363636363,1.25,90,19,109,1.81651376146789
2022-23,RegularSeason,1626149,290,Montrezl Harrell,1610612755,PHI,57,681,125,209,0.598,0,6,0.0,70,101,0.693,67,92,159,33,17,25,35,75,320,404,0.94,0.49,2022,23,5.614035087719298,0.9428571428571428,84,31,115,1.382608695652174
2022-23,RegularSeason,1627884,291,Derrick Jones Jr.,1610612741,CHI,64,893,115,230,0.5,27,80,0.338,62,84,0.738,60,93,153,34,29,37,25,86,319,410,1.36,1.16,2022,23,4.984375,1.36,115,22,137,1.1167883211678833
2022-23,RegularSeason,204060,292,Joe Ingles,1610612749,MIL,46,1044,108,248,0.435,83,203,0.409,18,21,0.857,13,115,128,150,33,6,55,74,317,436,2.73,0.6,2022,23,6.891304347826087,2.727272727272727,140,3,143,0.8951048951048951
2022-23,RegularSeason,203933,293,T.J. Warren,1610612756,PHX,42,687,132,270,0.489,22,67,0.328,28,35,0.8,26,95,121,40,22,12,20,65,314,344,2.0,1.1,2022,23,7.476190476190476,2.0,138,7,145,0.8344827586206897
2022-23,RegularSeason,1629660,294,Ty Jerome,1610612744,GSW,45,816,118,242,0.488,35,90,0.389,38,41,0.927,7,71,78,135,23,5,30,64,309,393,4.5,0.77,2022,23,6.866666666666666,4.5,124,3,127,0.6141732283464567
2022-23,RegularSeason,1630541,295,Moses Moody,1610612744,GSW,63,817,108,227,0.476,49,135,0.363,37,53,0.698,28,77,105,51,18,7,34,54,302,314,1.5,0.53,2022,23,4.7936507936507935,1.5,119,16,135,0.7777777777777778
2022-23,RegularSeason,1630181,295,R.J. Hampton,1610612765,DET,47,750,102,237,0.43,41,116,0.353,57,76,0.75,18,69,87,54,27,9,42,51,302,283,1.29,0.64,2022,23,6.425531914893617,1.2857142857142858,135,19,154,0.564935064935065
2022-23,RegularSeason,1629641,297,Romeo Langford,1610612759,SAS,43,844,121,259,0.467,16,61,0.262,39,56,0.696,57,57,114,50,24,13,30,67,297,313,1.67,0.8,2022,23,6.906976744186046,1.6666666666666667,138,17,155,0.7354838709677419
2022-23,RegularSeason,1628427,297,Vlatko Cancar,1610612743,DEN,60,889,108,227,0.476,43,115,0.374,38,41,0.927,24,104,128,80,22,14,37,84,297,382,2.16,0.59,2022,23,4.95,2.1621621621621623,119,3,122,1.0491803278688525
2022-23,RegularSeason,1630177,299,Theo Maledon,1610612766,CHA,44,854,102,254,0.402,28,95,0.295,63,74,0.851,14,109,123,152,37,12,59,61,295,397,2.58,0.63,2022,23,6.704545454545454,2.5762711864406778,152,11,163,0.754601226993865
2022-23,RegularSeason,1629680,300,Matisse Thybulle,1610612757,POR,71,1200,110,253,0.435,54,148,0.365,19,28,0.679,40,100,140,53,83,32,24,113,293,425,2.21,3.46,2022,23,4.126760563380282,2.2083333333333335,143,9,152,0.9210526315789473
2022-23,RegularSeason,200752,300,Rudy Gay,1610612762,UTA,56,816,109,287,0.38,33,130,0.254,42,49,0.857,33,130,163,57,19,18,37,68,293,328,1.54,0.51,2022,23,5.232142857142857,1.5405405405405406,178,7,185,0.8810810810810811
2022-23,RegularSeason,1630526,302,Jeremiah Robinson-Earl,1610612760,OKC,43,814,110,248,0.444,37,111,0.333,35,42,0.833,71,109,180,43,24,11,19,71,292,386,2.26,1.26,2022,23,6.790697674418604,2.263157894736842,138,7,145,1.2413793103448276
2022-23,RegularSeason,1627732,303,Ben Simmons,1610612751,BKN,42,1105,133,235,0.566,0,2,0.0,25,57,0.439,40,223,263,256,54,24,97,139,291,657,2.64,0.56,2022,23,6.928571428571429,2.6391752577319587,102,32,134,1.962686567164179
2022-23,RegularSeason,1627739,304,Kris Dunn,1610612762,UTA,22,568,116,216,0.537,17,36,0.472,41,53,0.774,9,91,100,124,25,10,35,58,290,402,3.54,0.71,2022,23,13.181818181818182,3.5428571428571427,100,12,112,0.8928571428571429
2022-23,RegularSeason,1631119,305,Jaylin Williams,1610612760,OKC,49,914,102,234,0.436,46,113,0.407,38,54,0.704,44,197,241,76,28,12,37,111,288,460,2.05,0.76,2022,23,5.877551020408164,2.054054054054054,132,16,148,1.6283783783783783
2022-23,RegularSeason,203496,305,Robert Covington,1610612746,LAC,48,779,102,229,0.445,54,136,0.397,30,40,0.75,31,135,166,57,38,33,32,86,288,413,1.78,1.19,2022,23,6.0,1.78125,127,10,137,1.2116788321167884
2022-23,RegularSeason,1630194,307,Paul Reed,1610612755,PHI,69,755,124,209,0.593,1,6,0.167,38,51,0.745,112,150,262,27,46,51,45,123,287,530,0.6,1.02,2022,23,4.159420289855072,0.6,85,13,98,2.673469387755102
2022-23,RegularSeason,1630256,308,Jae'Sean Tate,1610612745,HOU,31,677,110,229,0.48,13,46,0.283,50,69,0.725,41,77,118,84,21,7,47,106,283,328,1.79,0.45,2022,23,9.129032258064516,1.7872340425531914,119,19,138,0.855072463768116
2022-23,RegularSeason,1629057,309,Robert Williams III,1610612738,BOS,35,824,127,170,0.747,0,1,0.0,25,41,0.61,104,188,292,50,22,48,34,68,279,598,1.47,0.65,2022,23,7.9714285714285715,1.4705882352941178,43,16,59,4.9491525423728815
2022-23,RegularSeason,1630647,310,Eugene Omoruyi,1610612765,DET,40,645,101,228,0.443,25,89,0.281,51,75,0.68,43,68,111,28,28,3,34,91,278,263,0.82,0.82,2022,23,6.95,0.8235294117647058,127,24,151,0.7350993377483444
2022-23,RegularSeason,1630192,311,Zeke Nnaji,1610612743,DEN,53,728,110,196,0.561,17,65,0.262,40,62,0.645,65,73,138,18,17,23,31,105,277,334,0.58,0.55,2022,23,5.226415094339623,0.5806451612903226,86,22,108,1.2777777777777777
2022-23,RegularSeason,1630197,312,Aleksej Pokusevski,1610612760,OKC,34,701,108,249,0.434,38,104,0.365,22,35,0.629,45,114,159,64,20,43,43,58,276,365,1.49,0.47,2022,23,8.117647058823529,1.4883720930232558,141,13,154,1.0324675324675325
2022-23,RegularSeason,1630202,313,Payton Pritchard,1610612738,BOS,48,643,101,245,0.412,56,154,0.364,12,16,0.75,25,63,88,64,14,1,40,37,270,249,1.6,0.35,2022,23,5.625,1.6,144,4,148,0.5945945945945946
2022-23,RegularSeason,1627863,314,Danuel House Jr.,1610612755,PHI,56,807,93,197,0.472,37,110,0.336,45,60,0.75,9,85,94,44,14,9,26,69,268,284,1.69,0.54,2022,23,4.785714285714286,1.6923076923076923,104,15,119,0.7899159663865546
2022-23,RegularSeason,1629130,314,Duncan Robinson,1610612748,MIA,42,690,88,237,0.371,63,192,0.328,29,32,0.906,8,61,69,46,14,0,28,77,268,217,1.64,0.5,2022,23,6.380952380952381,1.6428571428571428,149,3,152,0.45394736842105265
2022-23,RegularSeason,1630699,316,MarJon Beauchamp,1610612749,MIL,52,701,96,243,0.395,47,142,0.331,27,37,0.73,38,77,115,35,21,7,45,71,266,242,0.78,0.47,2022,23,5.115384615384615,0.7777777777777778,147,10,157,0.732484076433121
2022-23,RegularSeason,200782,316,P.J. Tucker,1610612755,PHI,75,1920,96,225,0.427,55,140,0.393,19,23,0.826,95,200,295,60,39,15,44,180,266,498,1.36,0.89,2022,23,3.546666666666667,1.3636363636363635,129,4,133,2.218045112781955
2022-23,RegularSeason,202687,318,Bismack Biyombo,1610612756,PHX,61,874,119,206,0.578,0,0,0.0,25,70,0.357,89,171,260,56,18,88,51,114,263,502,1.1,0.35,2022,23,4.311475409836065,1.0980392156862746,87,45,132,1.9696969696969697
2022-23,RegularSeason,1630572,318,Sandro Mamukelashvili,1610612759,SAS,43,660,97,230,0.422,30,99,0.303,39,57,0.684,70,115,185,62,14,12,35,52,263,350,1.77,0.4,2022,23,6.116279069767442,1.7714285714285714,133,18,151,1.2251655629139073
2022-23,RegularSeason,1630550,320,JT Thor,1610612766,CHA,69,969,95,238,0.399,39,123,0.317,33,47,0.702,36,116,152,36,22,23,44,66,262,294,0.82,0.5,2022,23,3.7971014492753623,0.8181818181818182,143,14,157,0.9681528662420382
2022-23,RegularSeason,1626195,320,Willy Hernangomez,1610612740,NOP,38,458,89,169,0.527,3,11,0.273,81,104,0.779,58,122,180,33,17,13,39,64,262,363,0.85,0.44,2022,23,6.894736842105263,0.8461538461538461,80,23,103,1.7475728155339805
2022-23,RegularSeason,1628436,322,Luke Kornet,1610612738,BOS,69,804,113,170,0.665,3,13,0.231,32,39,0.821,86,111,197,53,11,46,25,81,261,479,2.12,0.44,2022,23,3.782608695652174,2.12,57,7,64,3.078125
2022-23,RegularSeason,1629726,323,Garrison Mathews,1610612737,ATL,54,686,73,201,0.363,63,180,0.35,48,53,0.906,11,62,73,26,24,5,19,62,257,233,1.37,1.26,2022,23,4.7592592592592595,1.368421052631579,128,5,133,0.5488721804511278
2022-23,RegularSeason,203085,324,Austin Rivers,1610612750,MIN,52,1016,91,209,0.435,43,123,0.35,30,39,0.769,5,78,83,75,28,4,23,80,255,295,3.26,1.22,2022,23,4.903846153846154,3.260869565217391,118,9,127,0.6535433070866141
2022-23,RegularSeason,1630688,325,Ish Wainright,1610612756,PHX,60,915,84,227,0.37,57,173,0.329,26,31,0.839,45,94,139,53,38,22,22,117,251,333,2.41,1.73,2022,23,4.183333333333334,2.409090909090909,143,5,148,0.9391891891891891
2022-23,RegularSeason,1628988,326,Aaron Holiday,1610612737,ATL,63,845,92,220,0.418,36,88,0.409,27,32,0.844,25,49,74,89,37,12,36,79,247,290,2.47,1.03,2022,23,3.9206349206349205,2.4722222222222223,128,5,133,0.556390977443609
2022-23,RegularSeason,1631121,327,Bryce McGowens,1610612766,CHA,46,787,80,202,0.396,26,80,0.325,60,80,0.75,20,73,93,54,15,6,43,48,246,229,1.26,0.35,2022,23,5.3478260869565215,1.255813953488372,122,20,142,0.6549295774647887
2022-23,RegularSeason,1630201,327,Malachi Flynn,1610612761,TOR,53,691,87,242,0.36,47,133,0.353,25,33,0.758,15,61,76,70,21,4,25,65,246,229,2.8,0.84,2022,23,4.6415094339622645,2.8,155,8,163,0.4662576687116564
2022-23,RegularSeason,201988,327,Patty Mills,1610612751,BKN,40,567,86,209,0.411,49,134,0.366,25,30,0.833,8,36,44,56,15,3,30,32,246,206,1.87,0.5,2022,23,6.15,1.8666666666666667,123,5,128,0.34375
2022-23,RegularSeason,1630613,330,Duane Washington Jr.,1610612752,NYK,31,394,94,256,0.367,40,111,0.36,16,24,0.667,2,34,36,63,6,4,34,23,244,149,1.85,0.18,2022,23,7.870967741935484,1.8529411764705883,162,8,170,0.21176470588235294
2022-23,RegularSeason,201152,331,Thaddeus Young,1610612761,TOR,54,795,108,198,0.545,6,34,0.176,18,26,0.692,71,95,166,75,54,5,42,88,240,400,1.79,1.29,2022,23,4.444444444444445,1.7857142857142858,90,8,98,1.6938775510204083
2022-23,RegularSeason,1630595,332,Cade Cunningham,1610612765,DET,12,400,93,224,0.415,17,61,0.279,36,43,0.837,12,62,74,72,10,7,39,34,239,225,1.85,0.26,2022,23,19.916666666666668,1.8461538461538463,131,7,138,0.5362318840579711
2022-23,RegularSeason,1629312,333,Haywood Highsmith,1610612748,MIA,54,969,93,216,0.431,37,109,0.339,13,28,0.464,57,131,188,43,36,17,45,82,236,337,0.96,0.8,2022,23,4.37037037037037,0.9555555555555556,123,15,138,1.3623188405797102
2022-23,RegularSeason,1629637,334,Jaxson Hayes,1610612740,NOP,47,610,86,156,0.551,3,29,0.103,58,83,0.699,39,93,132,34,20,19,31,67,233,312,1.1,0.65,2022,23,4.957446808510638,1.096774193548387,70,25,95,1.3894736842105264
2022-23,RegularSeason,201588,335,George Hill,1610612754,IND,46,833,78,166,0.47,34,95,0.358,42,55,0.764,15,70,85,110,26,6,34,55,232,324,3.23,0.77,2022,23,5.043478260869565,3.235294117647059,88,13,101,0.8415841584158416
2022-23,RegularSeason,1630549,336,Day'Ron Sharpe,1610612751,BKN,48,553,93,171,0.544,6,11,0.545,35,55,0.636,99,101,200,37,15,32,42,89,227,371,0.88,0.36,2022,23,4.729166666666667,0.8809523809523809,78,20,98,2.0408163265306123
2022-23,RegularSeason,1630700,336,Dyson Daniels,1610612740,NOP,59,1042,87,208,0.418,27,86,0.314,26,40,0.65,36,152,188,134,43,11,57,99,227,411,2.35,0.75,2022,23,3.847457627118644,2.3508771929824563,121,14,135,1.3925925925925926
2022-23,RegularSeason,1630227,338,Daishen Nix,1610612745,HOU,57,914,81,237,0.342,40,140,0.286,24,36,0.667,18,80,98,132,31,7,86,59,226,240,1.53,0.36,2022,23,3.9649122807017543,1.5348837209302326,156,12,168,0.5833333333333334
2022-23,RegularSeason,1630586,339,Usman Garuba,1610612745,HOU,75,970,86,177,0.486,24,59,0.407,29,47,0.617,120,187,307,64,44,29,47,135,225,513,1.36,0.94,2022,23,3.0,1.3617021276595744,91,18,109,2.81651376146789
2022-23,RegularSeason,1629647,340,Darius Bazley,1610612756,PHX,43,616,83,183,0.454,20,53,0.377,38,70,0.543,34,104,138,38,22,34,27,44,224,297,1.41,0.81,2022,23,5.209302325581396,1.4074074074074074,100,32,132,1.0454545454545454
2022-23,RegularSeason,1630540,341,Miles McBride,1610612752,NYK,64,760,77,215,0.358,40,134,0.299,28,42,0.667,13,37,50,72,37,8,25,60,222,212,2.88,1.48,2022,23,3.46875,2.88,138,14,152,0.32894736842105265
2022-23,RegularSeason,1629004,341,Svi Mykhailiuk,1610612766,CHA,32,468,77,173,0.445,42,99,0.424,26,39,0.667,15,38,53,53,15,4,24,23,222,214,2.21,0.63,2022,23,6.9375,2.2083333333333335,96,13,109,0.48623853211009177
2022-23,RegularSeason,1628467,343,Maxi Kleber,1610612742,DAL,37,930,77,169,0.456,39,112,0.348,27,38,0.711,30,105,135,52,12,30,27,85,220,319,1.93,0.44,2022,23,5.945945945945946,1.9259259259259258,92,11,103,1.3106796116504855
2022-23,RegularSeason,1631133,344,Jabari Walker,1610612757,POR,56,619,83,198,0.419,16,56,0.286,34,45,0.756,48,83,131,34,10,13,29,69,216,249,1.17,0.34,2022,23,3.857142857142857,1.1724137931034482,115,11,126,1.0396825396825398
2022-23,RegularSeason,1630322,345,Lindy Waters III,1610612760,OKC,41,531,70,178,0.393,58,162,0.358,16,20,0.8,16,59,75,28,14,11,10,42,214,220,2.8,1.4,2022,23,5.219512195121951,2.8,108,4,112,0.6696428571428571
2022-23,RegularSeason,1630533,346,Ziaire Williams,1610612763,MEM,37,561,84,196,0.429,25,97,0.258,17,22,0.773,16,63,79,35,14,6,37,58,210,190,0.95,0.38,2022,23,5.675675675675675,0.9459459459459459,112,5,117,0.6752136752136753
2022-23,RegularSeason,1629731,347,Dean Wade,1610612739,CLE,44,892,73,177,0.412,45,127,0.354,15,23,0.652,20,130,150,37,28,21,17,89,206,313,2.18,1.65,2022,23,4.681818181818182,2.176470588235294,104,8,112,1.3392857142857142
2022-23,RegularSeason,202722,347,Dāvis Bertāns,1610612742,DAL,45,492,69,160,0.431,55,141,0.39,13,15,0.867,10,43,53,21,11,8,10,53,206,196,2.1,1.1,2022,23,4.5777777777777775,2.1,91,2,93,0.5698924731182796
2022-23,RegularSeason,203200,349,Justin Holiday,1610612742,DAL,46,706,77,204,0.377,46,143,0.322,5,8,0.625,5,50,55,41,19,19,22,68,205,187,1.86,0.86,2022,23,4.456521739130435,1.8636363636363635,127,3,130,0.4230769230769231
2022-23,RegularSeason,1629646,350,Charles Bassey,1610612759,SAS,35,508,87,135,0.644,3,8,0.375,22,37,0.595,75,118,193,48,16,33,41,74,199,385,1.17,0.39,2022,23,5.685714285714286,1.170731707317073,48,15,63,3.0634920634920637
2022-23,RegularSeason,201599,350,DeAndre Jordan,1610612743,DEN,39,586,88,115,0.765,1,1,1.0,22,48,0.458,52,150,202,34,12,23,48,71,199,369,0.71,0.25,2022,23,5.102564102564102,0.7083333333333334,27,26,53,3.811320754716981
2022-23,RegularSeason,203473,350,Dewayne Dedmon,1610612755,PHI,38,426,77,151,0.51,12,39,0.308,33,49,0.673,34,100,134,26,9,19,25,75,199,272,1.04,0.36,2022,23,5.2368421052631575,1.04,74,16,90,1.488888888888889
2022-23,RegularSeason,1626159,353,Justise Winslow,1610612757,POR,29,776,81,198,0.409,14,45,0.311,20,28,0.714,49,96,145,98,30,11,43,89,196,312,2.28,0.7,2022,23,6.758620689655173,2.2790697674418605,117,8,125,1.16
2022-23,RegularSeason,1630264,354,Anthony Gill,1610612764,WAS,59,625,71,132,0.538,4,29,0.138,49,67,0.731,37,62,99,34,7,12,15,70,195,253,2.27,0.47,2022,23,3.305084745762712,2.2666666666666666,61,18,79,1.2531645569620253
2022-23,RegularSeason,1631216,355,Caleb Houstan,1610612753,ORL,51,812,66,182,0.363,46,136,0.338,15,18,0.833,34,65,99,30,12,7,18,63,193,204,1.67,0.67,2022,23,3.784313725490196,1.6666666666666667,116,3,119,0.8319327731092437
2022-23,RegularSeason,1631172,355,Ousmane Dieng,1610612760,OKC,39,569,76,181,0.42,26,98,0.265,15,23,0.652,19,86,105,46,14,7,26,42,193,226,1.77,0.54,2022,23,4.948717948717949,1.7692307692307692,105,8,113,0.9292035398230089
2022-23,RegularSeason,1630547,357,James Bouknight,1610612766,CHA,34,515,69,193,0.358,33,109,0.303,20,30,0.667,8,64,72,41,14,5,32,49,191,157,1.28,0.44,2022,23,5.617647058823529,1.28125,124,10,134,0.5373134328358209
2022-23,RegularSeason,1630553,358,Keon Johnson,1610612757,POR,40,416,67,178,0.376,28,81,0.346,27,41,0.659,11,33,44,59,19,6,43,43,189,149,1.37,0.44,2022,23,4.725,1.372093023255814,111,14,125,0.352
2022-23,RegularSeason,201580,359,JaVale McGee,1610612742,DAL,42,355,80,125,0.64,2,5,0.4,24,41,0.585,30,77,107,11,4,26,36,54,186,236,0.31,0.11,2022,23,4.428571428571429,0.3055555555555556,45,17,62,1.7258064516129032
2022-23,RegularSeason,1631104,360,Blake Wesley,1610612759,SAS,37,669,69,215,0.321,20,52,0.385,26,44,0.591,12,70,82,98,25,5,65,67,184,165,1.51,0.39,2022,23,4.972972972972973,1.5076923076923077,146,18,164,0.5
2022-23,RegularSeason,203585,361,Rodney McGruder,1610612765,DET,32,524,62,152,0.408,41,97,0.423,18,22,0.818,20,54,74,28,16,1,11,39,183,197,2.54,1.46,2022,23,5.71875,2.5454545454545454,90,4,94,0.7872340425531915
2022-23,RegularSeason,1631132,362,Christian Koloko,1610612761,TOR,58,802,72,150,0.48,1,12,0.083,37,59,0.627,84,87,171,31,21,57,20,128,182,342,1.55,1.05,2022,23,3.1379310344827585,1.55,78,22,100,1.71
2022-23,RegularSeason,1630568,363,Luka Garza,1610612750,MIN,28,243,63,116,0.543,14,39,0.359,41,52,0.788,33,30,63,18,3,2,14,43,181,189,1.29,0.21,2022,23,6.464285714285714,1.2857142857142858,53,11,64,0.984375
2022-23,RegularSeason,202083,364,Wesley Matthews,1610612749,MIL,52,820,58,160,0.363,39,124,0.315,24,28,0.857,34,79,113,34,20,13,18,71,179,235,1.89,1.11,2022,23,3.4423076923076925,1.8888888888888888,102,4,106,1.0660377358490567
2022-23,RegularSeason,1630579,365,Jericho Sims,1610612752,NYK,52,812,83,107,0.776,0,1,0.0,12,16,0.75,99,143,242,25,15,28,27,96,178,433,0.93,0.56,2022,23,3.423076923076923,0.9259259259259259,24,4,28,8.642857142857142
2022-23,RegularSeason,1626169,366,Stanley Johnson,1610612759,SAS,30,470,65,122,0.533,18,40,0.45,26,39,0.667,22,73,95,67,16,6,33,48,174,255,2.03,0.48,2022,23,5.8,2.0303030303030303,57,13,70,1.3571428571428572
2022-23,RegularSeason,1629599,367,Amir Coffey,1610612746,LAC,50,625,56,145,0.386,11,40,0.275,49,63,0.778,17,36,53,53,7,5,21,50,172,166,2.52,0.33,2022,23,3.44,2.5238095238095237,89,14,103,0.5145631067961165
2022-23,RegularSeason,1629676,367,Isaiah Roby,1610612752,NYK,42,474,67,155,0.432,18,60,0.3,20,41,0.488,21,86,107,38,18,7,31,53,172,202,1.23,0.58,2022,23,4.095238095238095,1.2258064516129032,88,21,109,0.981651376146789
2022-23,RegularSeason,201937,369,Ricky Rubio,1610612739,CLE,33,566,61,178,0.343,21,82,0.256,28,35,0.8,9,61,70,115,26,6,31,51,171,233,3.71,0.84,2022,23,5.181818181818182,3.7096774193548385,117,7,124,0.5645161290322581
2022-23,RegularSeason,201933,370,Blake Griffin,1610612738,BOS,41,569,63,130,0.485,23,66,0.348,21,32,0.656,47,108,155,61,14,9,22,75,170,309,2.77,0.64,2022,23,4.146341463414634,2.772727272727273,67,11,78,1.9871794871794872
2022-23,RegularSeason,201959,371,Taj Gibson,1610612764,WAS,49,480,65,125,0.52,8,24,0.333,30,42,0.714,32,61,93,34,15,12,26,84,168,224,1.31,0.58,2022,23,3.4285714285714284,1.3076923076923077,60,12,72,1.2916666666666667
2022-23,RegularSeason,1629048,372,Goga Bitadze,1610612753,ORL,38,457,69,125,0.552,6,26,0.231,23,42,0.548,61,76,137,39,16,26,22,64,167,288,1.77,0.73,2022,23,4.394736842105263,1.7727272727272727,56,19,75,1.8266666666666667
2022-23,RegularSeason,203095,373,Evan Fournier,1610612752,NYK,27,459,56,166,0.337,35,114,0.307,18,21,0.857,4,45,49,36,16,3,22,46,165,134,1.64,0.73,2022,23,6.111111111111111,1.6363636363636365,110,3,113,0.4336283185840708
2022-23,RegularSeason,1629750,373,Javonte Green,1610612741,CHI,32,480,61,108,0.565,13,35,0.371,30,45,0.667,27,61,88,23,24,21,20,52,165,239,1.15,1.2,2022,23,5.15625,1.15,47,15,62,1.4193548387096775
2022-23,RegularSeason,1630577,373,Julian Champagnie,1610612759,SAS,17,320,59,130,0.454,33,82,0.402,14,17,0.824,10,50,60,10,6,5,11,26,165,161,0.91,0.55,2022,23,9.705882352941176,0.9090909090909091,71,3,74,0.8108108108108109
2022-23,RegularSeason,1631098,376,Johnny Davis,1610612764,WAS,28,423,66,171,0.386,17,70,0.243,14,27,0.519,10,55,65,28,10,8,17,48,163,139,1.65,0.59,2022,23,5.821428571428571,1.6470588235294117,105,13,118,0.5508474576271186
2022-23,RegularSeason,1629162,377,Jordan McLaughlin,1610612750,MIN,43,679,61,145,0.421,24,78,0.308,15,18,0.833,15,47,62,148,32,4,33,28,161,287,4.49,0.97,2022,23,3.744186046511628,4.484848484848484,84,3,87,0.7126436781609196
2022-23,RegularSeason,1630539,378,Kai Jones,1610612766,CHA,46,550,67,120,0.558,4,19,0.211,19,26,0.731,37,86,123,15,17,30,31,65,157,251,0.48,0.55,2022,23,3.4130434782608696,0.4838709677419355,53,7,60,2.05
2022-23,RegularSeason,203526,378,Raul Neto,1610612739,CLE,48,505,57,110,0.518,12,42,0.286,31,34,0.912,10,36,46,79,17,4,24,49,157,223,3.29,0.71,2022,23,3.2708333333333335,3.2916666666666665,53,3,56,0.8214285714285714
2022-23,RegularSeason,1629678,380,Admiral Schofield,1610612753,ORL,37,451,55,122,0.451,24,74,0.324,21,23,0.913,23,39,62,31,8,5,16,61,155,176,1.94,0.5,2022,23,4.1891891891891895,1.9375,67,2,69,0.8985507246376812
2022-23,RegularSeason,1629308,380,Juan Toscano-Anderson,1610612762,UTA,52,700,64,143,0.448,8,43,0.186,19,24,0.792,28,96,124,65,16,10,34,80,155,252,1.91,0.47,2022,23,2.980769230769231,1.911764705882353,79,5,84,1.4761904761904763
2022-23,RegularSeason,1629650,380,Moses Brown,1610612751,BKN,36,294,61,96,0.635,0,0,0.0,33,72,0.458,57,82,139,4,4,14,15,39,155,227,0.27,0.27,2022,23,4.305555555555555,0.26666666666666666,35,39,74,1.8783783783783783
2022-23,RegularSeason,1631260,383,AJ Green,1610612749,MIL,35,345,53,125,0.424,44,105,0.419,4,4,1.0,6,39,45,22,6,0,9,31,154,146,2.44,0.67,2022,23,4.4,2.4444444444444446,72,0,72,0.625
2022-23,RegularSeason,1628981,384,Bruno Fernando,1610612737,ATL,39,405,59,112,0.527,0,4,0.0,35,50,0.7,54,83,137,31,6,34,25,74,153,268,1.24,0.24,2022,23,3.923076923076923,1.24,53,15,68,2.014705882352941
2022-23,RegularSeason,201565,385,Derrick Rose,1610612752,NYK,27,338,61,159,0.384,19,63,0.302,11,12,0.917,8,32,40,46,7,5,22,18,152,129,2.09,0.32,2022,23,5.62962962962963,2.090909090909091,98,1,99,0.40404040404040403
2022-23,RegularSeason,1630240,386,Saben Lee,1610612756,PHX,25,374,49,121,0.405,11,30,0.367,42,57,0.737,13,32,45,67,19,1,24,32,151,172,2.79,0.79,2022,23,6.04,2.7916666666666665,72,15,87,0.5172413793103449
2022-23,RegularSeason,1631102,387,TyTy Washington Jr.,1610612745,HOU,31,433,58,160,0.363,19,80,0.238,10,18,0.556,2,43,45,47,15,2,14,29,145,130,3.36,1.07,2022,23,4.67741935483871,3.357142857142857,102,8,110,0.4090909090909091
2022-23,RegularSeason,1630527,388,Brandon Boston Jr.,1610612746,LAC,22,248,51,122,0.418,12,29,0.414,29,38,0.763,7,23,30,20,9,0,12,21,143,110,1.67,0.75,2022,23,6.5,1.6666666666666667,71,9,80,0.375
2022-23,RegularSeason,1630625,389,Dalano Banton,1610612761,TOR,31,279,55,130,0.423,15,51,0.294,17,24,0.708,11,34,45,36,13,13,18,34,142,149,2.0,0.72,2022,23,4.580645161290323,2.0,75,7,82,0.5487804878048781
2022-23,RegularSeason,1627745,389,Damian Jones,1610612762,UTA,41,477,55,86,0.64,10,17,0.588,22,29,0.759,42,80,122,15,8,21,23,55,142,247,0.65,0.35,2022,23,3.4634146341463414,0.6521739130434783,31,7,38,3.210526315789474
2022-23,RegularSeason,1630284,391,Kevon Harris,1610612753,ORL,34,457,47,107,0.439,16,43,0.372,31,41,0.756,28,42,70,16,17,5,21,53,141,158,0.76,0.81,2022,23,4.147058823529412,0.7619047619047619,60,10,70,1.0
2022-23,RegularSeason,1627788,392,Furkan Korkmaz,1610612755,PHI,37,353,48,111,0.432,18,46,0.391,26,36,0.722,6,36,42,22,10,3,24,18,140,120,0.92,0.42,2022,23,3.7837837837837838,0.9166666666666666,63,10,73,0.5753424657534246
2022-23,RegularSeason,1630233,393,Nathan Knight,1610612750,MIN,38,291,46,81,0.568,8,22,0.364,39,57,0.684,22,34,56,13,10,6,21,41,139,150,0.62,0.48,2022,23,3.6578947368421053,0.6190476190476191,35,18,53,1.0566037735849056
2022-23,RegularSeason,1628373,394,Frank Ntilikina,1610612742,DAL,47,608,48,132,0.364,17,67,0.254,22,33,0.667,7,55,62,58,16,7,29,65,135,154,2.0,0.55,2022,23,2.872340425531915,2.0,84,11,95,0.6526315789473685
2022-23,RegularSeason,202693,395,Markieff Morris,1610612742,DAL,35,355,47,115,0.409,28,71,0.394,10,10,1.0,13,58,71,31,9,5,18,48,132,162,1.72,0.5,2022,23,3.7714285714285714,1.7222222222222223,68,0,68,1.0441176470588236
2022-23,RegularSeason,1626158,396,Richaun Holmes,1610612758,SAC,42,348,55,89,0.618,5,8,0.625,15,19,0.789,29,51,80,9,3,11,14,50,130,181,0.64,0.21,2022,23,3.0952380952380953,0.6428571428571429,34,4,38,2.1052631578947367
2022-23,RegularSeason,1629643,397,Chuma Okeke,1610612753,ORL,27,518,43,122,0.352,26,86,0.302,16,21,0.762,26,70,96,37,19,11,17,40,128,190,2.18,1.12,2022,23,4.7407407407407405,2.176470588235294,79,5,84,1.1428571428571428
2022-23,RegularSeason,1631108,397,Max Christie,1610612747,LAL,41,512,44,106,0.415,26,62,0.419,14,16,0.875,7,68,75,21,9,7,13,33,128,163,1.61,0.69,2022,23,3.1219512195121952,1.6153846153846154,62,2,64,1.171875
2022-23,RegularSeason,1628962,399,Udoka Azubuike,1610612762,UTA,36,359,59,72,0.819,0,0,0.0,7,20,0.35,31,88,119,11,6,15,18,34,125,232,0.61,0.33,2022,23,3.4722222222222223,0.6111111111111112,13,13,26,4.576923076923077
2022-23,RegularSeason,203109,400,Jae Crowder,1610612749,MIL,18,340,45,94,0.479,24,55,0.436,10,12,0.833,17,52,69,27,12,6,7,27,124,180,3.86,1.71,2022,23,6.888888888888889,3.857142857142857,49,2,51,1.3529411764705883
2022-23,RegularSeason,1627823,401,Juancho Hernangomez,1610612761,TOR,42,614,48,114,0.421,17,67,0.254,9,16,0.563,27,96,123,25,16,6,15,43,122,204,1.67,1.07,2022,23,2.9047619047619047,1.6666666666666667,66,7,73,1.6849315068493151
2022-23,RegularSeason,1630346,401,Matt Ryan,1610612750,MIN,34,310,40,108,0.37,32,84,0.381,10,12,0.833,4,22,26,16,5,1,7,27,122,93,2.29,0.71,2022,23,3.588235294117647,2.2857142857142856,68,2,70,0.37142857142857144
2022-23,RegularSeason,1631116,401,Patrick Baldwin Jr.,1610612744,GSW,31,226,43,109,0.394,32,84,0.381,4,6,0.667,1,39,40,11,6,4,11,14,122,104,1.0,0.55,2022,23,3.935483870967742,1.0,66,2,68,0.5882352941176471
2022-23,RegularSeason,203476,404,Gorgui Dieng,1610612759,SAS,31,358,45,117,0.385,21,75,0.28,10,13,0.769,27,80,107,53,4,14,32,57,121,192,1.66,0.13,2022,23,3.903225806451613,1.65625,72,3,75,1.4266666666666667
2022-23,RegularSeason,1631254,405,Kenneth Lofton Jr.,1610612763,MEM,24,176,49,93,0.527,6,17,0.353,16,27,0.593,19,32,51,20,5,2,12,28,120,131,1.67,0.42,2022,23,5.0,1.6666666666666667,44,11,55,0.9272727272727272
2022-23,RegularSeason,1631115,406,Orlando Robinson,1610612748,MIA,31,425,47,89,0.528,0,6,0.0,22,31,0.71,48,78,126,25,12,12,16,53,116,224,1.56,0.75,2022,23,3.7419354838709675,1.5625,42,9,51,2.4705882352941178
2022-23,RegularSeason,1630184,407,Kira Lewis Jr.,1610612740,NOP,25,235,40,88,0.455,15,34,0.441,19,22,0.864,5,28,33,23,10,2,10,24,114,121,2.3,1.0,2022,23,4.56,2.3,48,3,51,0.6470588235294118
2022-23,RegularSeason,1630593,407,McKinley Wright IV,1610612742,DAL,27,335,46,98,0.469,9,28,0.321,13,19,0.684,9,38,47,58,8,5,19,24,114,155,3.05,0.42,2022,23,4.222222222222222,3.0526315789473686,52,6,58,0.8103448275862069
2022-23,RegularSeason,201577,409,Robin Lopez,1610612739,CLE,37,299,48,75,0.64,2,4,0.5,14,18,0.778,23,28,51,19,2,8,25,43,112,136,0.76,0.08,2022,23,3.027027027027027,0.76,27,4,31,1.6451612903225807
2022-23,RegularSeason,1631230,410,Dominick Barlow,1610612759,SAS,28,408,46,86,0.535,0,4,0.0,18,25,0.72,46,56,102,24,10,19,15,56,110,203,1.6,0.67,2022,23,3.9285714285714284,1.6,40,7,47,2.1702127659574466
2022-23,RegularSeason,202397,411,Ish Smith,1610612743,DEN,43,398,52,131,0.397,2,12,0.167,2,4,0.5,5,49,54,100,8,7,44,33,108,152,2.27,0.18,2022,23,2.511627906976744,2.272727272727273,79,2,81,0.6666666666666666
2022-23,RegularSeason,1631222,412,Jake LaRavia,1610612763,MEM,35,414,37,95,0.389,24,71,0.338,7,9,0.778,19,44,63,21,12,4,18,49,105,127,1.17,0.67,2022,23,3.0,1.1666666666666667,58,2,60,1.05
2022-23,RegularSeason,1626246,413,Boban Marjanovic,1610612745,HOU,31,171,41,60,0.683,0,1,0.0,20,27,0.741,20,40,60,9,5,2,14,10,102,138,0.64,0.36,2022,23,3.2903225806451615,0.6428571428571429,19,7,26,2.3076923076923075
2022-23,RegularSeason,1627780,414,Gary Payton II,1610612744,GSW,22,368,41,69,0.594,13,26,0.5,6,7,0.857,24,45,69,30,22,5,16,43,101,182,1.88,1.38,2022,23,4.590909090909091,1.875,28,1,29,2.3793103448275863
2022-23,RegularSeason,1630556,415,Kessler Edwards,1610612758,SAC,36,386,36,93,0.387,17,55,0.309,11,15,0.733,23,38,61,23,14,6,13,40,100,130,1.77,1.08,2022,23,2.7777777777777777,1.7692307692307692,57,4,61,1.0
2022-23,RegularSeason,203469,416,Cody Zeller,1610612748,MIA,15,217,37,59,0.627,0,2,0.0,24,35,0.686,25,39,64,10,3,4,14,33,98,132,0.71,0.21,2022,23,6.533333333333333,0.7142857142857143,22,11,33,1.9393939393939394
2022-23,RegularSeason,1631288,416,Jamal Cain,1610612748,MIA,18,240,37,66,0.561,7,20,0.35,17,22,0.773,15,37,52,12,11,1,6,21,98,134,2.0,1.83,2022,23,5.444444444444445,2.0,29,5,34,1.5294117647058822
2022-23,RegularSeason,1629033,418,Theo Pinson,1610612742,DAL,40,323,31,87,0.356,22,62,0.355,11,13,0.846,10,53,63,46,6,1,12,34,95,141,3.83,0.5,2022,23,2.375,3.8333333333333335,56,2,58,1.0862068965517242
2022-23,RegularSeason,1630219,419,Skylar Mays,1610612757,POR,6,189,34,68,0.5,12,26,0.462,12,13,0.923,2,17,19,50,6,1,10,11,92,123,5.0,0.6,2022,23,15.333333333333334,5.0,34,1,35,0.5428571428571428
2022-23,RegularSeason,1627854,420,Bryn Forbes,1610612750,MIN,25,268,30,83,0.361,14,46,0.304,15,15,1.0,4,11,15,17,7,2,12,22,89,65,1.42,0.58,2022,23,3.56,1.4166666666666667,53,0,53,0.2830188679245283
2022-23,RegularSeason,1628432,420,Davon Reed,1610612747,LAL,43,343,28,84,0.333,17,46,0.37,16,24,0.667,10,49,59,23,15,4,20,39,89,106,1.15,0.75,2022,23,2.0697674418604652,1.15,56,8,64,0.921875
2022-23,RegularSeason,1626163,420,Frank Kaminsky,1610612745,HOU,36,235,31,63,0.492,13,33,0.394,14,16,0.875,7,45,52,32,6,4,9,22,89,140,3.56,0.67,2022,23,2.4722222222222223,3.5555555555555554,32,2,34,1.5294117647058822
2022-23,RegularSeason,1630678,420,Terry Taylor,1610612741,CHI,31,263,39,75,0.52,5,19,0.263,6,11,0.545,27,20,47,10,3,6,9,26,89,105,1.11,0.33,2022,23,2.870967741935484,1.1111111111111112,36,5,41,1.146341463414634
2022-23,RegularSeason,1630548,424,Johnny Juzang,1610612762,UTA,18,232,35,104,0.337,15,63,0.238,2,4,0.5,8,31,39,8,4,3,3,13,87,67,2.67,1.33,2022,23,4.833333333333333,2.6666666666666665,69,2,71,0.5492957746478874
2022-23,RegularSeason,1631207,425,Dalen Terry,1610612741,CHI,38,214,32,72,0.444,7,27,0.259,14,21,0.667,12,25,37,22,11,5,8,24,85,105,2.75,1.38,2022,23,2.236842105263158,2.75,40,7,47,0.7872340425531915
2022-23,RegularSeason,1630561,425,David Duke Jr.,1610612751,BKN,23,228,36,78,0.462,1,12,0.083,12,17,0.706,11,18,29,21,10,1,18,31,85,81,1.17,0.56,2022,23,3.6956521739130435,1.1666666666666667,42,5,47,0.6170212765957447
2022-23,RegularSeason,1631107,427,Nikola Jovic,1610612748,MIA,15,204,28,69,0.406,8,35,0.229,18,19,0.947,9,22,31,10,7,2,10,19,82,80,1.0,0.7,2022,23,5.466666666666667,1.0,41,1,42,0.7380952380952381
2022-23,RegularSeason,1631113,428,Kennedy Chandler,1610612763,MEM,36,282,35,83,0.422,2,15,0.133,6,13,0.462,9,29,38,58,12,5,18,15,78,118,3.22,0.67,2022,23,2.1666666666666665,3.2222222222222223,48,7,55,0.6909090909090909
2022-23,RegularSeason,1631212,429,Peyton Watson,1610612743,DEN,23,186,29,59,0.492,6,14,0.429,11,20,0.55,8,29,37,11,2,11,8,14,75,89,1.38,0.25,2022,23,3.260869565217391,1.375,30,9,39,0.9487179487179487
2022-23,RegularSeason,202689,430,Kemba Walker,1610612742,DAL,9,144,24,57,0.421,7,28,0.25,17,21,0.81,3,13,16,19,2,2,4,11,72,70,4.75,0.5,2022,23,8.0,4.75,33,4,37,0.43243243243243246
2022-23,RegularSeason,1629677,431,Luka Samanic,1610612762,UTA,7,161,26,57,0.456,8,31,0.258,9,13,0.692,0,30,30,15,6,2,10,17,69,77,1.5,0.6,2022,23,9.857142857142858,1.5,31,4,35,0.8571428571428571
2022-23,RegularSeason,201586,432,Serge Ibaka,1610612749,MIL,16,185,26,54,0.481,6,18,0.333,8,13,0.615,15,29,44,4,2,7,11,23,66,79,0.36,0.18,2022,23,4.125,0.36363636363636365,28,5,33,1.3333333333333333
2022-23,RegularSeason,201980,433,Danny Green,1610612739,CLE,11,139,22,49,0.449,16,37,0.432,1,1,1.0,3,11,14,6,6,3,10,16,61,53,0.6,0.6,2022,23,5.545454545454546,0.6,27,0,27,0.5185185185185185
2022-23,RegularSeason,1630288,433,Jeff Dowtin Jr.,1610612761,TOR,25,259,25,57,0.439,5,16,0.313,6,9,0.667,6,17,23,31,9,3,5,13,61,87,6.2,1.8,2022,23,2.44,6.2,32,3,35,0.6571428571428571
2022-23,RegularSeason,1631217,435,Moussa Diabate,1610612746,LAC,22,195,24,47,0.511,1,2,0.5,10,16,0.625,31,19,50,4,7,8,9,15,59,90,0.44,0.78,2022,23,2.6818181818181817,0.4444444444444444,23,6,29,1.7241379310344827
2022-23,RegularSeason,1629603,436,Mamadi Diakite,1610612739,CLE,22,176,24,50,0.48,7,21,0.333,2,2,1.0,8,22,30,8,4,9,12,26,57,70,0.67,0.33,2022,23,2.590909090909091,0.6666666666666666,26,0,26,1.1538461538461537
2022-23,RegularSeason,1630639,437,AJ Lawson,1610612742,DAL,15,108,22,44,0.5,10,25,0.4,2,8,0.25,6,15,21,2,2,0,3,11,56,50,0.67,0.67,2022,23,3.7333333333333334,0.6666666666666666,22,6,28,0.75
2022-23,RegularSeason,1631245,437,Quenton Jackson,1610612764,WAS,9,135,19,42,0.452,1,12,0.083,17,22,0.773,2,6,8,15,4,1,4,10,56,52,3.75,1.0,2022,23,6.222222222222222,3.75,23,5,28,0.2857142857142857
2022-23,RegularSeason,1628371,439,Jonathan Isaac,1610612753,ORL,11,124,22,53,0.415,6,15,0.4,5,9,0.556,15,29,44,6,14,4,4,5,55,84,1.5,3.5,2022,23,5.0,1.5,31,4,35,1.2571428571428571
2022-23,RegularSeason,1631466,440,Nate Williams,1610612757,POR,5,127,24,39,0.615,3,8,0.375,2,3,0.667,10,5,15,10,3,2,4,13,53,63,2.5,0.75,2022,23,10.6,2.5,15,1,16,0.9375
2022-23,RegularSeason,1630235,441,Trent Forrest,1610612737,ATL,23,277,25,60,0.417,0,2,0.0,2,3,0.667,5,32,37,38,7,2,15,17,52,85,2.53,0.47,2022,23,2.260869565217391,2.533333333333333,35,1,36,1.0277777777777777
2022-23,RegularSeason,201949,442,James Johnson,1610612754,IND,18,162,22,49,0.449,3,15,0.2,4,8,0.5,4,26,30,15,7,6,8,32,51,70,1.88,0.88,2022,23,2.8333333333333335,1.875,27,4,31,0.967741935483871
2022-23,RegularSeason,1630643,442,Jay Huff,1610612764,WAS,7,95,15,25,0.6,6,12,0.5,15,16,0.938,6,15,21,10,3,4,5,15,51,73,2.0,0.6,2022,23,7.285714285714286,2.0,10,1,11,1.9090909090909092
2022-23,RegularSeason,203648,442,Thanasis Antetokounmpo,1610612749,MIL,37,206,20,46,0.435,0,8,0.0,11,22,0.5,15,29,44,15,3,3,12,22,51,67,1.25,0.25,2022,23,1.3783783783783783,1.25,26,11,37,1.1891891891891893
2022-23,RegularSeason,202066,445,Garrett Temple,1610612740,NOP,25,162,18,45,0.4,11,26,0.423,3,4,0.75,5,12,17,13,9,2,4,15,50,59,3.25,2.25,2022,23,2.0,3.25,27,1,28,0.6071428571428571
2022-23,RegularSeason,1629623,445,Lindell Wigginton,1610612749,MIL,7,87,18,37,0.486,6,18,0.333,8,9,0.889,0,7,7,14,0,2,12,7,50,41,1.17,0.0,2022,23,7.142857142857143,1.1666666666666667,19,1,20,0.35
2022-23,RegularSeason,1628464,447,Daniel Theis,1610612754,IND,7,109,21,44,0.477,2,11,0.182,5,12,0.417,7,15,22,9,2,6,3,7,49,55,3.0,0.67,2022,23,7.0,3.0,23,7,30,0.7333333333333333
2022-23,RegularSeason,203521,448,Matthew Dellavedova,1610612758,SAC,32,213,17,50,0.34,9,27,0.333,4,7,0.571,1,12,13,41,7,0,10,20,47,62,4.1,0.7,2022,23,1.46875,4.1,33,3,36,0.3611111111111111
2022-23,RegularSeason,1631169,449,Josh Minott,1610612750,MIN,15,96,18,36,0.5,2,6,0.333,8,8,1.0,5,20,25,5,4,6,3,10,46,65,1.67,1.33,2022,23,3.066666666666667,1.6666666666666667,18,0,18,1.3888888888888888
2022-23,RegularSeason,1629644,449,KZ Okpala,1610612758,SAC,35,248,16,38,0.421,7,21,0.333,7,8,0.875,7,27,34,13,7,7,7,39,46,77,1.86,1.0,2022,23,1.3142857142857143,1.8571428571428572,22,1,23,1.4782608695652173
2022-23,RegularSeason,1631197,451,Jared Rhoden,1610612765,DET,14,198,17,44,0.386,5,20,0.25,6,6,1.0,11,26,37,4,4,1,3,23,45,61,1.33,1.33,2022,23,3.2142857142857144,1.3333333333333333,27,0,27,1.3703703703703705
2022-23,RegularSeason,1631219,451,John Butler Jr.,1610612757,POR,19,221,17,53,0.321,8,35,0.229,3,4,0.75,3,14,17,11,7,9,1,22,45,51,11.0,7.0,2022,23,2.3684210526315788,11.0,36,1,37,0.4594594594594595
2022-23,RegularSeason,1630696,453,Dru Smith,1610612751,BKN,15,158,18,45,0.4,5,19,0.263,3,3,1.0,2,22,24,22,10,4,3,23,44,74,7.33,3.33,2022,23,2.933333333333333,7.333333333333333,27,0,27,0.8888888888888888
2022-23,RegularSeason,1629633,453,Jarrett Culver,1610612737,ATL,10,137,17,43,0.395,1,12,0.083,9,13,0.692,10,28,38,6,6,2,7,14,44,59,0.86,0.86,2022,23,4.4,0.8571428571428571,26,4,30,1.2666666666666666
2022-23,RegularSeason,203490,453,Otto Porter Jr.,1610612761,TOR,8,146,15,30,0.5,6,17,0.353,8,8,1.0,6,13,19,8,11,0,4,7,44,63,2.0,2.75,2022,23,5.5,2.0,15,0,15,1.2666666666666666
2022-23,RegularSeason,1627885,453,Shaquille Harrison,1610612747,LAL,5,120,15,36,0.417,3,10,0.3,11,15,0.733,1,21,22,30,11,2,6,12,44,78,5.0,1.83,2022,23,8.8,5.0,21,4,25,0.88
2022-23,RegularSeason,203458,457,Alex Len,1610612758,SAC,26,161,16,30,0.533,0,2,0.0,11,16,0.688,24,36,60,12,4,11,16,28,43,95,0.75,0.25,2022,23,1.6538461538461537,0.75,14,5,19,3.1578947368421053
2022-23,RegularSeason,203920,457,Khem Birch,1610612759,SAS,20,162,19,32,0.594,1,2,0.5,4,5,0.8,8,17,25,7,5,5,8,24,43,63,0.88,0.63,2022,23,2.15,0.875,13,1,14,1.7857142857142858
2022-23,RegularSeason,203086,457,Meyers Leonard,1610612749,MIL,9,114,14,29,0.483,7,18,0.389,8,9,0.889,12,22,34,1,2,0,6,16,43,58,0.17,0.33,2022,23,4.777777777777778,0.16666666666666666,15,1,16,2.125
2022-23,RegularSeason,1630531,460,Jaden Springer,1610612755,PHI,16,89,17,35,0.486,2,5,0.4,6,8,0.75,6,8,14,8,7,3,3,15,42,51,2.67,2.33,2022,23,2.625,2.6666666666666665,18,2,20,0.7
2022-23,RegularSeason,1631111,460,Wendell Moore Jr.,1610612750,MIN,29,153,18,43,0.419,2,17,0.118,4,5,0.8,4,14,18,18,8,5,8,13,42,57,2.25,1.0,2022,23,1.4482758620689655,2.25,25,1,26,0.6923076923076923
2022-23,RegularSeason,1630554,462,Jason Preston,1610612746,LAC,14,124,18,41,0.439,5,18,0.278,0,2,0.0,2,20,22,27,2,0,10,7,41,57,2.7,0.2,2022,23,2.9285714285714284,2.7,23,2,25,0.88
2022-23,RegularSeason,1630209,463,Omer Yurtseven,1610612748,MIA,9,83,16,27,0.593,3,7,0.429,5,6,0.833,8,15,23,2,2,2,4,16,40,53,0.5,0.5,2022,23,4.444444444444445,0.5,11,1,12,1.9166666666666667
2022-23,RegularSeason,1641645,464,Xavier Cooks,1610612764,WAS,10,126,17,28,0.607,0,1,0.0,4,10,0.4,16,22,38,6,6,4,8,13,38,67,0.75,0.75,2022,23,3.8,0.75,11,6,17,2.235294117647059
2022-23,RegularSeason,1630215,465,Jared Butler,1610612760,OKC,6,77,15,32,0.469,7,14,0.5,0,0,0.0,1,3,4,8,5,0,5,5,37,32,1.6,1.0,2022,23,6.166666666666667,1.6,17,0,17,0.23529411764705882
2022-23,RegularSeason,1630846,466,Olivier Sarr,1610612760,OKC,9,114,15,30,0.5,1,8,0.125,5,7,0.714,12,19,31,4,1,5,4,17,36,56,1.0,0.25,2022,23,4.0,1.0,15,2,17,1.8235294117647058
2022-23,RegularSeason,1630249,466,Vit Krejci,1610612737,ATL,29,165,15,37,0.405,5,21,0.238,1,2,0.5,6,20,26,17,5,1,5,17,36,57,3.4,1.0,2022,23,1.2413793103448276,3.4,22,1,23,1.1304347826086956
2022-23,RegularSeason,1628998,468,Cody Martin,1610612766,CHA,7,134,14,36,0.389,3,14,0.214,4,7,0.571,8,16,24,11,4,1,2,13,35,48,5.5,2.0,2022,23,5.0,5.5,22,3,25,0.96
2022-23,RegularSeason,203457,468,Nerlens Noel,1610612751,BKN,17,195,13,36,0.361,1,2,0.5,8,12,0.667,10,36,46,10,16,10,13,32,35,77,0.77,1.23,2022,23,2.0588235294117645,0.7692307692307693,23,4,27,1.7037037037037037
2022-23,RegularSeason,1630600,470,Isaiah Mobley,1610612739,CLE,12,84,12,28,0.429,3,8,0.375,4,4,1.0,4,16,20,3,4,3,1,8,31,44,3.0,4.0,2022,23,2.5833333333333335,3.0,16,0,16,1.25
2022-23,RegularSeason,1631246,471,Vince Williams Jr.,1610612763,MEM,15,105,12,40,0.3,4,28,0.143,2,2,1.0,4,11,15,4,6,2,5,12,30,24,0.8,1.2,2022,23,2.0,0.8,28,0,28,0.5357142857142857
2022-23,RegularSeason,1630535,472,Greg Brown III,1610612757,POR,16,93,11,28,0.393,1,7,0.143,5,12,0.417,2,17,19,3,4,5,6,13,28,29,0.5,0.67,2022,23,1.75,0.5,17,7,24,0.7916666666666666
2022-23,RegularSeason,1631160,472,Jordan Hall,1610612759,SAS,9,83,9,28,0.321,3,15,0.2,7,9,0.778,3,9,12,11,1,0,7,6,28,24,1.57,0.14,2022,23,3.111111111111111,1.5714285714285714,19,2,21,0.5714285714285714
2022-23,RegularSeason,1630563,472,Joshua Primo,1610612759,SAS,4,93,9,26,0.346,3,12,0.25,7,9,0.778,2,11,13,18,1,2,11,8,28,32,1.64,0.09,2022,23,7.0,1.6363636363636365,17,2,19,0.6842105263157895
2022-23,RegularSeason,2617,475,Udonis Haslem,1610612748,MIA,7,72,10,29,0.345,3,9,0.333,4,5,0.8,4,7,11,0,1,2,1,11,27,20,0.0,1.0,2022,23,3.857142857142857,0.0,19,1,20,0.55
2022-23,RegularSeason,1627853,476,Ryan Arcidiacono,1610612757,POR,20,172,9,37,0.243,8,23,0.348,0,0,0.0,0,15,15,23,5,0,7,17,26,34,3.29,0.71,2022,23,1.3,3.2857142857142856,28,0,28,0.5357142857142857
2022-23,RegularSeason,1630644,477,Mac McClung,1610612755,PHI,2,41,9,20,0.45,4,11,0.364,3,5,0.6,3,7,10,9,0,0,3,3,25,28,3.0,0.0,2022,23,12.5,3.0,11,2,13,0.7692307692307693
2022-23,RegularSeason,203943,477,Noah Vonleh,1610612738,BOS,23,172,11,24,0.458,1,4,0.25,2,2,1.0,18,30,48,7,2,8,11,35,25,66,0.64,0.18,2022,23,1.0869565217391304,0.6363636363636364,13,0,13,3.6923076923076925
2022-23,RegularSeason,1630241,477,Sam Merrill,1610612739,CLE,5,59,9,22,0.409,5,18,0.278,2,2,1.0,0,9,9,5,4,0,0,3,25,30,0.0,0.0,2022,23,5.0,inf,13,0,13,0.6923076923076923
2022-23,RegularSeason,1628221,480,Gabe York,1610612754,IND,3,56,8,21,0.381,6,18,0.333,2,2,1.0,0,6,6,5,2,0,0,5,24,24,0.0,0.0,2022,23,8.0,inf,13,0,13,0.46153846153846156
2022-23,RegularSeason,1631165,480,Keon Ellis,1610612758,SAC,16,71,7,16,0.438,6,12,0.5,4,7,0.571,4,4,8,6,5,1,1,10,24,31,6.0,5.0,2022,23,1.5,6.0,9,3,12,0.6666666666666666
2022-23,RegularSeason,1630695,480,Micah Potter,1610612762,UTA,7,52,10,15,0.667,4,7,0.571,0,0,0.0,3,13,16,4,1,0,2,5,24,38,2.0,0.5,2022,23,3.4285714285714284,2.0,5,0,5,3.2
2022-23,RegularSeason,1631157,483,Ryan Rollins,1610612744,GSW,12,62,7,20,0.35,3,9,0.333,6,6,1.0,3,9,12,6,1,1,16,10,23,14,0.38,0.06,2022,23,1.9166666666666667,0.375,13,0,13,0.9230769230769231
2022-23,RegularSeason,1629714,484,Jarrell Brantley,1610612762,UTA,4,39,8,14,0.571,4,9,0.444,2,2,1.0,1,5,6,3,0,2,2,3,22,25,1.5,0.0,2022,23,5.5,1.5,6,0,6,1.0
2022-23,RegularSeason,1628408,484,PJ Dozier,1610612758,SAC,16,79,10,33,0.303,2,16,0.125,0,0,0.0,1,13,14,10,6,1,5,7,22,25,2.0,1.2,2022,23,1.375,2.0,23,0,23,0.6086956521739131
2022-23,RegularSeason,1631298,486,Jack White,1610612743,DEN,17,66,8,19,0.421,3,9,0.333,2,3,0.667,6,11,17,4,3,2,2,9,21,33,2.0,1.5,2022,23,1.2352941176470589,2.0,11,1,12,1.4166666666666667
2022-23,RegularSeason,1630243,486,Trevelin Queen,1610612754,IND,7,70,7,29,0.241,2,15,0.133,5,5,1.0,8,9,17,6,2,5,7,4,21,22,0.86,0.29,2022,23,3.0,0.8571428571428571,22,0,22,0.7727272727272727
2022-23,RegularSeason,1631213,486,Tyrese Martin,1610612737,ATL,16,66,9,23,0.391,1,7,0.143,2,2,1.0,5,7,12,2,1,0,2,2,21,20,1.0,0.5,2022,23,1.3125,1.0,14,0,14,0.8571428571428571
2022-23,RegularSeason,1630637,489,Carlik Jones,1610612741,CHI,7,56,6,15,0.4,3,6,0.5,5,8,0.625,1,4,5,6,2,0,2,2,20,19,3.0,1.0,2022,23,2.857142857142857,3.0,9,3,12,0.4166666666666667
2022-23,RegularSeason,1628382,489,Justin Jackson,1610612738,BOS,23,107,7,27,0.259,5,20,0.25,1,2,0.5,2,15,17,9,4,4,2,7,20,31,4.5,2.0,2022,23,0.8695652173913043,4.5,20,1,21,0.8095238095238095
2022-23,RegularSeason,1629663,489,Louis King,1610612755,PHI,1,29,8,13,0.615,4,8,0.5,0,1,0.0,2,2,4,2,1,0,2,4,20,19,1.0,0.5,2022,23,20.0,1.0,5,1,6,0.6666666666666666
2022-23,RegularSeason,1631199,489,Ron Harper Jr.,1610612761,TOR,9,48,8,16,0.5,3,9,0.333,1,1,1.0,3,4,7,4,0,1,0,3,20,24,0.0,0.0,2022,23,2.2222222222222223,inf,8,0,8,0.875
2022-23,RegularSeason,1631120,493,JD Davison,1610612738,BOS,12,66,8,19,0.421,2,7,0.286,1,2,0.5,2,7,9,11,2,2,4,5,19,27,2.75,0.5,2022,23,1.5833333333333333,2.75,11,1,12,0.75
2022-23,RegularSeason,1628396,493,Tony Bradley,1610612741,CHI,12,33,6,12,0.5,3,5,0.6,4,4,1.0,1,10,11,1,1,1,1,2,19,26,1.0,1.0,2022,23,1.5833333333333333,1.0,6,0,6,1.8333333333333333
2022-23,RegularSeason,2738,495,Andre Iguodala,1610612744,GSW,8,113,7,15,0.467,1,9,0.111,2,3,0.667,3,14,17,19,4,3,9,11,17,42,2.11,0.44,2022,23,2.125,2.111111111111111,8,1,9,1.8888888888888888
2022-23,RegularSeason,1631303,495,Justin Minaya,1610612757,POR,4,89,7,23,0.304,3,12,0.25,0,1,0.0,3,12,15,4,2,5,4,9,17,22,1.0,0.5,2022,23,4.25,1.0,16,1,17,0.8823529411764706
2022-23,RegularSeason,203487,495,Michael Carter-Williams,1610612753,ORL,4,44,6,14,0.429,1,3,0.333,4,7,0.571,1,4,5,7,1,1,4,5,17,16,1.75,0.25,2022,23,4.25,1.75,8,3,11,0.45454545454545453
2022-23,RegularSeason,1630270,495,Xavier Sneed,1610612766,CHA,4,48,5,10,0.5,3,6,0.5,4,4,1.0,0,5,5,5,0,1,3,7,17,20,1.67,0.0,2022,23,4.25,1.6666666666666667,5,0,5,1.0
2022-23,RegularSeason,1631205,499,Buddy Boeheim,1610612765,DET,10,90,5,27,0.185,4,25,0.16,2,2,1.0,2,4,6,4,2,0,0,6,16,6,0.0,0.0,2022,23,1.6,inf,22,0,22,0.2727272727272727
2022-23,RegularSeason,1630564,499,RaiQuan Gray,1610612751,BKN,1,35,6,12,0.5,2,5,0.4,2,2,1.0,3,6,9,7,0,1,4,5,16,23,1.75,0.0,2022,23,16.0,1.75,6,0,6,1.5
2022-23,RegularSeason,1630620,501,Darius Days,1610612745,HOU,4,25,5,12,0.417,3,10,0.3,2,2,1.0,1,5,6,1,0,1,0,2,15,16,0.0,0.0,2022,23,3.75,inf,7,0,7,0.8571428571428571
2022-23,RegularSeason,1631123,501,Jamaree Bouyea,1610612764,WAS,5,71,6,14,0.429,2,6,0.333,1,2,0.5,1,5,6,4,4,2,4,6,15,18,1.0,1.0,2022,23,3.0,1.0,8,1,9,0.6666666666666666
2022-23,RegularSeason,1630590,503,Scotty Pippen Jr.,1610612747,LAL,6,32,4,12,0.333,1,3,0.333,5,9,0.556,2,2,4,2,2,1,2,3,14,9,1.0,1.0,2022,23,2.3333333333333335,1.0,8,4,12,0.3333333333333333
2022-23,RegularSeason,1630206,504,Jay Scrubb,1610612753,ORL,2,30,5,7,0.714,2,2,1.0,1,2,0.5,0,6,6,1,2,0,3,2,13,16,0.33,0.67,2022,23,6.5,0.3333333333333333,2,1,3,2.0
2022-23,RegularSeason,1629674,505,Neemias Queta,1610612758,SAC,5,29,6,9,0.667,0,0,0.0,0,2,0.0,5,6,11,1,0,2,1,7,12,20,1.0,0.0,2022,23,2.4,1.0,3,2,5,2.2
2022-23,RegularSeason,1630551,506,Justin Champagnie,1610612738,BOS,5,34,5,15,0.333,1,5,0.2,0,0,0.0,3,5,8,4,1,0,0,2,11,14,0.0,0.0,2022,23,2.2,inf,10,0,10,0.8
2022-23,RegularSeason,1630267,507,Facundo Campazzo,1610612742,DAL,8,52,3,13,0.231,3,11,0.273,1,2,0.5,0,2,2,9,6,0,3,3,10,13,3.0,2.0,2022,23,1.25,3.0,10,1,11,0.18181818181818182
2022-23,RegularSeason,1631311,507,Lester Quinones,1610612744,GSW,4,18,2,5,0.4,2,4,0.5,4,6,0.667,1,2,3,2,1,0,5,0,10,6,0.4,0.2,2022,23,2.5,0.4,3,2,5,0.6
2022-23,RegularSeason,1631306,509,Cole Swider,1610612747,LAL,7,41,3,9,0.333,3,8,0.375,0,0,0.0,1,6,7,4,0,0,0,3,9,14,0.0,0.0,2022,23,1.2857142857142858,inf,6,0,6,1.1666666666666667
2022-23,RegularSeason,1630225,509,Isaiah Todd,1610612764,WAS,6,61,3,19,0.158,1,10,0.1,2,2,1.0,2,10,12,4,1,0,2,4,9,8,2.0,0.5,2022,23,1.5,2.0,16,0,16,0.75
2022-23,RegularSeason,1630580,509,Joe Wieskamp,1610612761,TOR,9,50,3,14,0.214,3,12,0.25,0,0,0.0,0,4,4,3,0,0,1,3,9,4,3.0,0.0,2022,23,1.0,3.0,11,0,11,0.36363636363636365
2022-23,RegularSeason,1631112,509,Kendall Brown,1610612754,IND,6,40,4,7,0.571,0,1,0.0,1,2,0.5,2,4,6,3,4,0,2,9,9,16,1.5,2.0,2022,23,1.5,1.5,3,1,4,1.5
2022-23,RegularSeason,1631309,509,Trevor Hudgins,1610612745,HOU,5,28,2,9,0.222,2,8,0.25,3,3,1.0,0,0,0,3,0,0,1,1,9,4,3.0,0.0,2022,23,1.8,3.0,7,0,7,0.0
2022-23,RegularSeason,1628416,509,Tyler Dorsey,1610612742,DAL,3,8,4,5,0.8,1,2,0.5,0,0,0.0,1,1,2,0,0,0,0,0,9,10,0.0,0.0,2022,23,3.0,,1,0,1,2.0
2022-23,RegularSeason,1628993,515,Alize Johnson,1610612759,SAS,4,30,3,6,0.5,0,2,0.0,1,2,0.5,2,8,10,1,1,0,4,3,7,11,0.25,0.25,2022,23,1.75,0.25,3,1,4,2.5
2022-23,RegularSeason,1628435,515,Chance Comanche,1610612757,POR,1,21,3,5,0.6,0,0,0.0,1,4,0.25,2,1,3,0,0,1,0,0,7,6,0.0,0.0,2022,23,7.0,,2,3,5,0.6
2022-23,RegularSeason,1629875,515,Xavier Moon,1610612746,LAC,4,20,3,9,0.333,1,3,0.333,0,0,0.0,0,3,3,5,0,0,1,2,7,8,5.0,0.0,2022,23,1.75,5.0,6,0,6,0.5
2022-23,RegularSeason,1630195,518,Leandro Bolmaro,1610612762,UTA,14,68,3,20,0.15,0,4,0.0,0,0,0.0,4,3,7,7,3,1,7,10,6,0,1.0,0.43,2022,23,0.42857142857142855,1.0,17,0,17,0.4117647058823529
2022-23,RegularSeason,1630250,518,Marko Simonovic,1610612741,CHI,7,20,2,7,0.286,1,4,0.25,1,2,0.5,1,1,2,0,0,0,0,5,6,2,0.0,0.0,2022,23,0.8571428571428571,,5,1,6,0.3333333333333333
2022-23,RegularSeason,1629662,518,Mfiondu Kabengele,1610612738,BOS,4,36,2,7,0.286,0,3,0.0,2,2,1.0,5,5,10,0,2,0,1,3,6,12,0.0,2.0,2022,23,1.5,0.0,5,0,5,2.0
2022-23,RegularSeason,1630176,518,Vernon Carey Jr.,1610612762,UTA,11,28,2,8,0.25,0,0,0.0,2,2,1.0,3,8,11,3,2,2,2,5,6,16,1.5,1.0,2022,23,0.5454545454545454,1.5,6,0,6,1.8333333333333333
2022-23,RegularSeason,1629685,522,Dylan Windler,1610612739,CLE,3,10,2,3,0.667,1,2,0.5,0,0,0.0,0,0,0,1,1,0,1,0,5,5,1.0,1.0,2022,23,1.6666666666666667,1.0,1,0,1,0.0
2022-23,RegularSeason,1628424,522,Kobi Simmons,1610612766,CHA,5,28,1,6,0.167,1,5,0.2,2,2,1.0,1,3,4,5,0,2,1,0,5,10,5.0,0.0,2022,23,1.0,5.0,5,0,5,0.8
2022-23,RegularSeason,1630792,522,Malcolm Hill,1610612741,CHI,5,9,2,4,0.5,1,3,0.333,0,0,0.0,0,3,3,0,0,0,0,1,5,6,0.0,0.0,2022,23,1.0,,2,0,2,1.5
2022-23,RegularSeason,1630296,525,Braxton Key,1610612765,DET,3,9,1,1,1.0,0,0,0.0,2,2,1.0,0,1,1,0,0,0,0,0,4,5,0.0,0.0,2022,23,1.3333333333333333,,0,0,0,inf
2022-23,RegularSeason,1631220,525,Dereon Seabron,1610612740,NOP,5,12,2,5,0.4,0,0,0.0,0,0,0.0,1,0,1,0,0,0,0,1,4,2,0.0,0.0,2022,23,0.8,,3,0,3,0.3333333333333333
2022-23,RegularSeason,1631495,525,Donovan Williams,1610612737,ATL,2,4,2,5,0.4,0,2,0.0,0,0,0.0,0,2,2,0,0,0,0,0,4,3,0.0,0.0,2022,23,2.0,,3,0,3,0.6666666666666666
2022-23,RegularSeason,1629653,528,Devon Dotson,1610612764,WAS,6,53,1,10,0.1,1,4,0.25,0,0,0.0,6,4,10,8,5,0,3,9,3,14,2.67,1.67,2022,23,0.5,2.6666666666666665,9,0,9,1.1111111111111112
2022-23,RegularSeason,1631367,528,Jacob Gilyard,1610612763,MEM,1,41,1,3,0.333,1,3,0.333,0,0,0.0,0,4,4,7,3,0,2,3,3,13,3.5,1.5,2022,23,3.0,3.5,2,0,2,2.0
2022-23,RegularSeason,1630648,528,Jordan Schakel,1610612764,WAS,2,6,1,2,0.5,1,1,1.0,0,0,0.0,0,0,0,1,1,0,0,1,3,4,0.0,0.0,2022,23,1.5,inf,1,0,1,0.0
2022-23,RegularSeason,1631211,528,Trevor Keels,1610612752,NYK,3,8,1,4,0.25,1,4,0.25,0,0,0.0,0,2,2,0,0,0,0,0,3,2,0.0,0.0,2022,23,1.0,,3,0,3,0.6666666666666666
2022-23,RegularSeason,1631320,532,Chima Moneke,1610612758,SAC,2,8,1,2,0.5,0,0,0.0,0,2,0.0,2,0,2,1,0,0,2,2,2,0,0.5,0.0,2022,23,1.0,0.5,1,2,3,0.6666666666666666
2022-23,RegularSeason,1629735,532,Chris Silva,1610612742,DAL,1,3,1,1,1.0,0,0,0.0,0,0,0.0,0,0,0,0,0,0,1,2,2,1,0.0,0.0,2022,23,2.0,0.0,0,0,0,
2022-23,RegularSeason,1630649,532,Stanley Umude,1610612765,DET,1,2,0,1,0.0,0,1,0.0,2,2,1.0,0,0,0,0,1,1,0,0,2,3,0.0,0.0,2022,23,2.0,,1,0,1,0.0
2022-23,RegularSeason,1631214,535,Alondes Williams,1610612751,BKN,1,5,0,0,0.0,0,0,0.0,0,0,0.0,0,1,1,0,0,0,2,1,0,-1,0.0,0.0,2022,23,0.0,0.0,0,0,0,inf
2022-23,RegularSeason,1629126,535,Deonte Burton,1610612758,SAC,2,7,0,2,0.0,0,1,0.0,0,0,0.0,0,0,0,0,0,0,0,0,0,-2,0.0,0.0,2022,23,0.0,,2,0,2,0.0
2022-23,RegularSeason,1628402,535,Frank Jackson,1610612762,UTA,1,5,0,3,0.0,0,1,0.0,0,0,0.0,1,1,2,1,0,0,0,0,0,0,0.0,0.0,2022,23,0.0,inf,3,0,3,0.6666666666666666
2022-23,RegularSeason,1630701,535,Michael Foster Jr.,1610612755,PHI,1,1,0,0,0.0,0,0,0.0,0,0,0.0,0,0,0,0,0,0,0,0,0,0,0.0,0.0,2022,23,0.0,,0,0,0,
2022-23,RegularSeason,1628425,535,Sterling Brown,1610612747,LAL,4,24,0,4,0.0,0,2,0.0,0,0,0.0,3,5,8,2,3,0,0,4,0,9,0.0,0.0,2022,23,0.0,inf,4,0,4,2.0
2022-23,Playoffs,203999,1,Nikola Jokic,1610612743,DEN,20,789,227,414,0.548,35,76,0.461,111,139,0.799,69,200,269,190,21,20,70,69,600,815,2.71,0.3,2022,23,30.0,2.7142857142857144,187,28,215,1.2511627906976743
2022-23,Playoffs,202710,2,Jimmy Butler,1610612748,MIA,22,874,207,442,0.468,28,78,0.359,150,186,0.806,47,95,142,129,40,14,41,37,592,605,3.15,0.98,2022,23,26.90909090909091,3.1463414634146343,235,36,271,0.5239852398523985
2022-23,Playoffs,1628369,3,Jayson Tatum,1610612738,BOS,20,799,185,404,0.458,53,164,0.323,120,137,0.876,26,184,210,105,21,21,56,44,543,608,1.88,0.38,2022,23,27.15,1.875,219,17,236,0.8898305084745762
2022-23,Playoffs,1627750,4,Jamal Murray,1610612743,DEN,20,799,194,410,0.473,59,149,0.396,75,81,0.926,15,98,113,142,30,5,50,41,522,540,2.84,0.6,2022,23,26.1,2.84,216,6,222,0.509009009009009
2022-23,Playoffs,1627759,5,Jaylen Brown,1610612738,BOS,20,751,181,365,0.496,40,113,0.354,51,74,0.689,25,87,112,68,21,8,66,61,453,389,1.03,0.32,2022,23,22.65,1.0303030303030303,184,23,207,0.5410628019323671
2022-23,Playoffs,1628389,6,Bam Adebayo,1610612748,MIA,23,850,167,347,0.481,0,3,0.0,78,95,0.821,63,164,227,85,19,15,62,71,412,499,1.37,0.31,2022,23,17.91304347826087,1.3709677419354838,180,17,197,1.1522842639593909
2022-23,Playoffs,201939,7,Stephen Curry,1610612744,GSW,13,493,145,311,0.466,57,157,0.363,49,58,0.845,9,58,67,79,13,6,42,34,396,344,1.88,0.31,2022,23,30.46153846153846,1.880952380952381,166,9,175,0.38285714285714284
2022-23,Playoffs,2544,8,LeBron James,1610612747,LAL,16,619,147,295,0.498,28,106,0.264,70,92,0.761,25,133,158,104,17,18,40,28,392,479,2.6,0.42,2022,23,24.5,2.6,148,22,170,0.9294117647058824
2022-23,Playoffs,1626164,9,Devin Booker,1610612756,PHX,11,459,141,241,0.585,31,61,0.508,58,67,0.866,12,41,53,79,19,9,32,37,371,390,2.47,0.59,2022,23,33.72727272727273,2.46875,100,9,109,0.48623853211009177
2022-23,Playoffs,203076,10,Anthony Davis,1610612747,LAL,16,608,132,254,0.52,5,15,0.333,92,108,0.852,38,187,225,41,22,50,34,46,361,527,1.21,0.65,2022,23,22.5625,1.2058823529411764,122,16,138,1.6304347826086956
2022-23,Playoffs,201142,11,Kevin Durant,1610612756,PHX,11,466,107,224,0.478,17,51,0.333,88,96,0.917,7,89,96,61,9,15,39,29,319,336,1.56,0.23,2022,23,29.0,1.564102564102564,117,8,125,0.768
2022-23,Playoffs,1628973,12,Jalen Brunson,1610612752,NYK,11,443,109,230,0.474,26,80,0.325,62,68,0.912,9,45,54,62,16,1,23,26,306,289,2.7,0.7,2022,23,27.818181818181817,2.6956521739130435,121,6,127,0.4251968503937008
2022-23,Playoffs,203935,13,Marcus Smart,1610612738,BOS,20,679,101,223,0.453,44,122,0.361,52,65,0.8,21,59,80,101,25,5,45,37,298,329,2.24,0.56,2022,23,14.9,2.2444444444444445,122,13,135,0.5925925925925926
2022-23,Playoffs,1628997,14,Caleb Martin,1610612748,MIA,23,694,109,206,0.529,44,104,0.423,29,35,0.829,27,98,125,36,20,9,24,55,291,354,1.5,0.83,2022,23,12.652173913043478,1.5,97,6,103,1.2135922330097086
2022-23,Playoffs,1629216,15,Gabe Vincent,1610612748,MIA,22,672,99,246,0.402,51,135,0.378,30,34,0.882,8,23,31,78,19,4,31,66,279,229,2.52,0.61,2022,23,12.681818181818182,2.5161290322580645,147,4,151,0.2052980132450331
2022-23,Playoffs,1630559,16,Austin Reaves,1610612747,LAL,16,579,90,194,0.464,39,88,0.443,51,57,0.895,20,51,71,73,10,3,25,39,270,292,2.92,0.4,2022,23,16.875,2.92,104,6,110,0.6454545454545455
2022-23,Playoffs,1628401,17,Derrick White,1610612738,BOS,20,593,93,184,0.505,50,110,0.455,31,34,0.912,13,46,59,42,12,20,18,38,267,288,2.33,0.67,2022,23,13.35,2.3333333333333335,91,3,94,0.6276595744680851
2022-23,Playoffs,1629008,17,Michael Porter Jr.,1610612743,DEN,20,653,99,234,0.423,46,131,0.351,23,29,0.793,20,142,162,31,10,11,9,42,267,331,3.44,1.11,2022,23,13.35,3.4444444444444446,135,6,141,1.148936170212766
2022-23,Playoffs,203932,19,Aaron Gordon,1610612743,DEN,20,713,101,195,0.518,18,46,0.391,45,69,0.652,49,71,120,52,11,13,20,58,265,323,2.6,0.55,2022,23,13.25,2.6,94,24,118,1.0169491525423728
2022-23,Playoffs,202691,20,Klay Thompson,1610612744,GSW,13,468,85,219,0.388,50,136,0.368,21,24,0.875,1,53,54,29,7,4,26,28,241,172,1.11,0.27,2022,23,18.53846153846154,1.1153846153846154,134,3,137,0.39416058394160586
2022-23,Playoffs,1628971,21,Bruce Brown,1610612743,DEN,20,532,90,176,0.511,18,57,0.316,42,49,0.857,15,65,80,38,21,9,23,49,240,272,1.65,0.91,2022,23,12.0,1.6521739130434783,86,7,93,0.8602150537634409
2022-23,Playoffs,1627763,22,Malcolm Brogdon,1610612738,BOS,19,473,82,196,0.418,33,87,0.379,29,35,0.829,13,53,66,55,3,5,19,29,226,216,2.9,0.16,2022,23,11.894736842105264,2.8947368421052633,114,6,120,0.55
2022-23,Playoffs,1630178,22,Tyrese Maxey,1610612755,PHI,11,423,82,192,0.427,34,85,0.4,28,31,0.903,9,44,53,25,15,5,8,26,226,203,3.13,1.88,2022,23,20.545454545454547,3.125,110,3,113,0.4690265486725664
2022-23,Playoffs,201935,24,James Harden,1610612755,PHI,11,427,72,183,0.393,31,82,0.378,48,55,0.873,6,62,68,91,20,4,35,28,223,253,2.6,0.57,2022,23,20.272727272727273,2.6,111,7,118,0.576271186440678
2022-23,Playoffs,203952,25,Andrew Wiggins,1610612744,GSW,13,442,83,181,0.459,19,64,0.297,32,47,0.681,24,49,73,25,11,15,17,45,217,211,1.47,0.65,2022,23,16.692307692307693,1.4705882352941178,98,15,113,0.6460176991150443
2022-23,Playoffs,1629622,26,Max Strus,1610612748,MIA,23,647,76,189,0.402,43,135,0.319,20,25,0.8,14,69,83,33,8,7,6,47,215,222,5.5,1.33,2022,23,9.347826086956522,5.5,113,5,118,0.7033898305084746
2022-23,Playoffs,1626156,27,D'Angelo Russell,1610612747,LAL,16,473,83,195,0.426,27,87,0.31,20,26,0.769,10,37,47,74,11,5,29,32,213,203,2.55,0.38,2022,23,13.3125,2.5517241379310347,112,6,118,0.3983050847457627
2022-23,Playoffs,203954,27,Joel Embiid,1610612755,PHI,9,336,66,153,0.431,5,28,0.179,76,84,0.905,16,72,88,24,6,25,35,27,213,226,0.69,0.17,2022,23,23.666666666666668,0.6857142857142857,87,8,95,0.9263157894736842
2022-23,Playoffs,203484,29,Kentavious Caldwell-Pope,1610612743,DEN,20,671,74,162,0.457,35,92,0.38,29,35,0.829,14,51,65,31,26,13,15,48,212,238,2.07,1.73,2022,23,10.6,2.066666666666667,88,6,94,0.6914893617021277
2022-23,Playoffs,200768,29,Kyle Lowry,1610612748,MIA,23,599,74,174,0.425,33,88,0.375,31,33,0.939,12,69,81,101,24,14,40,59,212,290,2.52,0.6,2022,23,9.217391304347826,2.525,100,2,102,0.7941176470588235
2022-23,Playoffs,1629628,29,RJ Barrett,1610612752,NYK,11,377,71,164,0.433,20,61,0.328,50,65,0.769,5,44,49,31,9,2,25,25,212,170,1.24,0.36,2022,23,19.272727272727273,1.24,93,15,108,0.4537037037037037
2022-23,Playoffs,1629130,32,Duncan Robinson,1610612748,MIA,23,419,75,158,0.475,50,113,0.442,7,8,0.875,1,33,34,39,8,3,20,36,207,187,1.95,0.4,2022,23,9.0,1.95,83,1,84,0.40476190476190477
2022-23,Playoffs,1629060,33,Rui Hachimura,1610612747,LAL,16,388,73,131,0.557,19,39,0.487,30,34,0.882,9,49,58,10,8,4,10,25,195,203,1.0,0.8,2022,23,12.1875,1.0,58,4,62,0.9354838709677419
2022-23,Playoffs,1628368,34,De'Aaron Fox,1610612758,SAC,7,270,70,165,0.424,21,63,0.333,31,41,0.756,12,26,38,54,15,4,28,23,192,170,1.93,0.54,2022,23,27.428571428571427,1.9285714285714286,95,10,105,0.3619047619047619
2022-23,Playoffs,1629027,35,Trae Young,1610612737,ATL,6,230,60,149,0.403,18,54,0.333,37,43,0.86,5,17,22,61,10,4,24,11,175,153,2.54,0.42,2022,23,29.166666666666668,2.5416666666666665,89,6,95,0.23157894736842105
2022-23,Playoffs,202699,36,Tobias Harris,1610612755,PHI,11,392,70,134,0.522,15,41,0.366,13,15,0.867,17,63,80,18,7,6,8,28,168,205,2.25,0.88,2022,23,15.272727272727273,2.25,64,2,66,1.2121212121212122
2022-23,Playoffs,203944,37,Julius Randle,1610612752,NYK,10,330,55,147,0.374,17,66,0.258,39,55,0.709,17,66,83,36,5,3,35,24,166,150,1.03,0.14,2022,23,16.6,1.0285714285714285,92,16,108,0.7685185185185185
2022-23,Playoffs,1630162,38,Anthony Edwards,1610612750,MIN,5,199,55,114,0.482,15,43,0.349,33,39,0.846,3,22,25,26,9,10,8,13,158,155,3.25,1.13,2022,23,31.6,3.25,59,6,65,0.38461538461538464
2022-23,Playoffs,1629057,39,Robert Williams III,1610612738,BOS,20,417,67,85,0.788,0,1,0.0,19,28,0.679,36,83,119,19,9,25,16,44,153,282,1.19,0.56,2022,23,7.65,1.1875,18,9,27,4.407407407407407
2022-23,Playoffs,1630217,40,Desmond Bane,1610612763,MEM,6,231,49,116,0.422,16,50,0.32,27,29,0.931,7,29,36,19,3,0,17,19,141,113,1.12,0.18,2022,23,23.5,1.1176470588235294,67,2,69,0.5217391304347826
2022-23,Playoffs,201567,41,Kevin Love,1610612748,MIA,20,359,45,119,0.378,33,88,0.375,14,16,0.875,14,97,111,24,9,7,10,35,137,202,2.4,0.9,2022,23,6.85,2.4,74,2,76,1.4605263157894737
2022-23,Playoffs,1629028,42,Deandre Ayton,1610612756,PHX,10,319,61,111,0.55,0,0,0.0,12,23,0.522,29,68,97,10,6,7,17,35,134,176,0.59,0.35,2022,23,13.4,0.5882352941176471,50,11,61,1.5901639344262295
2022-23,Playoffs,1629673,42,Jordan Poole,1610612744,GSW,13,284,46,135,0.341,16,63,0.254,26,34,0.765,4,24,28,46,10,3,15,32,134,109,3.07,0.67,2022,23,10.307692307692308,3.066666666666667,89,8,97,0.28865979381443296
2022-23,Playoffs,201143,44,Al Horford,1610612738,BOS,20,617,51,132,0.386,28,94,0.298,3,4,0.75,30,113,143,59,22,34,11,47,133,298,5.36,2.0,2022,23,6.65,5.363636363636363,81,1,82,1.7439024390243902
2022-23,Playoffs,1628370,44,Malik Monk,1610612758,SAC,7,205,38,93,0.409,13,39,0.333,44,49,0.898,6,32,38,25,5,3,14,15,133,130,1.79,0.36,2022,23,19.0,1.7857142857142858,55,5,60,0.6333333333333333
2022-23,Playoffs,1629630,46,Ja Morant,1610612763,MEM,5,187,45,106,0.425,13,31,0.419,20,26,0.769,8,26,34,35,9,1,17,12,123,118,2.06,0.53,2022,23,24.6,2.0588235294117645,61,6,67,0.5074626865671642
2022-23,Playoffs,203114,47,Khris Middleton,1610612749,MIL,5,173,40,86,0.465,13,32,0.406,26,30,0.867,7,25,32,31,3,0,17,15,119,118,1.82,0.18,2022,23,23.8,1.8235294117647058,46,4,50,0.64
2022-23,Playoffs,203471,48,Dennis Schroder,1610612747,LAL,16,417,41,103,0.398,13,39,0.333,23,28,0.821,3,28,31,46,16,3,20,40,118,127,2.3,0.8,2022,23,7.375,2.3,62,5,67,0.4626865671641791
2022-23,Playoffs,201566,48,Russell Westbrook,1610612746,LAC,5,192,43,105,0.41,10,28,0.357,22,25,0.88,9,29,38,37,6,7,20,15,118,121,1.85,0.3,2022,23,23.6,1.85,62,3,65,0.5846153846153846
2022-23,Playoffs,1628378,50,Donovan Mitchell,1610612739,CLE,5,207,45,104,0.433,13,45,0.289,13,18,0.722,3,22,25,36,10,3,19,14,116,107,1.9,0.53,2022,23,23.2,1.894736842105263,59,5,64,0.390625
2022-23,Playoffs,1627749,51,Dejounte Murray,1610612737,ATL,5,190,46,103,0.447,14,37,0.378,9,9,1.0,9,27,36,34,10,1,10,7,115,129,3.4,1.0,2022,23,23.0,3.4,57,0,57,0.631578947368421
2022-23,Playoffs,1627734,51,Domantas Sabonis,1610612758,SAC,7,243,49,99,0.495,1,5,0.2,16,28,0.571,31,46,77,33,10,6,26,28,115,153,1.27,0.39,2022,23,16.428571428571427,1.2692307692307692,50,12,62,1.2419354838709677
2022-23,Playoffs,1628404,53,Josh Hart,1610612752,NYK,11,353,45,94,0.479,10,32,0.313,14,22,0.636,18,63,81,24,9,3,21,38,114,153,1.14,0.43,2022,23,10.363636363636363,1.1428571428571428,49,8,57,1.4210526315789473
2022-23,Playoffs,203110,54,Draymond Green,1610612744,GSW,12,367,42,91,0.462,5,20,0.25,24,33,0.727,19,64,83,82,18,12,27,48,113,223,3.04,0.67,2022,23,9.416666666666666,3.037037037037037,49,9,58,1.4310344827586208
2022-23,Playoffs,1626181,55,Norman Powell,1610612746,LAC,5,167,36,76,0.474,13,32,0.406,24,31,0.774,4,11,15,11,4,2,8,16,109,86,1.38,0.5,2022,23,21.8,1.375,40,7,47,0.3191489361702128
2022-23,Playoffs,1628991,56,Jaren Jackson Jr.,1610612763,MEM,6,220,35,83,0.422,7,25,0.28,31,36,0.861,20,27,47,9,6,12,18,24,108,111,0.5,0.33,2022,23,18.0,0.5,48,5,53,0.8867924528301887
2022-23,Playoffs,1629636,57,Darius Garland,1610612739,CLE,5,189,35,80,0.438,12,31,0.387,21,25,0.84,0,9,9,25,8,1,18,17,103,79,1.39,0.44,2022,23,20.6,1.3888888888888888,45,4,49,0.1836734693877551
2022-23,Playoffs,1629631,58,De'Andre Hunter,1610612737,ATL,6,224,39,85,0.459,14,38,0.368,8,10,0.8,7,27,34,7,4,2,9,20,100,90,0.78,0.44,2022,23,16.666666666666668,0.7777777777777778,46,2,48,0.7083333333333334
2022-23,Playoffs,201572,59,Brook Lopez,1610612749,MIL,5,182,39,67,0.582,7,17,0.412,10,13,0.769,14,18,32,6,7,9,11,10,95,107,0.55,0.64,2022,23,19.0,0.5454545454545454,28,3,31,1.032258064516129
2022-23,Playoffs,1628969,60,Mikal Bridges,1610612751,BKN,4,157,33,77,0.429,10,25,0.4,18,23,0.783,2,19,21,16,2,2,8,5,94,78,2.0,0.25,2022,23,23.5,2.0,44,5,49,0.42857142857142855
2022-23,Playoffs,1626157,61,Karl-Anthony Towns,1610612750,MIN,5,180,32,70,0.457,6,24,0.25,21,28,0.75,6,45,51,10,3,4,18,21,91,96,0.56,0.17,2022,23,18.2,0.5555555555555556,38,7,45,1.1333333333333333
2022-23,Playoffs,201950,62,Jrue Holiday,1610612749,MIL,5,191,34,85,0.4,12,42,0.286,9,13,0.692,4,29,33,40,5,2,12,12,89,102,3.33,0.42,2022,23,17.8,3.3333333333333335,51,4,55,0.6
2022-23,Playoffs,101108,63,Chris Paul,1610612756,PHX,7,250,38,91,0.418,9,28,0.321,2,4,0.5,5,30,35,52,12,5,7,16,87,129,7.43,1.71,2022,23,12.428571428571429,7.428571428571429,53,2,55,0.6363636363636364
2022-23,Playoffs,1629001,63,De'Anthony Melton,1610612755,PHI,11,274,31,81,0.383,19,49,0.388,6,8,0.75,14,22,36,18,13,9,8,20,87,103,2.25,1.63,2022,23,7.909090909090909,2.25,50,2,52,0.6923076923076923
2022-23,Playoffs,1626172,65,Kevon Looney,1610612744,GSW,13,325,37,64,0.578,0,0,0.0,10,18,0.556,61,109,170,43,8,5,13,36,84,262,3.31,0.61,2022,23,6.461538461538462,3.3076923076923075,27,8,35,4.857142857142857
2022-23,Playoffs,1627780,66,Gary Payton II,1610612744,GSW,12,191,36,54,0.667,4,15,0.267,6,9,0.667,22,22,44,9,8,6,11,19,82,117,0.82,0.73,2022,23,6.833333333333333,0.8181818181818182,18,3,21,2.0952380952380953
2022-23,Playoffs,201145,66,Jeff Green,1610612743,DEN,20,343,28,62,0.452,9,28,0.321,17,19,0.895,6,25,31,14,5,7,9,43,82,94,1.56,0.56,2022,23,4.1,1.5555555555555556,34,2,36,0.8611111111111112
2022-23,Playoffs,203992,68,Bogdan Bogdanovic,1610612737,ATL,6,157,30,54,0.556,15,33,0.455,5,7,0.714,2,16,18,15,6,5,3,16,80,95,5.0,2.0,2022,23,13.333333333333334,5.0,24,2,26,0.6923076923076923
2022-23,Playoffs,1629022,68,Lonnie Walker IV,1610612747,LAL,13,179,29,60,0.483,13,34,0.382,9,12,0.75,1,11,12,11,7,1,4,16,80,73,2.75,1.75,2022,23,6.153846153846154,2.75,31,3,34,0.35294117647058826
2022-23,Playoffs,1630167,70,Obi Toppin,1610612752,NYK,11,175,30,70,0.429,13,43,0.302,4,5,0.8,10,29,39,7,8,3,8,12,77,85,0.88,1.0,2022,23,7.0,0.875,40,1,41,0.9512195121951219
2022-23,Playoffs,1629684,71,Grant Williams,1610612738,BOS,15,265,25,53,0.472,18,40,0.45,8,10,0.8,11,22,33,18,5,6,4,25,76,104,4.5,1.25,2022,23,5.066666666666666,4.5,28,2,30,1.1
2022-23,Playoffs,1627747,72,Caris LeVert,1610612739,CLE,5,170,27,63,0.429,13,36,0.361,8,13,0.615,4,19,23,13,2,1,5,10,75,68,2.6,0.4,2022,23,15.0,2.6,36,5,41,0.5609756097560976
2022-23,Playoffs,203084,72,Harrison Barnes,1610612758,SAC,7,197,25,60,0.417,6,25,0.24,19,26,0.731,10,14,24,5,8,2,3,5,75,69,1.67,2.67,2022,23,10.714285714285714,1.6666666666666667,35,7,42,0.5714285714285714
2022-23,Playoffs,203497,72,Rudy Gobert,1610612750,MIN,5,177,29,46,0.63,0,0,0.0,17,27,0.63,18,43,61,10,2,5,8,24,75,118,1.25,0.25,2022,23,15.0,1.25,17,10,27,2.259259259259259
2022-23,Playoffs,1629661,75,Cameron Johnson,1610612751,BKN,4,152,28,55,0.509,12,28,0.429,6,7,0.857,3,20,23,11,3,1,5,10,74,79,2.2,0.6,2022,23,18.5,2.2,27,1,28,0.8214285714285714
2022-23,Playoffs,1630193,76,Immanuel Quickley,1610612752,NYK,8,175,23,66,0.348,9,37,0.243,17,20,0.85,2,11,13,8,4,0,9,11,72,42,0.89,0.44,2022,23,9.0,0.8888888888888888,43,3,46,0.2826086956521739
2022-23,Playoffs,1628978,77,Donte DiVincenzo,1610612744,GSW,13,235,24,64,0.375,15,44,0.341,8,12,0.667,11,28,39,36,11,3,17,20,71,99,2.12,0.65,2022,23,5.461538461538462,2.1176470588235294,40,4,44,0.8863636363636364
2022-23,Playoffs,1629011,77,Mitchell Robinson,1610612752,NYK,11,298,29,48,0.604,0,0,0.0,13,33,0.394,55,47,102,9,8,16,10,29,71,157,0.9,0.8,2022,23,6.454545454545454,0.9,19,20,39,2.6153846153846154
2022-23,Playoffs,1628470,77,Torrey Craig,1610612756,PHX,11,183,26,45,0.578,11,25,0.44,8,9,0.889,7,18,25,6,5,2,3,23,71,86,2.0,1.67,2022,23,6.454545454545454,2.0,19,1,20,1.25
2022-23,Playoffs,203507,80,Giannis Antetokounmpo,1610612749,MIL,3,91,28,53,0.528,0,3,0.0,14,31,0.452,8,25,33,16,1,2,14,9,70,66,1.14,0.07,2022,23,23.333333333333332,1.1428571428571428,25,17,42,0.7857142857142857
2022-23,Playoffs,1630541,80,Moses Moody,1610612744,GSW,12,161,23,43,0.535,13,22,0.591,11,12,0.917,7,24,31,8,5,4,2,18,70,95,4.0,2.5,2022,23,5.833333333333333,4.0,20,1,21,1.4761904761904763
2022-23,Playoffs,1629020,82,Jarred Vanderbilt,1610612747,LAL,15,247,24,60,0.4,7,29,0.241,14,20,0.7,19,29,48,12,11,12,13,31,69,97,0.92,0.85,2022,23,4.6,0.9230769230769231,36,6,42,1.1428571428571428
2022-23,Playoffs,202695,82,Kawhi Leonard,1610612746,LAC,2,80,24,44,0.545,6,10,0.6,15,17,0.882,3,10,13,12,4,1,6,5,69,71,2.0,0.67,2022,23,34.5,2.0,20,2,22,0.5909090909090909
2022-23,Playoffs,1628381,84,John Collins,1610612737,ATL,6,164,26,60,0.433,11,32,0.344,5,6,0.833,7,19,26,5,2,6,9,13,68,63,0.56,0.22,2022,23,11.333333333333334,0.5555555555555556,34,1,35,0.7428571428571429
2022-23,Playoffs,1631099,84,Keegan Murray,1610612758,SAC,7,194,26,58,0.448,12,32,0.375,4,6,0.667,15,29,44,5,4,2,4,18,68,85,1.25,1.0,2022,23,9.714285714285714,1.25,32,2,34,1.2941176470588236
2022-23,Playoffs,203915,86,Spencer Dinwiddie,1610612751,BKN,4,159,22,51,0.431,7,18,0.389,15,22,0.682,1,12,13,26,5,1,12,7,66,63,2.17,0.42,2022,23,16.5,2.1666666666666665,29,7,36,0.3611111111111111
2022-23,Playoffs,1628989,87,Kevin Huerter,1610612758,SAC,7,183,25,72,0.347,8,39,0.205,6,8,0.75,1,30,31,8,3,9,4,23,64,62,2.0,0.75,2022,23,9.142857142857142,2.0,47,2,49,0.6326530612244898
2022-23,Playoffs,1628415,88,Dillon Brooks,1610612763,MEM,6,167,24,77,0.312,10,42,0.238,5,7,0.714,3,15,18,11,1,0,7,20,63,31,1.57,0.14,2022,23,10.5,1.5714285714285714,53,2,55,0.32727272727272727
2022-23,Playoffs,1631128,89,Christian Braun,1610612743,DEN,19,247,24,45,0.533,2,10,0.2,11,19,0.579,12,27,39,11,11,4,10,29,61,87,1.1,1.1,2022,23,3.210526315789474,1.1,21,8,29,1.3448275862068966
2022-23,Playoffs,1629312,90,Haywood Highsmith,1610612748,MIA,18,161,24,39,0.615,8,16,0.5,4,5,0.8,10,14,24,5,10,2,2,20,60,83,2.5,5.0,2022,23,3.3333333333333335,2.5,15,1,16,1.5
2022-23,Playoffs,201144,90,Mike Conley,1610612750,MIN,5,183,20,42,0.476,10,22,0.455,10,11,0.909,2,11,13,32,3,0,7,11,60,78,4.57,0.43,2022,23,12.0,4.571428571428571,22,1,23,0.5652173913043478
2022-23,Playoffs,1628960,92,Grayson Allen,1610612749,MIL,5,149,19,41,0.463,14,29,0.483,6,7,0.857,1,11,12,9,2,0,4,7,58,54,2.25,0.5,2022,23,11.6,2.25,22,1,23,0.5217391304347826
2022-23,Playoffs,1626166,93,Cameron Payne,1610612756,PHX,7,152,23,48,0.479,11,27,0.407,0,3,0.0,0,14,14,20,3,2,9,15,57,59,2.22,0.33,2022,23,8.142857142857142,2.2222222222222223,25,3,28,0.5
2022-23,Playoffs,200782,94,P.J. Tucker,1610612755,PHI,11,294,19,51,0.373,14,40,0.35,2,3,0.667,18,32,50,16,13,3,5,28,54,98,3.2,2.6,2022,23,4.909090909090909,3.2,32,1,33,1.5151515151515151
2022-23,Playoffs,1629611,95,Terance Mann,1610612746,LAC,5,133,19,33,0.576,9,19,0.474,6,9,0.667,7,9,16,11,4,1,9,17,53,59,1.22,0.44,2022,23,10.6,1.2222222222222223,14,3,17,0.9411764705882353
2022-23,Playoffs,1630214,96,Xavier Tillman,1610612763,MEM,6,183,24,45,0.533,1,4,0.25,3,5,0.6,17,31,48,19,4,4,4,17,52,100,4.75,1.0,2022,23,8.666666666666666,4.75,21,2,23,2.0869565217391304
2022-23,Playoffs,201569,97,Eric Gordon,1610612746,LAC,5,149,18,44,0.409,10,29,0.345,5,6,0.833,1,6,7,13,3,2,4,12,51,45,3.25,0.75,2022,23,10.2,3.25,26,1,27,0.25925925925925924
2022-23,Playoffs,1630194,97,Paul Reed,1610612755,PHI,11,157,22,38,0.579,0,0,0.0,7,7,1.0,27,33,60,7,6,4,6,15,51,106,1.17,1.0,2022,23,4.636363636363637,1.1666666666666667,16,0,16,3.75
2022-23,Playoffs,203991,99,Clint Capela,1610612737,ATL,6,151,23,38,0.605,0,0,0.0,4,6,0.667,15,35,50,3,6,3,4,5,50,91,0.75,1.5,2022,23,8.333333333333334,0.75,15,2,17,2.9411764705882355
2022-23,Playoffs,1630558,99,Davion Mitchell,1610612758,SAC,7,140,19,46,0.413,7,27,0.259,5,6,0.833,3,6,9,12,6,1,6,7,50,44,2.0,1.0,2022,23,7.142857142857143,2.0,27,1,28,0.32142857142857145
2022-23,Playoffs,1630596,101,Evan Mobley,1610612739,CLE,5,188,22,48,0.458,0,1,0.0,5,8,0.625,15,35,50,10,3,6,12,13,49,77,0.83,0.25,2022,23,9.8,0.8333333333333334,26,3,29,1.7241379310344827
2022-23,Playoffs,1626171,102,Bobby Portis,1610612749,MIL,5,107,20,41,0.488,5,18,0.278,3,3,1.0,10,31,41,6,3,2,4,15,48,75,1.5,0.75,2022,23,9.6,1.5,21,0,21,1.9523809523809523
2022-23,Playoffs,1627777,102,Georges Niang,1610612755,PHI,11,157,18,36,0.5,12,26,0.462,0,0,0.0,0,4,4,2,0,2,5,16,48,33,0.4,0.0,2022,23,4.363636363636363,0.4,18,0,18,0.2222222222222222
2022-23,Playoffs,1629013,102,Landry Shamet,1610612756,PHX,10,184,17,45,0.378,11,29,0.379,3,4,0.75,3,14,17,11,2,1,4,15,48,46,2.75,0.5,2022,23,4.8,2.75,28,1,29,0.5862068965517241
2022-23,Playoffs,1626192,102,Pat Connaughton,1610612749,MIL,4,88,17,30,0.567,11,23,0.478,3,4,0.75,4,16,20,7,4,1,2,10,48,64,3.5,2.0,2022,23,12.0,3.5,13,1,14,1.4285714285714286
2022-23,Playoffs,1628386,106,Jarrett Allen,1610612739,CLE,5,191,22,36,0.611,0,0,0.0,3,6,0.5,15,22,37,12,4,5,3,10,47,85,4.0,1.33,2022,23,9.4,4.0,14,3,17,2.176470588235294
2022-23,Playoffs,203469,107,Cody Zeller,1610612748,MIA,21,174,20,35,0.571,0,0,0.0,6,15,0.4,11,37,48,7,2,4,13,28,46,70,0.54,0.15,2022,23,2.1904761904761907,0.5384615384615384,15,9,24,2.0
2022-23,Playoffs,1627826,107,Ivica Zubac,1610612746,LAC,5,130,17,30,0.567,0,0,0.0,12,16,0.75,16,32,48,3,3,1,11,8,46,73,0.27,0.27,2022,23,9.2,0.2727272727272727,13,4,17,2.823529411764706
2022-23,Playoffs,1629656,107,Quentin Grimes,1610612752,NYK,9,242,14,46,0.304,9,37,0.243,9,11,0.818,3,22,25,13,9,5,10,17,46,54,1.3,0.9,2022,23,5.111111111111111,1.3,32,2,34,0.7352941176470589
2022-23,Playoffs,1626168,107,Trey Lyles,1610612758,SAC,7,118,17,40,0.425,9,27,0.333,3,5,0.6,9,31,40,5,2,0,3,12,46,65,1.67,0.67,2022,23,6.571428571428571,1.6666666666666667,23,2,25,1.6
2022-23,Playoffs,1630180,111,Saddiq Bey,1610612737,ATL,6,133,15,40,0.375,7,18,0.389,8,9,0.889,7,17,24,6,3,0,2,3,45,50,3.0,1.5,2022,23,7.5,3.0,25,1,26,0.9230769230769231
2022-23,Playoffs,1630538,112,Bones Hyland,1610612746,LAC,5,82,15,44,0.341,5,20,0.25,8,10,0.8,1,3,4,4,4,1,4,9,43,21,1.0,1.0,2022,23,8.6,1.0,29,2,31,0.12903225806451613
2022-23,Playoffs,1629111,112,Jock Landale,1610612756,PHX,7,113,17,27,0.63,0,1,0.0,9,14,0.643,10,18,28,3,3,3,2,15,43,63,1.5,1.5,2022,23,6.142857142857143,1.5,10,5,15,1.8666666666666667
2022-23,Playoffs,1629651,114,Nic Claxton,1610612751,BKN,4,117,18,25,0.72,0,0,0.0,6,10,0.6,5,27,32,6,1,7,3,8,42,74,2.0,0.33,2022,23,10.5,2.0,7,4,11,2.909090909090909
2022-23,Playoffs,1629638,114,Nickeil Alexander-Walker,1610612750,MIN,5,148,15,35,0.429,10,25,0.4,2,3,0.667,1,9,10,7,3,1,4,9,42,38,1.75,0.75,2022,23,8.4,1.75,20,1,21,0.47619047619047616
2022-23,Playoffs,1629006,116,Josh Okogie,1610612756,PHX,10,175,14,37,0.378,2,14,0.143,11,13,0.846,12,9,21,13,6,2,3,18,41,55,4.33,2.0,2022,23,4.1,4.333333333333333,23,2,25,0.84
2022-23,Playoffs,203486,116,Mason Plumlee,1610612746,LAC,5,91,14,16,0.875,0,0,0.0,13,14,0.929,16,18,34,9,2,2,3,15,41,82,3.0,0.67,2022,23,8.2,3.0,2,1,3,11.333333333333334
2022-23,Playoffs,1630583,118,Santi Aldama,1610612763,MEM,6,101,15,33,0.455,7,15,0.467,2,2,1.0,7,19,26,7,3,0,2,5,39,55,3.5,1.5,2022,23,6.5,3.5,18,0,18,1.4444444444444444
2022-23,Playoffs,1627752,118,Taurean Prince,1610612750,MIN,5,100,12,33,0.364,8,21,0.381,7,9,0.778,3,4,7,4,3,1,5,9,39,26,0.8,0.6,2022,23,7.8,0.8,21,2,23,0.30434782608695654
2022-23,Playoffs,1628379,120,Luke Kennard,1610612763,MEM,5,107,12,23,0.522,8,16,0.5,4,4,1.0,5,15,20,7,4,0,1,8,36,55,7.0,4.0,2022,23,7.2,7.0,11,0,11,1.8181818181818181
2022-23,Playoffs,1630168,120,Onyeka Okongwu,1610612737,ATL,6,131,15,25,0.6,1,1,1.0,5,10,0.5,19,19,38,7,2,8,7,18,36,69,1.0,0.29,2022,23,6.0,1.0,10,5,15,2.533333333333333
2022-23,Playoffs,1628392,122,Isaiah Hartenstein,1610612752,NYK,11,220,11,23,0.478,0,0,0.0,12,16,0.75,23,28,51,14,9,15,5,29,34,102,2.8,1.8,2022,23,3.090909090909091,2.8,12,4,16,3.1875
2022-23,Playoffs,204060,122,Joe Ingles,1610612749,MIL,5,89,12,23,0.522,10,20,0.5,0,0,0.0,1,5,6,10,3,1,6,7,34,37,1.67,0.5,2022,23,6.8,1.6666666666666667,11,0,11,0.5454545454545454
2022-23,Playoffs,1630228,122,Jonathan Kuminga,1610612744,GSW,10,61,13,24,0.542,3,7,0.429,5,9,0.556,4,5,9,5,2,0,4,5,34,31,1.25,0.5,2022,23,3.4,1.25,11,4,15,0.6
2022-23,Playoffs,203937,122,Kyle Anderson,1610612750,MIN,4,104,15,30,0.5,2,6,0.333,2,2,1.0,3,13,16,18,7,2,6,13,34,56,3.0,1.17,2022,23,8.5,3.0,15,0,15,1.0666666666666667
2022-23,Playoffs,1627736,126,Malik Beasley,1610612747,LAL,11,91,10,34,0.294,7,26,0.269,6,6,1.0,3,5,8,2,1,0,2,6,33,18,1.0,0.5,2022,23,3.0,1.0,24,0,24,0.3333333333333333
2022-23,Playoffs,1630171,127,Isaac Okoro,1610612739,CLE,5,75,11,23,0.478,4,13,0.308,6,6,1.0,3,4,7,4,2,2,4,10,32,31,1.0,0.5,2022,23,6.4,1.0,12,0,12,0.5833333333333334
2022-23,Playoffs,1630202,127,Payton Pritchard,1610612738,BOS,10,57,12,22,0.545,4,10,0.4,4,5,0.8,0,6,6,11,1,0,5,3,32,34,2.2,0.2,2022,23,3.2,2.2,10,1,11,0.5454545454545454
2022-23,Playoffs,1626224,129,Cedi Osman,1610612739,CLE,5,93,9,25,0.36,6,20,0.3,6,9,0.667,1,14,15,5,2,1,5,12,30,29,1.0,0.4,2022,23,6.0,1.0,16,3,19,0.7894736842105263
2022-23,Playoffs,1630573,129,Sam Hauser,1610612738,BOS,15,104,10,29,0.345,8,24,0.333,2,2,1.0,5,12,17,4,1,2,0,8,30,35,0.0,0.0,2022,23,2.0,inf,19,0,19,0.8947368421052632
2022-23,Playoffs,202687,131,Bismack Biyombo,1610612756,PHX,8,78,9,16,0.563,0,0,0.0,9,18,0.5,10,17,27,6,0,10,6,18,27,48,1.0,0.0,2022,23,3.375,1.0,7,9,16,1.6875
2022-23,Playoffs,1626145,131,Tyus Jones,1610612763,MEM,6,120,11,36,0.306,3,19,0.158,2,3,0.667,3,15,18,22,8,0,8,5,27,41,2.75,1.0,2022,23,4.5,2.75,25,1,26,0.6923076923076923
2022-23,Playoffs,1630552,133,Jalen Johnson,1610612737,ATL,6,56,10,24,0.417,4,11,0.364,2,2,1.0,2,13,15,8,3,0,5,5,26,33,1.6,0.6,2022,23,4.333333333333333,1.6,14,0,14,1.0714285714285714
2022-23,Playoffs,202694,133,Marcus Morris Sr.,1610612746,LAC,3,68,10,29,0.345,2,12,0.167,4,4,1.0,1,11,12,0,1,1,1,6,26,20,0.0,1.0,2022,23,8.666666666666666,0.0,19,0,19,0.631578947368421
2022-23,Playoffs,1627827,135,Dorian Finney-Smith,1610612751,BKN,4,101,9,23,0.391,7,17,0.412,0,0,0.0,6,12,18,3,3,2,5,7,25,32,0.6,0.6,2022,23,6.25,0.6,14,0,14,1.2857142857142858
2022-23,Playoffs,203552,135,Seth Curry,1610612751,BKN,3,58,10,19,0.526,3,9,0.333,2,3,0.667,0,3,3,6,0,0,1,2,25,23,6.0,0.0,2022,23,8.333333333333334,6.0,9,1,10,0.3
2022-23,Playoffs,1629056,137,Terence Davis,1610612758,SAC,4,58,8,20,0.4,6,17,0.353,2,2,1.0,2,7,9,6,1,0,2,12,24,26,3.0,0.5,2022,23,6.0,3.0,12,0,12,0.75
2022-23,Playoffs,1631223,138,David Roddy,1610612763,MEM,6,76,8,29,0.276,6,20,0.3,1,1,1.0,4,13,17,4,0,2,1,6,23,24,4.0,0.0,2022,23,3.8333333333333335,4.0,21,0,21,0.8095238095238095
2022-23,Playoffs,203210,138,JaMychal Green,1610612744,GSW,7,49,9,23,0.391,5,18,0.278,0,0,0.0,0,5,5,3,0,1,2,10,23,16,1.5,0.0,2022,23,3.2857142857142856,1.5,14,0,14,0.35714285714285715
2022-23,Playoffs,203506,138,Victor Oladipo,1610612748,MIA,2,45,10,19,0.526,2,5,0.4,1,3,0.333,1,6,7,2,2,1,2,5,23,22,1.0,1.0,2022,23,11.5,1.0,9,2,11,0.6363636363636364
2022-23,Playoffs,201587,141,Nicolas Batum,1610612746,LAC,5,92,8,19,0.421,6,17,0.353,0,0,0.0,1,10,11,6,2,2,2,10,22,30,3.0,1.0,2022,23,4.4,3.0,11,0,11,1.0
2022-23,Playoffs,203082,141,Terrence Ross,1610612756,PHX,6,69,8,27,0.296,6,22,0.273,0,0,0.0,0,8,8,1,1,2,1,6,22,14,1.0,1.0,2022,23,3.6666666666666665,1.0,19,0,19,0.42105263157894735
2022-23,Playoffs,1628972,141,Troy Brown Jr.,1610612747,LAL,12,124,10,28,0.357,2,15,0.133,0,0,0.0,4,20,24,11,2,1,0,4,22,42,0.0,0.0,2022,23,1.8333333333333333,inf,18,0,18,1.3333333333333333
2022-23,Playoffs,1627863,144,Danuel House Jr.,1610612755,PHI,7,42,9,21,0.429,1,10,0.1,1,1,1.0,0,12,12,1,0,0,1,4,20,20,1.0,0.0,2022,23,2.857142857142857,1.0,12,0,12,1.0
2022-23,Playoffs,1626220,144,Royce O'Neale,1610612751,BKN,4,118,7,29,0.241,4,22,0.182,2,2,1.0,4,13,17,14,5,1,4,11,20,31,3.5,1.25,2022,23,5.0,3.5,22,0,22,0.7727272727272727
2022-23,Playoffs,203458,146,Alex Len,1610612758,SAC,7,54,7,9,0.778,0,0,0.0,5,6,0.833,7,13,20,1,0,3,7,15,19,33,0.14,0.0,2022,23,2.7142857142857144,0.14285714285714285,2,1,3,6.666666666666667
2022-23,Playoffs,1629667,146,Jalen McDaniels,1610612755,PHI,8,102,8,20,0.4,3,9,0.333,0,0,0.0,3,13,16,5,1,0,3,8,19,26,1.67,0.33,2022,23,2.375,1.6666666666666667,12,0,12,1.3333333333333333
2022-23,Playoffs,1627814,148,Damion Lee,1610612756,PHX,8,89,6,20,0.3,3,15,0.2,2,2,1.0,4,7,11,5,2,0,1,8,17,20,5.0,2.0,2022,23,2.125,5.0,14,0,14,0.7857142857142857
2022-23,Playoffs,1628436,148,Luke Kornet,1610612738,BOS,8,32,7,8,0.875,1,1,1.0,2,2,1.0,5,5,10,0,0,1,0,2,17,27,0.0,0.0,2022,23,2.125,,1,0,1,10.0
2022-23,Playoffs,1629669,150,Jaylen Nowell,1610612750,MIN,5,62,6,26,0.231,3,9,0.333,1,2,0.5,4,1,5,3,0,0,2,4,16,1,1.5,0.0,2022,23,3.2,1.5,20,1,21,0.23809523809523808
2022-23,Playoffs,203933,150,T.J. Warren,1610612756,PHX,6,81,6,19,0.316,1,7,0.143,3,4,0.75,2,5,7,3,1,3,1,5,16,15,3.0,1.0,2022,23,2.6666666666666665,3.0,13,1,14,0.5
2022-23,Playoffs,1631108,152,Max Christie,1610612747,LAL,9,33,5,10,0.5,1,4,0.25,2,4,0.5,1,6,7,3,0,1,0,0,13,17,0.0,0.0,2022,23,1.4444444444444444,inf,5,2,7,1.0
2022-23,Playoffs,1629639,153,Tyler Herro,1610612748,MIA,1,19,5,9,0.556,2,4,0.5,0,0,0.0,0,2,2,2,0,1,1,1,12,12,2.0,0.0,2022,23,12.0,2.0,4,0,4,0.5
2022-23,Playoffs,202083,153,Wesley Matthews,1610612749,MIL,2,41,4,9,0.444,4,7,0.571,0,0,0.0,1,2,3,1,2,1,0,3,12,14,0.0,0.0,2022,23,6.0,inf,5,0,5,0.6
2022-23,Playoffs,202684,155,Tristan Thompson,1610612747,LAL,6,32,5,11,0.455,0,0,0.0,1,5,0.2,4,6,10,2,0,0,1,1,11,12,2.0,0.0,2022,23,1.8333333333333333,2.0,6,4,10,1.0
2022-23,Playoffs,203085,156,Austin Rivers,1610612750,MIN,4,46,4,8,0.5,2,6,0.333,0,0,0.0,1,4,5,1,1,0,1,1,10,12,1.0,1.0,2022,23,2.5,1.0,4,0,4,1.25
2022-23,Playoffs,1627885,156,Shaquille Harrison,1610612747,LAL,8,28,4,7,0.571,1,1,1.0,1,2,0.5,0,3,3,9,2,0,0,3,10,20,0.0,0.0,2022,23,1.25,inf,3,1,4,0.75
2022-23,Playoffs,1629117,156,Wenyen Gabriel,1610612747,LAL,10,37,4,10,0.4,0,0,0.0,2,3,0.667,8,1,9,0,2,3,2,8,10,15,0.0,1.0,2022,23,1.0,0.0,6,1,7,1.2857142857142858
2022-23,Playoffs,1630531,159,Jaden Springer,1610612755,PHI,4,17,4,4,1.0,0,0,0.0,1,2,0.5,0,0,0,0,1,0,1,2,9,8,0.0,1.0,2022,23,2.25,0.0,0,1,1,0.0
2022-23,Playoffs,203488,159,Mike Muscala,1610612738,BOS,6,21,2,4,0.5,2,4,0.5,3,4,0.75,3,1,4,1,0,0,1,1,9,10,1.0,0.0,2022,23,1.5,1.0,2,1,3,1.3333333333333333
2022-23,Playoffs,1628408,161,PJ Dozier,1610612758,SAC,3,6,3,6,0.5,2,4,0.5,0,0,0.0,1,1,2,0,0,0,0,0,8,7,0.0,0.0,2022,23,2.6666666666666665,,3,0,3,0.6666666666666666
2022-23,Playoffs,201577,161,Robin Lopez,1610612739,CLE,2,6,3,3,1.0,0,0,0.0,2,2,1.0,1,0,1,0,0,0,1,2,8,8,0.0,0.0,2022,23,4.0,0.0,0,0,0,inf
2022-23,Playoffs,1629003,161,Shake Milton,1610612755,PHI,6,21,3,5,0.6,0,1,0.0,2,2,1.0,0,3,3,2,2,0,1,3,8,12,2.0,2.0,2022,23,1.3333333333333333,2.0,2,0,2,1.5
2022-23,Playoffs,203109,164,Jae Crowder,1610612749,MIL,4,41,3,13,0.231,0,6,0.0,1,2,0.5,1,3,4,3,2,0,1,5,7,4,3.0,2.0,2022,23,1.75,3.0,10,1,11,0.36363636363636365
2022-23,Playoffs,203925,164,Joe Harris,1610612751,BKN,4,44,2,13,0.154,1,12,0.083,2,2,1.0,0,5,5,0,2,0,3,5,7,0,0.0,0.67,2022,23,1.75,0.0,11,0,11,0.45454545454545453
2022-23,Playoffs,1631254,164,Kenneth Lofton Jr.,1610612763,MEM,4,12,3,8,0.375,0,2,0.0,1,2,0.5,1,2,3,1,0,0,0,0,7,5,0.0,0.0,2022,23,1.75,inf,5,1,6,0.5
2022-23,Playoffs,1630560,167,Cam Thomas,1610612751,BKN,2,16,3,7,0.429,0,2,0.0,0,0,0.0,0,1,1,1,0,0,1,2,6,3,1.0,0.0,2022,23,3.0,1.0,4,0,4,0.25
2022-23,Playoffs,1630549,167,Day'Ron Sharpe,1610612751,BKN,2,20,2,3,0.667,0,0,0.0,2,2,1.0,2,4,6,5,0,1,2,3,6,15,2.5,0.0,2022,23,3.0,2.5,1,0,1,6.0
2022-23,Playoffs,1630237,169,Anthony Lamb,1610612744,GSW,6,31,2,5,0.4,1,4,0.25,0,0,0.0,1,5,6,0,1,1,2,3,5,8,0.0,0.5,2022,23,0.8333333333333334,0.0,3,0,3,2.0
2022-23,Playoffs,201599,169,DeAndre Jordan,1610612743,DEN,4,14,2,3,0.667,0,0,0.0,1,2,0.5,0,4,4,1,0,1,2,2,5,7,0.5,0.0,2022,23,1.25,0.5,1,1,2,2.0
2022-23,Playoffs,1628975,169,Jevon Carter,1610612749,MIL,4,49,2,9,0.222,1,7,0.143,0,0,0.0,0,4,4,4,1,0,0,1,5,7,0.0,0.0,2022,23,1.25,inf,7,0,7,0.5714285714285714
2022-23,Playoffs,1630205,169,Lamar Stevens,1610612739,CLE,2,9,1,2,0.5,1,1,1.0,2,2,1.0,0,3,3,0,0,0,0,0,5,7,0.0,0.0,2022,23,2.5,,1,0,1,3.0
2022-23,Playoffs,1630699,169,MarJon Beauchamp,1610612749,MIL,2,5,2,3,0.667,1,1,1.0,0,0,0.0,0,1,1,0,0,0,0,0,5,5,0.0,0.0,2022,23,2.5,,1,0,1,1.0
2022-23,Playoffs,1631212,169,Peyton Watson,1610612743,DEN,5,14,2,5,0.4,1,2,0.5,0,0,0.0,1,3,4,1,0,1,1,2,5,7,1.0,0.0,2022,23,1.0,1.0,3,0,3,1.3333333333333333
2022-23,Playoffs,1630192,169,Zeke Nnaji,1610612743,DEN,5,12,2,4,0.5,1,3,0.333,0,0,0.0,0,2,2,0,1,0,1,0,5,5,0.0,1.0,2022,23,1.0,0.0,2,0,2,1.0
2022-23,Playoffs,1630533,169,Ziaire Williams,1610612763,MEM,4,12,2,7,0.286,1,3,0.333,0,0,0.0,0,2,2,2,0,0,2,1,5,2,1.0,0.0,2022,23,1.25,1.0,5,0,5,0.4
2022-23,Playoffs,201609,177,Goran Dragic,1610612749,MIL,2,7,0,2,0.0,0,1,0.0,4,4,1.0,0,0,0,1,0,0,0,0,4,3,0.0,0.0,2022,23,2.0,inf,2,0,2,0.0
2022-23,Playoffs,1629723,177,John Konchar,1610612763,MEM,5,49,2,9,0.222,0,4,0.0,0,0,0.0,4,6,10,4,2,2,1,6,4,14,4.0,2.0,2022,23,0.8,4.0,7,0,7,1.4285714285714286
2022-23,Playoffs,1630209,177,Omer Yurtseven,1610612748,MIA,8,16,2,7,0.286,0,2,0.0,0,0,0.0,3,2,5,1,0,1,1,2,4,5,1.0,0.0,2022,23,0.5,1.0,5,0,5,1.0
2022-23,Playoffs,201980,180,Danny Green,1610612739,CLE,4,40,1,5,0.2,1,4,0.25,0,0,0.0,2,5,7,1,2,1,2,7,3,8,0.5,1.0,2022,23,0.75,0.5,4,0,4,1.75
2022-23,Playoffs,1630688,180,Ish Wainright,1610612756,PHX,6,21,1,4,0.25,1,4,0.25,0,0,0.0,0,1,1,0,0,1,0,2,3,2,0.0,0.0,2022,23,0.5,,3,0,3,0.3333333333333333
2022-23,Playoffs,1630540,180,Miles McBride,1610612752,NYK,8,20,1,4,0.25,1,3,0.333,0,0,0.0,0,2,2,1,0,1,0,1,3,4,0.0,0.0,2022,23,0.375,inf,3,0,3,0.6666666666666666
2022-23,Playoffs,202704,180,Reggie Jackson,1610612743,DEN,6,18,1,2,0.5,1,2,0.5,0,0,0.0,0,2,2,2,1,0,1,0,3,6,2.0,1.0,2022,23,0.5,2.0,1,0,1,2.0
2022-23,Playoffs,1629139,180,Yuta Watanabe,1610612751,BKN,1,5,1,2,0.5,1,2,0.5,0,2,0.0,0,1,1,0,0,0,1,0,3,0,0.0,0.0,2022,23,3.0,0.0,1,2,3,0.3333333333333333
2022-23,Playoffs,1629002,185,Chimezie Metu,1610612758,SAC,3,6,0,1,0.0,0,0,0.0,2,3,0.667,1,0,1,0,0,0,1,0,2,0,0.0,0.0,2022,23,0.6666666666666666,0.0,1,1,2,0.5
2022-23,Playoffs,1630561,185,David Duke Jr.,1610612751,BKN,1,5,1,3,0.333,0,1,0.0,0,0,0.0,0,0,0,0,0,0,1,1,2,-1,0.0,0.0,2022,23,2.0,0.0,2,0,2,0.0
2022-23,Playoffs,1629731,185,Dean Wade,1610612739,CLE,2,11,0,1,0.0,0,1,0.0,2,2,1.0,0,3,3,0,0,0,0,0,2,4,0.0,0.0,2022,23,1.0,,1,0,1,3.0
2022-23,Playoffs,1627788,185,Furkan Korkmaz,1610612755,PHI,3,11,0,2,0.0,0,1,0.0,2,2,1.0,0,1,1,1,0,0,1,0,2,1,1.0,0.0,2022,23,0.6666666666666666,1.0,2,0,2,0.5
2022-23,Playoffs,202397,185,Ish Smith,1610612743,DEN,4,12,1,2,0.5,0,0,0.0,0,0,0.0,0,1,1,1,0,0,0,2,2,3,0.0,0.0,2022,23,0.5,inf,1,0,1,1.0
2022-23,Playoffs,1630551,185,Justin Champagnie,1610612738,BOS,4,10,1,4,0.25,0,3,0.0,0,0,0.0,0,0,0,0,0,0,0,2,2,-1,0.0,0.0,2022,23,0.5,,3,0,3,0.0
2022-23,Playoffs,1630233,185,Nathan Knight,1610612750,MIN,2,5,1,4,0.25,0,2,0.0,0,0,0.0,1,0,1,0,0,0,1,0,2,-1,0.0,0.0,2022,23,1.0,0.0,3,0,3,0.3333333333333333
2022-23,Playoffs,1631107,185,Nikola Jovic,1610612748,MIA,7,13,1,4,0.25,0,2,0.0,0,0,0.0,1,4,5,0,0,0,0,0,2,4,0.0,0.0,2022,23,0.2857142857142857,,3,0,3,1.6666666666666667
2022-23,Playoffs,203526,193,Raul Neto,1610612739,CLE,2,7,0,1,0.0,0,1,0.0,1,2,0.5,0,0,0,1,0,0,2,2,1,-2,0.5,0.0,2022,23,0.5,0.5,1,1,2,0.0
2022-23,Playoffs,1628988,194,Aaron Holiday,1610612737,ATL,1,4,0,0,0.0,0,0,0.0,0,0,0.0,0,0,0,1,0,0,1,0,0,0,1.0,0.0,2022,23,0.0,1.0,0,0,0,
2022-23,Playoffs,1629599,194,Amir Coffey,1610612746,LAC,1,1,0,0,0.0,0,0,0.0,0,0,0.0,0,0,0,0,0,0,0,0,0,0,0.0,0.0,2022,23,0.0,,0,0,0,
2022-23,Playoffs,201933,194,Blake Griffin,1610612738,BOS,1,6,0,1,0.0,0,0,0.0,0,0,0.0,1,1,2,0,0,0,0,2,0,1,0.0,0.0,2022,23,0.0,,1,0,1,2.0
2022-23,Playoffs,1630527,194,Brandon Boston Jr.,1610612746,LAC,1,1,0,0,0.0,0,0,0.0,0,0,0.0,0,0,0,0,0,0,1,0,0,-1,0.0,0.0,2022,23,0.0,0.0,0,0,0,
2022-23,Playoffs,1629610,194,DaQuan Jeffries,1610612752,NYK,2,5,0,0,0.0,0,0,0.0,0,0,0.0,0,0,0,0,0,0,0,2,0,0,0.0,0.0,2022,23,0.0,,0,0,0,
2022-23,Playoffs,201565,194,Derrick Rose,1610612752,NYK,1,3,0,4,0.0,0,1,0.0,0,0,0.0,0,0,0,1,0,0,0,0,0,-3,0.0,0.0,2022,23,0.0,inf,4,0,4,0.0
2022-23,Playoffs,203473,194,Dewayne Dedmon,1610612755,PHI,1,5,0,1,0.0,0,1,0.0,0,0,0.0,0,1,1,0,0,0,1,1,0,-1,0.0,0.0,2022,23,0.0,0.0,1,0,1,1.0
2022-23,Playoffs,1628410,194,Edmond Sumner,1610612751,BKN,1,4,0,0,0.0,0,0,0.0,0,0,0.0,0,0,0,1,0,0,0,0,0,1,0.0,0.0,2022,23,0.0,inf,0,0,0,
2022-23,Playoffs,1630554,194,Jason Preston,1610612746,LAC,1,1,0,0,0.0,0,0,0.0,0,0,0.0,0,0,0,0,0,0,0,0,0,0,0.0,0.0,2022,23,0.0,,0,0,0,
2022-23,Playoffs,1629162,194,Jordan McLaughlin,1610612750,MIN,2,14,0,4,0.0,0,2,0.0,0,0,0.0,0,2,2,2,0,0,0,2,0,0,0.0,0.0,2022,23,0.0,inf,4,0,4,0.5
2022-23,Playoffs,1631169,194,Josh Minott,1610612750,MIN,1,6,0,1,0.0,0,1,0.0,0,0,0.0,0,0,0,0,2,1,1,1,0,1,0.0,2.0,2022,23,0.0,0.0,1,0,1,0.0
2022-23,Playoffs,1630556,194,Kessler Edwards,1610612758,SAC,6,7,0,0,0.0,0,0,0.0,0,0,0.0,0,1,1,0,0,0,0,0,0,1,0.0,0.0,2022,23,0.0,,0,0,0,inf
2022-23,Playoffs,203086,194,Meyers Leonard,1610612749,MIL,2,5,0,1,0.0,0,0,0.0,0,0,0.0,0,1,1,0,0,0,0,0,0,0,0.0,0.0,2022,23,0.0,,1,0,1,1.0
2022-23,Playoffs,1628964,194,Mo Bamba,1610612747,LAL,3,10,0,2,0.0,0,1,0.0,0,0,0.0,0,3,3,1,0,1,0,0,0,3,0.0,0.0,2022,23,0.0,inf,2,0,2,1.5
2022-23,Playoffs,1626149,194,Montrezl Harrell,1610612755,PHI,2,7,0,3,0.0,0,0,0.0,0,0,0.0,0,1,1,0,0,0,0,0,0,-2,0.0,0.0,2022,23,0.0,,3,0,3,0.3333333333333333
2022-23,Playoffs,1631116,194,Patrick Baldwin Jr.,1610612744,GSW,3,11,0,3,0.0,0,3,0.0,0,0,0.0,0,3,3,1,0,0,0,0,0,1,0.0,0.0,2022,23,0.0,inf,3,0,3,1.0
2022-23,Playoffs,201988,194,Patty Mills,1610612751,BKN,1,5,0,2,0.0,0,2,0.0,0,0,0.0,0,0,0,0,0,0,0,1,0,-2,0.0,0.0,2022,23,0.0,,2,0,2,0.0
2022-23,Playoffs,201937,194,Ricky Rubio,1610612739,CLE,3,17,0,1,0.0,0,0,0.0,0,0,0.0,2,4,6,3,1,0,5,5,0,4,0.6,0.2,2022,23,0.0,0.6,1,0,1,6.0
2022-23,Playoffs,203496,194,Robert Covington,1610612746,LAC,2,12,0,3,0.0,0,2,0.0,0,0,0.0,0,2,2,2,0,1,0,2,0,2,0.0,0.0,2022,23,0.0,inf,3,0,3,0.6666666666666666
2022-23,Playoffs,203648,194,Thanasis Antetokounmpo,1610612749,MIL,2,5,0,0,0.0,0,0,0.0,0,0,0.0,0,0,0,0,0,0,0,0,0,0,0.0,0.0,2022,23,0.0,,0,0,0,
2022-23,Playoffs,1628418,194,Thomas Bryant,1610612743,DEN,1,1,0,0,0.0,0,0,0.0,0,0,0.0,0,0,0,0,0,0,0,0,0,0,0.0,0.0,2022,23,0.0,,0,0,0,
2022-23,Playoffs,2617,194,Udonis Haslem,1610612748,MIA,2,3,0,3,0.0,0,1,0.0,0,0,0.0,0,1,1,0,0,0,0,0,0,-2,0.0,0.0,2022,23,0.0,,3,0,3,0.3333333333333333
2022-23,Playoffs,1628427,194,Vlatko Cancar,1610612743,DEN,5,10,0,5,0.0,0,4,0.0,0,0,0.0,0,3,3,1,0,0,0,0,0,-1,0.0,0.0,2022,23,0.0,inf,5,0,5,0.6
2022-23,Playoffs,1631111,194,Wendell Moore Jr.,1610612750,MIN,1,2,0,0,0.0,0,0,0.0,0,0,0.0,0,0,0,0,0,0,1,0,0,-1,0.0,0.0,2022,23,0.0,0.0,0,0,0,
2023-24,RegularSeason,1629029,1,Luka Doncic,1610612742,DAL,70,2624,804,1652,0.487,284,744,0.382,478,608,0.786,59,588,647,686,99,38,282,149,2370,2580,2.43,0.35,2023,24,33.857142857142854,2.4326241134751774,848,130,978,0.6615541922290389
2023-24,RegularSeason,1628983,2,Shai Gilgeous-Alexander,1610612760,OKC,75,2553,796,1487,0.535,95,269,0.353,567,649,0.874,65,350,415,465,150,67,162,184,2254,2416,2.87,0.93,2023,24,30.053333333333335,2.8703703703703702,691,82,773,0.536869340232859
2023-24,RegularSeason,203507,3,Giannis Antetokounmpo,1610612749,MIL,73,2567,837,1369,0.611,34,124,0.274,514,782,0.657,196,645,841,476,87,79,250,210,2222,2655,1.9,0.35,2023,24,30.438356164383563,1.904,532,268,800,1.05125
2023-24,RegularSeason,1628973,4,Jalen Brunson,1610612752,NYK,77,2726,790,1648,0.479,211,526,0.401,421,497,0.847,43,235,278,519,70,13,186,144,2212,1972,2.79,0.38,2023,24,28.727272727272727,2.7903225806451615,858,76,934,0.29764453961456105
2023-24,RegularSeason,203999,5,Nikola Jokic,1610612743,DEN,79,2737,822,1411,0.583,83,231,0.359,358,438,0.817,223,753,976,708,108,68,237,194,2085,3039,2.99,0.46,2023,24,26.39240506329114,2.9873417721518987,589,80,669,1.4588938714499253
2023-24,RegularSeason,1630162,6,Anthony Edwards,1610612750,MIN,79,2770,718,1558,0.461,190,532,0.357,423,506,0.836,52,378,430,405,101,42,241,141,2049,1863,1.68,0.42,2023,24,25.936708860759495,1.6804979253112033,840,83,923,0.4658721560130011
2023-24,RegularSeason,201142,7,Kevin Durant,1610612756,PHX,75,2791,751,1436,0.523,168,407,0.413,362,423,0.856,41,454,495,378,69,91,244,133,2032,2075,1.55,0.28,2023,24,27.093333333333334,1.5491803278688525,685,61,746,0.6635388739946381
2023-24,RegularSeason,1628369,8,Jayson Tatum,1610612738,BOS,74,2645,672,1426,0.471,229,609,0.376,414,497,0.833,67,534,601,364,75,43,188,145,1987,2045,1.94,0.4,2023,24,26.85135135135135,1.9361702127659575,754,83,837,0.7180406212664278
2023-24,RegularSeason,1628368,9,De'Aaron Fox,1610612758,SAC,74,2659,720,1549,0.465,214,580,0.369,312,423,0.738,67,273,340,418,150,31,194,193,1966,1771,2.15,0.77,2023,24,26.56756756756757,2.154639175257732,829,111,940,0.3617021276595745
2023-24,RegularSeason,201939,10,Stephen Curry,1610612744,GSW,74,2422,650,1445,0.45,357,876,0.408,299,324,0.923,37,293,330,379,54,28,210,117,1956,1717,1.8,0.26,2023,24,26.43243243243243,1.8047619047619048,795,25,820,0.4024390243902439
2023-24,RegularSeason,201942,11,DeMar DeRozan,1610612741,CHI,79,2989,650,1355,0.48,75,225,0.333,522,612,0.853,43,297,340,421,90,45,135,161,1897,1863,3.12,0.67,2023,24,24.0126582278481,3.1185185185185187,705,90,795,0.4276729559748428
2023-24,RegularSeason,203076,12,Anthony Davis,1610612747,LAL,76,2700,713,1283,0.556,29,107,0.271,421,516,0.816,239,722,961,266,91,178,159,177,1876,2548,1.67,0.57,2023,24,24.68421052631579,1.6729559748427674,570,95,665,1.4451127819548872
2023-24,RegularSeason,1626164,13,Devin Booker,1610612756,PHX,68,2447,642,1305,0.492,152,418,0.364,405,457,0.886,56,252,308,472,61,28,178,206,1841,1817,2.65,0.34,2023,24,27.073529411764707,2.651685393258427,663,52,715,0.4307692307692308
2023-24,RegularSeason,2544,14,LeBron James,1610612747,LAL,71,2504,685,1269,0.54,149,363,0.41,303,404,0.75,61,457,518,589,89,38,245,78,1822,2126,2.4,0.36,2023,24,25.661971830985916,2.404081632653061,584,101,685,0.7562043795620438
2023-24,RegularSeason,1630178,15,Tyrese Maxey,1610612755,PHI,70,2626,638,1419,0.45,212,569,0.373,328,378,0.868,36,222,258,433,69,33,116,151,1816,1662,3.73,0.59,2023,24,25.942857142857143,3.7327586206896552,781,50,831,0.3104693140794224
2023-24,RegularSeason,1631094,16,Paolo Banchero,1610612753,ORL,80,2799,640,1407,0.455,119,351,0.339,405,559,0.725,82,472,554,431,71,47,247,153,1804,1739,1.75,0.29,2023,24,22.55,1.7449392712550607,767,154,921,0.6015200868621065
2023-24,RegularSeason,203081,17,Damian Lillard,1610612749,MIL,73,2578,541,1277,0.424,220,622,0.354,473,514,0.92,36,284,320,508,72,18,193,134,1775,1723,2.63,0.37,2023,24,24.315068493150687,2.6321243523316062,736,41,777,0.4118404118404118
2023-24,RegularSeason,1627749,18,Dejounte Murray,1610612737,ATL,78,2783,672,1463,0.459,201,554,0.363,208,262,0.794,62,354,416,502,111,24,201,138,1753,1760,2.5,0.55,2023,24,22.474358974358974,2.4975124378109452,791,54,845,0.49230769230769234
2023-24,RegularSeason,1627783,19,Pascal Siakam,1610612754,IND,80,2658,681,1271,0.536,85,246,0.346,290,396,0.732,139,426,565,342,63,25,141,193,1737,1895,2.43,0.45,2023,24,21.7125,2.425531914893617,590,106,696,0.8117816091954023
2023-24,RegularSeason,202331,20,Paul George,1610612746,LAC,74,2502,582,1236,0.471,243,588,0.413,264,291,0.907,37,351,388,262,113,37,153,202,1671,1637,1.71,0.74,2023,24,22.58108108108108,1.7124183006535947,654,27,681,0.5697503671071953
2023-24,RegularSeason,202695,21,Kawhi Leonard,1610612746,LAC,68,2330,610,1162,0.525,140,336,0.417,253,286,0.885,84,332,416,244,111,59,119,97,1613,1739,2.05,0.93,2023,24,23.720588235294116,2.0504201680672267,552,33,585,0.7111111111111111
2023-24,RegularSeason,1630224,22,Jalen Green,1610612745,HOU,82,2601,563,1332,0.423,201,605,0.332,283,352,0.804,41,382,423,291,66,28,191,115,1610,1389,1.52,0.35,2023,24,19.634146341463413,1.5235602094240839,769,69,838,0.5047732696897375
2023-24,RegularSeason,1627759,22,Jaylen Brown,1610612738,BOS,70,2343,627,1256,0.499,145,410,0.354,211,300,0.703,84,303,387,249,83,37,166,185,1610,1482,1.5,0.5,2023,24,23.0,1.5,629,89,718,0.5389972144846796
2023-24,RegularSeason,1628969,24,Mikal Bridges,1610612751,BKN,82,2854,564,1294,0.436,220,592,0.372,258,317,0.814,68,304,372,299,81,30,164,116,1606,1435,1.82,0.49,2023,24,19.585365853658537,1.8231707317073171,730,59,789,0.4714828897338403
2023-24,RegularSeason,1629627,25,Zion Williamson,1610612740,NOP,70,2207,624,1094,0.57,6,18,0.333,347,494,0.702,122,284,406,352,77,47,193,159,1601,1673,1.82,0.4,2023,24,22.87142857142857,1.8238341968911918,470,147,617,0.6580226904376013
2023-24,RegularSeason,1627734,26,Domantas Sabonis,1610612758,SAC,82,2928,634,1068,0.594,33,87,0.379,292,415,0.704,294,826,1120,673,74,48,272,250,1593,2679,2.47,0.27,2023,24,19.426829268292682,2.474264705882353,434,123,557,2.0107719928186714
2023-24,RegularSeason,1628398,27,Kyle Kuzma,1610612764,WAS,70,2281,608,1313,0.463,151,450,0.336,186,240,0.775,62,402,464,296,37,49,192,153,1553,1448,1.54,0.19,2023,24,22.185714285714287,1.5416666666666667,705,54,759,0.61133069828722
2023-24,RegularSeason,1641705,28,Victor Wembanyama,1610612759,SAS,71,2106,551,1186,0.465,128,394,0.325,292,367,0.796,161,594,755,274,88,254,260,153,1522,1923,1.05,0.34,2023,24,21.43661971830986,1.0538461538461539,635,75,710,1.0633802816901408
2023-24,RegularSeason,1629632,29,Coby White,1610612741,CHI,79,2881,541,1209,0.447,209,556,0.376,218,260,0.838,44,314,358,405,53,18,166,186,1509,1467,2.44,0.32,2023,24,19.10126582278481,2.4397590361445785,668,42,710,0.504225352112676
2023-24,RegularSeason,202681,30,Kyrie Irving,1610612742,DAL,58,2030,562,1131,0.497,173,421,0.411,190,210,0.905,44,246,290,299,74,28,106,112,1487,1483,2.82,0.7,2023,24,25.637931034482758,2.8207547169811322,569,20,589,0.4923599320882852
2023-24,RegularSeason,1628991,31,Jaren Jackson Jr.,1610612763,MEM,66,2124,516,1162,0.444,117,366,0.32,337,417,0.808,85,280,365,154,80,106,160,235,1486,1305,0.96,0.5,2023,24,22.515151515151516,0.9625,646,80,726,0.5027548209366391
2023-24,RegularSeason,1630560,32,Cam Thomas,1610612751,BKN,66,2075,526,1190,0.442,144,396,0.364,286,334,0.856,28,186,214,192,45,16,124,138,1482,1113,1.55,0.36,2023,24,22.454545454545453,1.5483870967741935,664,48,712,0.300561797752809
2023-24,RegularSeason,1628378,33,Donovan Mitchell,1610612739,CLE,55,1943,503,1089,0.462,182,494,0.368,275,318,0.865,46,234,280,333,101,30,154,118,1463,1424,2.16,0.66,2023,24,26.6,2.1623376623376624,586,43,629,0.4451510333863275
2023-24,RegularSeason,1629012,34,Collin Sexton,1610612762,UTA,78,2075,506,1038,0.487,128,325,0.394,318,370,0.859,71,134,205,383,62,18,165,154,1458,1377,2.32,0.38,2023,24,18.692307692307693,2.3212121212121213,532,52,584,0.351027397260274
2023-24,RegularSeason,1628970,35,Miles Bridges,1610612766,CHA,69,2581,559,1210,0.462,157,450,0.349,174,211,0.825,71,434,505,231,65,33,138,118,1449,1457,1.67,0.47,2023,24,21.0,1.673913043478261,651,37,688,0.7340116279069767
2023-24,RegularSeason,1630532,36,Franz Wagner,1610612753,ORL,72,2337,528,1096,0.482,94,334,0.281,271,319,0.85,72,309,381,269,76,28,137,168,1421,1422,1.96,0.56,2023,24,19.73611111111111,1.9635036496350364,568,48,616,0.6185064935064936
2023-24,RegularSeason,1630595,37,Cade Cunningham,1610612765,DET,62,2074,524,1167,0.449,119,335,0.355,238,274,0.869,33,235,268,464,56,22,212,153,1405,1324,2.19,0.26,2023,24,22.661290322580644,2.188679245283019,643,36,679,0.3946980854197349
2023-24,RegularSeason,1629027,38,Trae Young,1610612737,ATL,54,1942,433,1008,0.43,175,469,0.373,348,407,0.855,23,126,149,583,72,11,235,109,1389,1335,2.48,0.31,2023,24,25.72222222222222,2.480851063829787,575,59,634,0.23501577287066247
2023-24,RegularSeason,1630169,38,Tyrese Haliburton,1610612754,IND,69,2224,500,1048,0.477,195,535,0.364,194,227,0.855,35,236,271,752,83,48,159,75,1389,1803,4.73,0.52,2023,24,20.130434782608695,4.729559748427673,548,33,581,0.4664371772805508
2023-24,RegularSeason,202691,40,Klay Thompson,1610612744,GSW,77,2284,490,1133,0.432,268,692,0.387,127,137,0.927,35,219,254,176,50,35,117,127,1375,1120,1.5,0.43,2023,24,17.857142857142858,1.5042735042735043,643,10,653,0.3889739663093415
2023-24,RegularSeason,202696,41,Nikola Vucevic,1610612741,CHI,76,2610,586,1211,0.484,92,313,0.294,106,129,0.822,210,591,801,254,50,60,120,190,1370,1767,2.12,0.42,2023,24,18.026315789473685,2.1166666666666667,625,23,648,1.2361111111111112
2023-24,RegularSeason,1626156,42,D'Angelo Russell,1610612747,LAL,76,2484,492,1080,0.456,226,545,0.415,159,192,0.828,28,208,236,482,69,36,156,156,1369,1415,3.09,0.44,2023,24,18.013157894736842,3.08974358974359,588,33,621,0.38003220611916266
2023-24,RegularSeason,1628389,43,Bam Adebayo,1610612748,MIA,71,2416,530,1017,0.521,15,42,0.357,292,387,0.755,159,578,737,278,81,66,162,159,1367,1785,1.72,0.5,2023,24,19.253521126760564,1.7160493827160495,487,95,582,1.2663230240549828
2023-24,RegularSeason,1631096,44,Chet Holmgren,1610612760,OKC,82,2413,505,953,0.53,129,349,0.37,218,275,0.793,129,519,648,200,53,190,131,197,1357,1812,1.53,0.41,2023,24,16.548780487804876,1.5267175572519085,448,57,505,1.2831683168316832
2023-24,RegularSeason,1629673,45,Jordan Poole,1610612764,WAS,78,2346,490,1186,0.413,184,564,0.326,192,219,0.877,32,180,212,343,86,25,188,244,1356,1111,1.82,0.46,2023,24,17.384615384615383,1.824468085106383,696,27,723,0.29322268326417705
2023-24,RegularSeason,1629008,45,Michael Porter Jr.,1610612743,DEN,81,2565,522,1079,0.484,220,554,0.397,92,110,0.836,106,459,565,122,42,53,92,148,1356,1471,1.33,0.46,2023,24,16.74074074074074,1.326086956521739,557,18,575,0.9826086956521739
2023-24,RegularSeason,1631114,47,Jalen Williams,1610612760,OKC,71,2224,536,993,0.54,103,241,0.427,180,221,0.814,37,245,282,322,80,45,123,175,1355,1463,2.62,0.65,2023,24,19.08450704225352,2.6178861788617884,457,41,498,0.5662650602409639
2023-24,RegularSeason,203954,48,Joel Embiid,1610612755,PHI,39,1309,450,851,0.529,54,139,0.388,399,452,0.883,95,335,430,219,46,66,150,112,1353,1510,1.46,0.31,2023,24,34.69230769230769,1.46,401,53,454,0.947136563876652
2023-24,RegularSeason,1626157,49,Karl-Anthony Towns,1610612750,MIN,62,2026,479,951,0.504,136,327,0.416,255,292,0.873,94,421,515,189,43,41,177,204,1349,1451,1.07,0.24,2023,24,21.758064516129032,1.0677966101694916,472,37,509,1.0117878192534382
2023-24,RegularSeason,203992,50,Bogdan Bogdanovic,1610612737,ATL,79,2401,471,1100,0.428,240,641,0.374,151,164,0.921,53,219,272,247,96,26,112,179,1333,1220,2.21,0.86,2023,24,16.873417721518987,2.205357142857143,629,13,642,0.4236760124610592
2023-24,RegularSeason,1627742,51,Brandon Ingram,1610612740,NOP,64,2103,500,1017,0.492,86,242,0.355,246,307,0.801,43,281,324,363,50,40,163,145,1332,1368,2.23,0.31,2023,24,20.8125,2.226993865030675,517,61,578,0.5605536332179931
2023-24,RegularSeason,1630578,52,Alperen Sengun,1610612745,HOU,63,2046,527,982,0.537,33,111,0.297,244,352,0.693,183,406,589,312,76,46,162,211,1331,1629,1.93,0.47,2023,24,21.126984126984127,1.9259259259259258,455,108,563,1.0461811722912966
2023-24,RegularSeason,1630170,53,Devin Vassell,1610612759,SAS,68,2248,498,1056,0.472,166,446,0.372,161,201,0.801,27,234,261,277,73,23,108,74,1323,1251,2.56,0.68,2023,24,19.455882352941178,2.564814814814815,558,40,598,0.43645484949832775
2023-24,RegularSeason,203468,54,CJ McCollum,1610612740,NOP,66,2159,484,1055,0.459,239,557,0.429,115,139,0.827,39,247,286,305,62,41,110,126,1322,1311,2.77,0.56,2023,24,20.03030303030303,2.772727272727273,571,24,595,0.48067226890756304
2023-24,RegularSeason,1626167,55,Myles Turner,1610612754,IND,77,2076,476,909,0.524,116,324,0.358,245,317,0.773,113,420,533,100,39,144,109,232,1313,1515,0.92,0.36,2023,24,17.051948051948052,0.9174311926605505,433,72,505,1.0554455445544555
2023-24,RegularSeason,1630559,56,Austin Reaves,1610612747,LAL,82,2629,457,940,0.486,154,420,0.367,232,272,0.853,57,295,352,450,66,25,174,153,1300,1496,2.59,0.38,2023,24,15.853658536585366,2.586206896551724,483,40,523,0.6730401529636711
2023-24,RegularSeason,1641706,57,Brandon Miller,1610612766,CHA,74,2383,476,1083,0.44,184,493,0.373,143,173,0.827,60,255,315,175,66,42,132,184,1279,1108,1.33,0.5,2023,24,17.283783783783782,1.3257575757575757,607,30,637,0.4945054945054945
2023-24,RegularSeason,1628374,58,Lauri Markkanen,1610612762,UTA,55,1820,427,890,0.48,175,439,0.399,249,277,0.899,122,327,449,110,50,26,77,100,1278,1345,1.43,0.65,2023,24,23.236363636363638,1.4285714285714286,463,28,491,0.9144602851323829
2023-24,RegularSeason,1628386,59,Jarrett Allen,1610612739,CLE,77,2442,519,819,0.634,0,6,0.0,233,314,0.742,243,568,811,210,53,81,121,147,1271,1924,1.74,0.44,2023,24,16.506493506493506,1.7355371900826446,300,81,381,2.1286089238845145
2023-24,RegularSeason,1627832,60,Fred VanVleet,1610612745,HOU,73,2684,423,1018,0.416,227,586,0.387,197,229,0.86,33,245,278,589,101,59,126,183,1270,1544,4.67,0.8,2023,24,17.397260273972602,4.674603174603175,595,32,627,0.4433811802232855
2023-24,RegularSeason,1628978,61,Donte DiVincenzo,1610612752,NYK,81,2360,445,1004,0.443,283,705,0.401,86,114,0.754,63,234,297,216,107,36,113,166,1259,1215,1.91,0.95,2023,24,15.54320987654321,1.9115044247787611,559,28,587,0.5059625212947189
2023-24,RegularSeason,1627750,62,Jamal Murray,1610612743,DEN,59,1861,474,986,0.481,145,341,0.425,157,184,0.853,42,200,242,384,57,39,125,104,1250,1308,3.07,0.46,2023,24,21.1864406779661,3.072,512,27,539,0.4489795918367347
2023-24,RegularSeason,202710,63,Jimmy Butler,1610612748,MIA,60,2042,396,793,0.499,60,145,0.414,394,459,0.858,105,213,318,298,79,17,102,68,1246,1394,2.92,0.78,2023,24,20.766666666666666,2.9215686274509802,397,65,462,0.6883116883116883
2023-24,RegularSeason,1626179,64,Terry Rozier,1610612748,MIA,61,2040,442,998,0.443,149,410,0.363,172,198,0.869,35,212,247,342,63,21,106,101,1205,1190,3.23,0.59,2023,24,19.75409836065574,3.2264150943396226,556,26,582,0.42439862542955326
2023-24,RegularSeason,202699,65,Tobias Harris,1610612755,PHI,70,2368,463,951,0.487,91,258,0.353,187,213,0.878,80,373,453,217,70,46,93,115,1204,1383,2.33,0.75,2023,24,17.2,2.3333333333333335,488,26,514,0.8813229571984436
2023-24,RegularSeason,201935,66,James Harden,1610612746,LAC,72,2470,352,822,0.428,186,488,0.381,302,344,0.878,34,335,369,614,77,57,185,127,1192,1612,3.32,0.42,2023,24,16.555555555555557,3.3189189189189188,470,42,512,0.720703125
2023-24,RegularSeason,1630567,67,Scottie Barnes,1610612761,TOR,60,2094,447,942,0.475,101,296,0.341,196,251,0.781,141,353,494,363,75,88,165,118,1191,1496,2.2,0.46,2023,24,19.85,2.2,495,55,550,0.8981818181818182
2023-24,RegularSeason,1630228,68,Jonathan Kuminga,1610612744,GSW,74,1949,456,862,0.529,53,165,0.321,223,299,0.746,92,263,355,163,55,36,122,169,1188,1193,1.34,0.45,2023,24,16.054054054054053,1.3360655737704918,406,76,482,0.7365145228215768
2023-24,RegularSeason,1631093,69,Jaden Ivey,1610612765,DET,77,2218,417,973,0.429,124,369,0.336,227,303,0.749,86,178,264,296,57,41,190,204,1185,1021,1.56,0.3,2023,24,15.38961038961039,1.5578947368421052,556,76,632,0.4177215189873418
2023-24,RegularSeason,1631099,70,Keegan Murray,1610612758,SAC,77,2589,443,975,0.454,183,511,0.358,103,124,0.831,106,314,420,129,79,59,64,205,1172,1242,2.02,1.23,2023,24,15.220779220779221,2.015625,532,21,553,0.759493670886076
2023-24,RegularSeason,1629628,71,RJ Barrett,1610612761,TOR,58,1838,436,880,0.495,90,250,0.36,208,291,0.715,53,262,315,193,31,22,126,129,1170,1078,1.53,0.25,2023,24,20.17241379310345,1.5317460317460319,444,83,527,0.5977229601518027
2023-24,RegularSeason,1630193,72,Immanuel Quickley,1610612761,TOR,68,1985,388,894,0.434,171,433,0.395,209,245,0.853,17,242,259,331,50,10,101,119,1156,1163,3.28,0.49,2023,24,17.0,3.277227722772277,506,36,542,0.477859778597786
2023-24,RegularSeason,204001,73,Kristaps Porzingis,1610612738,BOS,57,1690,388,752,0.516,110,293,0.375,259,302,0.858,97,312,409,115,42,111,89,156,1145,1326,1.29,0.47,2023,24,20.087719298245613,1.2921348314606742,364,43,407,1.0049140049140048
2023-24,RegularSeason,203501,74,Tim Hardaway Jr.,1610612742,DAL,79,2120,392,976,0.402,211,597,0.353,144,169,0.852,22,232,254,139,42,6,69,106,1139,902,2.01,0.61,2023,24,14.417721518987342,2.0144927536231885,584,25,609,0.41707717569786534
2023-24,RegularSeason,203924,75,Jerami Grant,1610612757,POR,54,1830,383,850,0.451,111,276,0.402,255,312,0.817,37,154,191,152,45,34,116,117,1132,914,1.31,0.39,2023,24,20.962962962962962,1.3103448275862069,467,57,524,0.36450381679389315
2023-24,RegularSeason,1626171,76,Bobby Portis,1610612749,MIL,82,2008,466,918,0.508,100,246,0.407,98,124,0.79,142,465,607,104,68,34,91,189,1130,1374,1.14,0.75,2023,24,13.78048780487805,1.1428571428571428,452,26,478,1.2698744769874477
2023-24,RegularSeason,203471,77,Dennis Schroder,1610612751,BKN,80,2486,403,927,0.435,138,368,0.375,178,213,0.836,39,203,242,488,63,17,153,164,1122,1220,3.19,0.41,2023,24,14.025,3.189542483660131,524,35,559,0.4329159212880143
2023-24,RegularSeason,1628370,78,Malik Monk,1610612758,SAC,72,1872,396,893,0.443,148,423,0.35,170,205,0.829,28,184,212,370,45,39,150,156,1110,1094,2.47,0.3,2023,24,15.416666666666666,2.466666666666667,497,35,532,0.39849624060150374
2023-24,RegularSeason,1628401,79,Derrick White,1610612738,BOS,73,2381,387,839,0.461,196,495,0.396,137,152,0.901,51,259,310,377,74,87,112,152,1107,1376,3.37,0.66,2023,24,15.164383561643836,3.3660714285714284,452,15,467,0.6638115631691649
2023-24,RegularSeason,1630166,80,Deni Avdija,1610612764,WAS,75,2257,406,803,0.506,88,235,0.374,202,273,0.74,84,456,540,286,60,36,160,185,1102,1396,1.79,0.38,2023,24,14.693333333333333,1.7875,397,71,468,1.1538461538461537
2023-24,RegularSeason,203944,80,Julius Randle,1610612752,NYK,46,1630,395,836,0.472,76,244,0.311,236,302,0.781,99,324,423,229,25,12,159,125,1102,1125,1.44,0.16,2023,24,23.956521739130434,1.440251572327044,441,66,507,0.834319526627219
2023-24,RegularSeason,1629675,82,Naz Reid,1610612750,MIN,81,1964,406,851,0.477,169,408,0.414,109,148,0.736,73,350,423,106,63,73,111,172,1090,1160,0.95,0.57,2023,24,13.45679012345679,0.954954954954955,445,39,484,0.8739669421487604
2023-24,RegularSeason,1629640,83,Keldon Johnson,1610612759,SAS,69,2038,391,862,0.454,127,367,0.346,175,221,0.792,95,282,377,195,51,20,100,149,1084,1110,1.95,0.51,2023,24,15.710144927536232,1.95,471,46,517,0.7292069632495164
2023-24,RegularSeason,1630557,84,Corey Kispert,1610612764,WAS,80,2067,386,794,0.486,184,480,0.383,114,157,0.726,30,195,225,156,41,16,98,141,1070,959,1.59,0.42,2023,24,13.375,1.5918367346938775,408,43,451,0.49889135254988914
2023-24,RegularSeason,203497,85,Rudy Gobert,1610612750,MIN,76,2593,406,614,0.661,0,3,0.0,249,390,0.638,285,697,982,102,52,162,118,238,1061,1892,0.86,0.44,2023,24,13.960526315789474,0.864406779661017,208,141,349,2.8137535816618913
2023-24,RegularSeason,1626181,86,Norman Powell,1610612746,LAC,76,1990,373,768,0.486,167,384,0.435,143,172,0.831,16,179,195,82,43,22,66,137,1056,908,1.24,0.65,2023,24,13.894736842105264,1.2424242424242424,395,29,424,0.45990566037735847
2023-24,RegularSeason,1626162,87,Kelly Oubre Jr.,1610612755,PHI,68,2055,387,878,0.441,101,325,0.311,174,232,0.75,94,247,341,101,77,47,87,194,1049,979,1.16,0.89,2023,24,15.426470588235293,1.160919540229885,491,58,549,0.6211293260473588
2023-24,RegularSeason,1631095,88,Jabari Smith Jr.,1610612745,HOU,76,2424,378,833,0.454,138,380,0.363,150,185,0.811,139,477,616,121,52,61,89,200,1044,1315,1.36,0.58,2023,24,13.736842105263158,1.3595505617977528,455,35,490,1.2571428571428571
2023-24,RegularSeason,1629014,89,Anfernee Simons,1610612757,POR,46,1582,360,837,0.43,156,405,0.385,163,178,0.916,22,145,167,255,23,5,126,98,1039,871,2.02,0.18,2023,24,22.58695652173913,2.0238095238095237,477,15,492,0.3394308943089431
2023-24,RegularSeason,1629636,90,Darius Garland,1610612739,CLE,57,1900,375,841,0.446,132,356,0.371,146,175,0.834,30,122,152,373,74,7,176,95,1028,963,2.12,0.42,2023,24,18.035087719298247,2.1193181818181817,466,29,495,0.30707070707070705
2023-24,RegularSeason,1628381,91,John Collins,1610612762,UTA,68,1901,397,746,0.532,86,232,0.371,147,185,0.795,157,418,575,77,40,61,98,191,1027,1295,0.79,0.41,2023,24,15.102941176470589,0.7857142857142857,349,38,387,1.4857881136950903
2023-24,RegularSeason,1628960,92,Grayson Allen,1610612756,PHX,75,2513,340,682,0.499,205,445,0.461,129,147,0.878,48,247,295,227,69,45,95,157,1014,1195,2.39,0.73,2023,24,13.52,2.389473684210526,342,18,360,0.8194444444444444
2023-24,RegularSeason,203932,93,Aaron Gordon,1610612743,DEN,73,2297,398,716,0.556,40,138,0.29,177,269,0.658,174,297,471,259,56,45,105,142,1013,1329,2.47,0.53,2023,24,13.876712328767123,2.466666666666667,318,92,410,1.148780487804878
2023-24,RegularSeason,1627741,93,Buddy Hield,1610612755,PHI,84,2160,371,850,0.436,219,568,0.386,52,59,0.881,61,208,269,236,70,42,103,169,1013,1041,2.29,0.68,2023,24,12.05952380952381,2.29126213592233,479,7,486,0.5534979423868313
2023-24,RegularSeason,202685,95,Jonas Valanciunas,1610612740,NOP,82,1925,402,719,0.559,37,120,0.308,161,205,0.785,186,535,721,173,32,68,111,218,1002,1524,1.56,0.29,2023,24,12.21951219512195,1.5585585585585586,317,44,361,1.997229916897507
2023-24,RegularSeason,203084,96,Harrison Barnes,1610612758,SAC,82,2381,347,732,0.474,149,385,0.387,157,196,0.801,67,182,249,99,54,12,58,98,1000,932,1.71,0.93,2023,24,12.195121951219512,1.706896551724138,385,39,424,0.5872641509433962
2023-24,RegularSeason,1630217,97,Desmond Bane,1610612763,MEM,42,1443,360,776,0.464,137,360,0.381,140,161,0.87,36,149,185,230,43,22,112,120,997,928,2.05,0.38,2023,24,23.738095238095237,2.0535714285714284,416,21,437,0.4233409610983982
2023-24,RegularSeason,201572,98,Brook Lopez,1610612749,MIL,79,2411,366,755,0.485,148,404,0.366,110,134,0.821,117,292,409,127,43,189,79,191,990,1266,1.61,0.54,2023,24,12.531645569620252,1.6075949367088607,389,24,413,0.9903147699757869
2023-24,RegularSeason,1630581,99,Josh Giddey,1610612760,OKC,80,2012,402,847,0.475,82,243,0.337,100,124,0.806,111,403,514,386,51,44,168,111,986,1344,2.3,0.3,2023,24,12.325,2.2976190476190474,445,24,469,1.095948827292111
2023-24,RegularSeason,1629018,100,Gary Trent Jr.,1610612761,TOR,71,1994,361,847,0.426,178,453,0.393,74,96,0.771,25,163,188,119,77,10,47,96,974,813,2.53,1.64,2023,24,13.71830985915493,2.5319148936170213,486,22,508,0.3700787401574803
2023-24,RegularSeason,1641718,100,Keyonte George,1610612762,UTA,75,2023,319,815,0.391,147,440,0.334,189,223,0.848,15,196,211,332,36,7,188,91,974,842,1.77,0.19,2023,24,12.986666666666666,1.7659574468085106,496,34,530,0.39811320754716983
2023-24,RegularSeason,203078,102,Bradley Beal,1610612756,PHX,53,1767,377,735,0.513,101,235,0.43,109,134,0.813,54,178,232,265,52,27,131,127,964,1026,2.02,0.4,2023,24,18.18867924528302,2.0229007633587788,358,25,383,0.6057441253263708
2023-24,RegularSeason,1627747,103,Caris LeVert,1610612739,CLE,68,1958,345,820,0.421,108,332,0.325,154,201,0.766,39,241,280,346,76,34,117,121,952,1049,2.96,0.65,2023,24,14.0,2.9572649572649574,475,47,522,0.5363984674329502
2023-24,RegularSeason,1630591,104,Jalen Suggs,1610612753,ORL,75,2025,336,714,0.471,153,385,0.397,118,156,0.756,48,181,229,205,106,47,132,205,943,982,1.55,0.8,2023,24,12.573333333333334,1.553030303030303,378,38,416,0.5504807692307693
2023-24,RegularSeason,203903,105,Jordan Clarkson,1610612762,UTA,55,1682,337,816,0.413,91,309,0.294,177,201,0.881,49,139,188,277,35,6,146,81,942,799,1.9,0.24,2023,24,17.12727272727273,1.8972602739726028,479,24,503,0.37375745526838966
2023-24,RegularSeason,203952,106,Andrew Wiggins,1610612744,GSW,71,1920,353,780,0.453,91,254,0.358,142,189,0.751,108,213,321,119,42,41,87,147,939,901,1.37,0.48,2023,24,13.225352112676056,1.367816091954023,427,47,474,0.6772151898734177
2023-24,RegularSeason,1629023,106,P.J. Washington,1610612742,DAL,73,2221,354,811,0.436,132,413,0.32,99,145,0.683,85,326,411,141,72,59,96,169,939,1023,1.47,0.75,2023,24,12.863013698630137,1.46875,457,46,503,0.8170974155069582
2023-24,RegularSeason,1630175,108,Cole Anthony,1610612753,ORL,81,1817,332,763,0.435,93,275,0.338,180,218,0.826,64,247,311,236,64,37,126,175,937,990,1.87,0.51,2023,24,11.567901234567902,1.873015873015873,431,38,469,0.6631130063965884
2023-24,RegularSeason,1630245,109,Ayo Dosunmu,1610612741,CHI,76,2212,360,719,0.501,119,295,0.403,85,105,0.81,54,162,216,242,68,36,103,166,924,1004,2.35,0.66,2023,24,12.157894736842104,2.349514563106796,359,20,379,0.5699208443271768
2023-24,RegularSeason,1629060,110,Rui Hachimura,1610612747,LAL,68,1825,363,676,0.537,98,232,0.422,99,134,0.739,58,236,294,81,41,25,46,101,923,970,1.76,0.89,2023,24,13.573529411764707,1.7608695652173914,313,35,348,0.8448275862068966
2023-24,RegularSeason,1629028,111,Deandre Ayton,1610612757,POR,55,1783,427,749,0.57,1,10,0.1,65,79,0.823,176,433,609,90,56,42,99,109,920,1282,0.91,0.57,2023,24,16.727272727272727,0.9090909090909091,322,14,336,1.8125
2023-24,RegularSeason,1628415,112,Dillon Brooks,1610612745,HOU,72,2227,329,768,0.428,133,370,0.359,124,147,0.844,53,193,246,119,64,10,88,241,915,804,1.35,0.73,2023,24,12.708333333333334,1.3522727272727273,439,23,462,0.5324675324675324
2023-24,RegularSeason,1630552,113,Jalen Johnson,1610612737,ATL,56,1889,359,702,0.511,71,200,0.355,107,147,0.728,74,414,488,203,67,47,101,133,896,1217,2.01,0.66,2023,24,16.0,2.00990099009901,343,40,383,1.2741514360313315
2023-24,RegularSeason,1629631,114,De'Andre Hunter,1610612737,ATL,57,1681,304,663,0.459,117,304,0.385,166,196,0.847,31,191,222,87,40,16,83,146,891,784,1.05,0.48,2023,24,15.631578947368421,1.0481927710843373,359,30,389,0.570694087403599
2023-24,RegularSeason,1631170,115,Jaime Jaquez Jr.,1610612748,MIA,75,2113,341,697,0.489,65,202,0.322,142,175,0.811,82,203,285,195,77,20,110,167,889,967,1.77,0.7,2023,24,11.853333333333333,1.7727272727272727,356,33,389,0.7326478149100257
2023-24,RegularSeason,1627736,115,Malik Beasley,1610612749,MIL,79,2337,320,722,0.443,224,542,0.413,25,35,0.714,41,249,290,108,59,9,54,158,889,889,2.0,1.09,2023,24,11.253164556962025,2.0,402,10,412,0.7038834951456311
2023-24,RegularSeason,1630174,117,Aaron Nesmith,1610612754,IND,72,1995,315,635,0.496,140,334,0.419,107,137,0.781,63,212,275,108,65,49,64,241,877,960,1.69,1.02,2023,24,12.180555555555555,1.6875,320,30,350,0.7857142857142857
2023-24,RegularSeason,1629130,118,Duncan Robinson,1610612748,MIA,68,1906,304,675,0.45,187,473,0.395,80,90,0.889,15,158,173,192,46,16,95,163,875,826,2.02,0.48,2023,24,12.867647058823529,2.0210526315789474,371,10,381,0.4540682414698163
2023-24,RegularSeason,1629639,118,Tyler Herro,1610612748,MIA,42,1407,324,735,0.441,132,333,0.396,95,111,0.856,19,203,222,188,30,3,93,63,875,798,2.02,0.32,2023,24,20.833333333333332,2.021505376344086,411,16,427,0.5199063231850117
2023-24,RegularSeason,201144,120,Mike Conley,1610612750,MIN,76,2193,294,644,0.457,179,405,0.442,102,112,0.911,37,181,218,449,88,17,102,128,869,1179,4.4,0.86,2023,24,11.43421052631579,4.401960784313726,350,10,360,0.6055555555555555
2023-24,RegularSeason,202711,121,Bojan Bogdanovic,1610612752,NYK,57,1478,309,681,0.454,133,334,0.398,117,149,0.785,22,130,152,97,30,5,101,95,868,647,0.96,0.3,2023,24,15.228070175438596,0.9603960396039604,372,32,404,0.37623762376237624
2023-24,RegularSeason,1629021,121,Moritz Wagner,1610612753,ORL,80,1415,332,552,0.601,38,115,0.33,166,204,0.814,117,230,347,96,39,21,97,160,868,1016,0.99,0.4,2023,24,10.85,0.9896907216494846,220,38,258,1.3449612403100775
2023-24,RegularSeason,1630703,121,Scoot Henderson,1610612757,POR,62,1765,307,797,0.385,87,268,0.325,167,204,0.819,53,141,194,336,48,13,212,195,868,720,1.58,0.23,2023,24,14.0,1.5849056603773586,490,37,527,0.3681214421252372
2023-24,RegularSeason,1630180,124,Saddiq Bey,1610612737,ATL,63,2062,290,697,0.416,113,358,0.316,170,203,0.837,167,244,411,92,51,11,54,88,863,934,1.7,0.94,2023,24,13.698412698412698,1.7037037037037037,407,33,440,0.9340909090909091
2023-24,RegularSeason,1631110,125,Jeremy Sochan,1610612759,SAS,74,2193,340,776,0.438,70,227,0.308,111,144,0.771,137,339,476,249,62,40,140,168,861,1079,1.78,0.44,2023,24,11.635135135135135,1.7785714285714285,436,33,469,1.0149253731343284
2023-24,RegularSeason,201950,126,Jrue Holiday,1610612738,BOS,69,2263,331,689,0.48,138,322,0.429,60,72,0.833,84,289,373,333,61,53,124,108,860,1186,2.69,0.49,2023,24,12.46376811594203,2.685483870967742,358,12,370,1.008108108108108
2023-24,RegularSeason,1629652,126,Luguentz Dort,1610612760,OKC,79,2246,288,657,0.438,156,396,0.394,128,155,0.826,74,210,284,113,72,47,74,228,860,906,1.53,0.97,2023,24,10.886075949367088,1.527027027027027,369,27,396,0.7171717171717171
2023-24,RegularSeason,1631097,128,Bennedict Mathurin,1610612754,IND,59,1538,296,663,0.446,80,214,0.374,184,224,0.821,60,174,234,119,35,14,97,117,856,754,1.23,0.36,2023,24,14.508474576271187,1.2268041237113403,367,40,407,0.5749385749385749
2023-24,RegularSeason,1629622,129,Max Strus,1610612739,CLE,70,2239,304,728,0.418,168,479,0.351,77,97,0.794,66,272,338,283,64,29,112,170,853,1011,2.53,0.57,2023,24,12.185714285714285,2.5267857142857144,424,20,444,0.7612612612612613
2023-24,RegularSeason,1630167,130,Obi Toppin,1610612754,IND,82,1731,332,579,0.573,102,253,0.403,77,100,0.77,85,235,320,128,47,43,69,143,843,1042,1.85,0.68,2023,24,10.28048780487805,1.855072463768116,247,23,270,1.1851851851851851
2023-24,RegularSeason,1630530,131,Trey Murphy III,1610612740,NOP,57,1690,275,621,0.443,169,445,0.38,123,151,0.815,42,238,280,124,51,28,34,70,842,917,3.65,1.5,2023,24,14.771929824561404,3.6470588235294117,346,28,374,0.7486631016042781
2023-24,RegularSeason,1631105,132,Jalen Duren,1610612765,DET,61,1777,349,564,0.619,0,4,0.0,143,181,0.79,192,517,709,147,33,47,129,192,841,1395,1.14,0.26,2023,24,13.78688524590164,1.1395348837209303,215,38,253,2.802371541501976
2023-24,RegularSeason,1629651,132,Nic Claxton,1610612751,BKN,71,2116,366,582,0.629,1,5,0.2,108,196,0.551,193,513,706,147,46,146,93,175,841,1489,1.58,0.49,2023,24,11.845070422535212,1.5806451612903225,216,88,304,2.3223684210526314
2023-24,RegularSeason,1630529,134,Herbert Jones,1610612740,NOP,76,2321,293,588,0.498,114,273,0.418,137,158,0.867,74,198,272,199,105,62,93,224,837,1066,2.14,1.13,2023,24,11.013157894736842,2.139784946236559,295,21,316,0.8607594936708861
2023-24,RegularSeason,203991,135,Clint Capela,1610612737,ATL,73,1883,353,618,0.571,0,1,0.0,130,206,0.631,335,441,776,91,43,106,74,164,836,1437,1.23,0.58,2023,24,11.452054794520548,1.2297297297297298,265,76,341,2.275659824046921
2023-24,RegularSeason,202704,136,Reggie Jackson,1610612743,DEN,82,1817,326,756,0.431,102,284,0.359,79,98,0.806,33,122,155,308,44,13,106,149,833,798,2.91,0.41,2023,24,10.158536585365853,2.9056603773584904,430,19,449,0.34521158129175944
2023-24,RegularSeason,203994,137,Jusuf Nurkic,1610612756,PHX,76,2078,320,627,0.51,22,90,0.244,167,261,0.64,224,613,837,301,81,80,175,254,829,1552,1.72,0.46,2023,24,10.907894736842104,1.72,307,94,401,2.0872817955112217
2023-24,RegularSeason,203114,138,Khris Middleton,1610612749,MIL,55,1487,317,643,0.493,94,247,0.381,100,120,0.833,40,217,257,292,51,15,127,141,828,970,2.3,0.4,2023,24,15.054545454545455,2.2992125984251968,326,20,346,0.7427745664739884
2023-24,RegularSeason,1629655,139,Daniel Gafford,1610612742,DAL,74,1814,348,480,0.725,0,0,0.0,118,175,0.674,195,367,562,115,65,153,74,227,814,1446,1.55,0.88,2023,24,11.0,1.554054054054054,132,57,189,2.9735449735449735
2023-24,RegularSeason,203915,140,Spencer Dinwiddie,1610612747,LAL,76,2152,251,640,0.392,124,368,0.337,169,210,0.805,30,175,205,356,51,22,91,138,795,908,3.91,0.56,2023,24,10.460526315789474,3.912087912087912,389,41,430,0.47674418604651164
2023-24,RegularSeason,1627826,141,Ivica Zubac,1610612746,LAC,68,1795,337,519,0.649,0,0,0.0,120,166,0.723,196,430,626,93,22,83,79,180,794,1311,1.18,0.28,2023,24,11.676470588235293,1.1772151898734178,182,46,228,2.745614035087719
2023-24,RegularSeason,1626145,142,Tyus Jones,1610612764,WAS,66,1933,326,666,0.489,106,256,0.414,32,40,0.8,20,159,179,485,71,18,66,48,790,1129,7.35,1.08,2023,24,11.969696969696969,7.348484848484849,340,8,348,0.514367816091954
2023-24,RegularSeason,1630202,143,Payton Pritchard,1610612738,BOS,82,1826,297,635,0.468,147,382,0.385,46,56,0.821,70,195,265,281,39,6,61,106,787,969,4.61,0.64,2023,24,9.597560975609756,4.60655737704918,338,10,348,0.7614942528735632
2023-24,RegularSeason,1630596,144,Evan Mobley,1610612739,CLE,50,1532,320,552,0.58,22,59,0.373,123,171,0.719,111,357,468,160,45,72,90,134,785,1160,1.78,0.5,2023,24,15.7,1.7777777777777777,232,48,280,1.6714285714285715
2023-24,RegularSeason,1629684,145,Grant Williams,1610612766,CHA,76,2130,276,605,0.456,126,336,0.375,106,140,0.757,86,232,318,174,44,39,109,226,784,887,1.6,0.4,2023,24,10.31578947368421,1.5963302752293578,329,34,363,0.8760330578512396
2023-24,RegularSeason,1629661,146,Cameron Johnson,1610612751,BKN,58,1599,276,619,0.446,138,353,0.391,86,109,0.789,55,196,251,138,49,15,57,105,776,806,2.42,0.86,2023,24,13.379310344827585,2.4210526315789473,343,23,366,0.6857923497267759
2023-24,RegularSeason,1628380,146,Zach Collins,1610612759,SAS,69,1526,298,616,0.484,58,181,0.32,122,162,0.753,118,252,370,194,34,52,132,206,776,936,1.47,0.26,2023,24,11.246376811594203,1.4696969696969697,318,40,358,1.0335195530726258
2023-24,RegularSeason,1630200,148,Tre Jones,1610612759,SAS,77,2138,303,600,0.505,64,191,0.335,101,118,0.856,58,231,289,478,78,9,116,92,771,1195,4.12,0.67,2023,24,10.012987012987013,4.120689655172414,297,17,314,0.9203821656050956
2023-24,RegularSeason,1627777,149,Georges Niang,1610612739,CLE,82,1831,284,632,0.449,149,396,0.376,51,60,0.85,22,256,278,98,30,18,72,192,768,763,1.36,0.42,2023,24,9.365853658536585,1.3611111111111112,348,9,357,0.7787114845938375
2023-24,RegularSeason,203484,150,Kentavious Caldwell-Pope,1610612743,DEN,76,2402,270,587,0.46,125,308,0.406,101,113,0.894,31,152,183,183,98,42,75,151,766,868,2.44,1.31,2023,24,10.078947368421053,2.44,317,12,329,0.5562310030395137
2023-24,RegularSeason,203482,151,Kelly Olynyk,1610612761,TOR,78,1759,276,497,0.555,60,155,0.387,150,180,0.833,108,303,411,347,74,30,152,230,762,1221,2.28,0.49,2023,24,9.76923076923077,2.2828947368421053,221,30,251,1.6374501992031874
2023-24,RegularSeason,1628404,152,Josh Hart,1610612752,NYK,81,2707,295,679,0.434,80,258,0.31,91,115,0.791,128,547,675,331,75,23,118,171,761,1339,2.81,0.64,2023,24,9.395061728395062,2.805084745762712,384,24,408,1.6544117647058822
2023-24,RegularSeason,1630183,153,Jaden McDaniels,1610612750,MIN,72,2105,307,628,0.489,86,255,0.337,57,79,0.722,56,168,224,101,63,42,87,219,757,757,1.16,0.72,2023,24,10.51388888888889,1.160919540229885,321,22,343,0.6530612244897959
2023-24,RegularSeason,201566,154,Russell Westbrook,1610612746,LAC,68,1529,301,663,0.454,42,154,0.273,110,160,0.688,93,250,343,306,74,23,144,121,754,944,2.13,0.51,2023,24,11.088235294117647,2.125,362,50,412,0.8325242718446602
2023-24,RegularSeason,201569,155,Eric Gordon,1610612756,PHX,68,1893,274,618,0.443,150,397,0.378,51,64,0.797,16,106,122,139,66,30,73,79,749,676,1.9,0.9,2023,24,11.014705882352942,1.904109589041096,344,13,357,0.34173669467787116
2023-24,RegularSeason,1628384,156,OG Anunoby,1610612752,NYK,50,1702,282,577,0.489,102,267,0.382,67,89,0.753,47,161,208,107,68,36,81,119,733,754,1.32,0.84,2023,24,14.66,1.3209876543209877,295,22,317,0.6561514195583596
2023-24,RegularSeason,204456,157,T.J. McConnell,1610612754,IND,71,1291,330,593,0.556,18,44,0.409,49,62,0.79,36,155,191,390,72,8,108,79,727,1004,3.61,0.67,2023,24,10.23943661971831,3.611111111111111,263,13,276,0.6920289855072463
2023-24,RegularSeason,1628971,158,Bruce Brown,1610612761,TOR,67,1865,278,582,0.478,53,164,0.323,117,142,0.824,53,231,284,192,59,17,86,148,726,863,2.23,0.69,2023,24,10.835820895522389,2.2325581395348837,304,25,329,0.8632218844984803
2023-24,RegularSeason,1627936,159,Alex Caruso,1610612741,CHI,71,2040,253,541,0.468,136,333,0.408,73,96,0.76,62,211,273,247,120,70,102,181,715,1012,2.42,1.18,2023,24,10.070422535211268,2.4215686274509802,288,23,311,0.8778135048231511
2023-24,RegularSeason,1630573,160,Sam Hauser,1610612738,BOS,79,1741,249,558,0.446,197,465,0.424,17,19,0.895,45,231,276,82,40,25,32,99,712,792,2.56,1.25,2023,24,9.012658227848101,2.5625,309,2,311,0.887459807073955
2023-24,RegularSeason,1641713,161,GG Jackson II,1610612763,MEM,48,1233,241,563,0.428,102,286,0.357,115,153,0.752,53,143,196,59,28,24,65,64,699,581,0.91,0.43,2023,24,14.5625,0.9076923076923077,322,38,360,0.5444444444444444
2023-24,RegularSeason,1627752,162,Taurean Prince,1610612747,LAL,78,2108,253,572,0.442,141,356,0.396,50,68,0.735,21,209,230,119,58,35,73,146,697,729,1.63,0.8,2023,24,8.935897435897436,1.63013698630137,319,18,337,0.6824925816023739
2023-24,RegularSeason,1631323,163,Simone Fontecchio,1610612765,DET,66,1644,252,548,0.46,134,334,0.401,54,66,0.818,64,182,246,101,44,23,68,110,692,730,1.49,0.65,2023,24,10.484848484848484,1.4852941176470589,296,12,308,0.7987012987012987
2023-24,RegularSeason,1631103,164,Malaki Branham,1610612759,SAS,75,1594,271,628,0.432,93,268,0.347,55,63,0.873,28,120,148,156,27,8,91,94,690,573,1.71,0.3,2023,24,9.2,1.7142857142857142,357,8,365,0.4054794520547945
2023-24,RegularSeason,202692,165,Alec Burks,1610612752,NYK,66,1212,210,569,0.369,124,330,0.376,145,167,0.868,24,126,150,88,28,12,48,75,689,538,1.83,0.58,2023,24,10.43939393939394,1.8333333333333333,359,22,381,0.3937007874015748
2023-24,RegularSeason,1641764,166,Brandin Podziemski,1610612744,GSW,74,1968,271,597,0.454,90,234,0.385,50,79,0.633,118,309,427,273,61,14,88,122,682,1014,3.1,0.69,2023,24,9.216216216216216,3.102272727272727,326,29,355,1.2028169014084507
2023-24,RegularSeason,203083,167,Andre Drummond,1610612741,CHI,79,1351,267,480,0.556,0,3,0.0,129,218,0.592,265,443,708,37,73,48,81,140,663,1146,0.46,0.9,2023,24,8.39240506329114,0.4567901234567901,213,89,302,2.3443708609271523
2023-24,RegularSeason,1629611,168,Terance Mann,1610612746,LAC,75,1873,254,493,0.515,71,204,0.348,79,95,0.832,87,167,254,119,43,15,48,145,658,786,2.48,0.9,2023,24,8.773333333333333,2.4791666666666665,239,16,255,0.996078431372549
2023-24,RegularSeason,1627884,169,Derrick Jones Jr.,1610612742,DAL,76,1783,239,495,0.483,82,239,0.343,97,136,0.713,82,168,250,75,53,51,65,121,657,726,1.15,0.81,2023,24,8.644736842105264,1.1538461538461537,256,39,295,0.847457627118644
2023-24,RegularSeason,1628989,170,Kevin Huerter,1610612758,SAC,64,1562,248,560,0.443,123,341,0.361,36,47,0.766,38,186,224,166,45,23,53,135,655,737,3.13,0.85,2023,24,10.234375,3.1320754716981134,312,11,323,0.6934984520123839
2023-24,RegularSeason,1629638,170,Nickeil Alexander-Walker,1610612750,MIN,82,1921,236,538,0.439,131,335,0.391,52,65,0.8,35,132,167,204,64,42,76,143,655,741,2.68,0.84,2023,24,7.987804878048781,2.6842105263157894,302,13,315,0.5301587301587302
2023-24,RegularSeason,1630583,172,Santi Aldama,1610612763,MEM,61,1618,247,568,0.435,106,304,0.349,54,87,0.621,72,280,352,138,43,54,69,89,654,818,2.0,0.62,2023,24,10.721311475409836,2.0,321,33,354,0.9943502824858758
2023-24,RegularSeason,1630208,173,Nick Richards,1610612766,CHA,67,1759,260,376,0.691,0,1,0.0,132,179,0.737,172,367,539,54,26,74,73,176,652,1109,0.74,0.36,2023,24,9.73134328358209,0.7397260273972602,116,47,163,3.3067484662576687
2023-24,RegularSeason,1630171,174,Isaac Okoro,1610612739,CLE,69,1887,235,480,0.49,84,215,0.391,93,137,0.679,67,139,206,132,57,34,54,140,647,733,2.44,1.06,2023,24,9.376811594202898,2.4444444444444446,245,44,289,0.71280276816609
2023-24,RegularSeason,1628997,175,Caleb Martin,1610612748,MIA,64,1757,241,559,0.431,81,232,0.349,77,99,0.778,74,207,281,143,47,29,77,126,640,723,1.86,0.61,2023,24,10.0,1.8571428571428572,318,22,340,0.8264705882352941
2023-24,RegularSeason,1631133,176,Jabari Walker,1610612757,POR,72,1701,234,509,0.46,41,139,0.295,129,171,0.754,151,357,508,71,42,22,66,173,638,898,1.08,0.64,2023,24,8.86111111111111,1.0757575757575757,275,42,317,1.6025236593059937
2023-24,RegularSeason,1630198,177,Isaiah Joe,1610612760,OKC,78,1445,222,485,0.458,147,353,0.416,45,52,0.865,32,148,180,99,46,22,47,87,636,666,2.11,0.98,2023,24,8.153846153846153,2.106382978723404,263,7,270,0.6666666666666666
2023-24,RegularSeason,1629614,178,Andrew Nembhard,1610612754,IND,68,1697,260,522,0.498,61,171,0.357,45,56,0.804,36,105,141,280,63,6,101,143,626,742,2.77,0.62,2023,24,9.205882352941176,2.772277227722772,262,11,273,0.5164835164835165
2023-24,RegularSeason,1641871,179,Duop Reath,1610612757,POR,68,1214,230,499,0.461,88,245,0.359,69,93,0.742,93,157,250,67,33,38,52,161,617,660,1.29,0.64,2023,24,9.073529411764707,1.2884615384615385,269,24,293,0.8532423208191127
2023-24,RegularSeason,1627763,180,Malcolm Brogdon,1610612757,POR,39,1121,218,496,0.44,82,199,0.412,95,116,0.819,28,120,148,214,27,8,60,58,613,651,3.57,0.45,2023,24,15.717948717948717,3.566666666666667,278,21,299,0.49498327759197325
2023-24,RegularSeason,1626220,181,Royce O'Neale,1610612756,PHX,79,1954,214,539,0.397,156,422,0.37,24,35,0.686,60,317,377,219,59,44,73,174,608,898,3.0,0.81,2023,24,7.69620253164557,3.0,325,11,336,1.1220238095238095
2023-24,RegularSeason,1628976,182,Wendell Carter Jr.,1610612753,ORL,55,1406,223,425,0.525,64,171,0.374,93,134,0.694,112,269,381,95,35,28,68,121,603,831,1.4,0.52,2023,24,10.963636363636363,1.3970588235294117,202,41,243,1.5679012345679013
2023-24,RegularSeason,1630188,183,Jalen Smith,1610612754,IND,61,1047,234,395,0.592,61,144,0.424,72,104,0.692,112,225,337,63,17,38,44,124,601,819,1.43,0.39,2023,24,9.852459016393443,1.4318181818181819,161,32,193,1.7461139896373057
2023-24,RegularSeason,1631128,184,Christian Braun,1610612743,DEN,82,1656,222,483,0.46,63,164,0.384,93,134,0.694,79,227,306,132,42,35,55,137,600,758,2.4,0.76,2023,24,7.317073170731708,2.4,261,41,302,1.0132450331125828
2023-24,RegularSeason,1630194,184,Paul Reed,1610612755,PHI,82,1589,259,480,0.54,21,57,0.368,61,85,0.718,193,295,488,109,67,84,67,198,600,1036,1.63,1.0,2023,24,7.317073170731708,1.626865671641791,221,24,245,1.9918367346938775
2023-24,RegularSeason,1641708,186,Amen Thompson,1610612745,HOU,62,1389,239,446,0.536,8,58,0.138,106,155,0.684,148,261,409,163,78,38,90,141,592,934,1.81,0.87,2023,24,9.548387096774194,1.8111111111111111,207,49,256,1.59765625
2023-24,RegularSeason,1631204,187,Marcus Sasser,1610612765,DET,71,1351,219,512,0.428,90,240,0.375,58,66,0.879,11,114,125,236,44,12,90,103,586,612,2.62,0.49,2023,24,8.253521126760564,2.6222222222222222,293,8,301,0.4152823920265781
2023-24,RegularSeason,1628963,188,Marvin Bagley III,1610612764,WAS,50,1053,239,408,0.586,9,23,0.391,96,126,0.762,130,182,312,55,20,33,59,81,583,745,0.93,0.34,2023,24,11.66,0.9322033898305084,169,30,199,1.5678391959798994
2023-24,RegularSeason,1628392,189,Isaiah Hartenstein,1610612752,NYK,75,1896,235,365,0.644,1,3,0.333,111,157,0.707,244,382,626,188,87,85,93,210,582,1299,2.02,0.94,2023,24,7.76,2.021505376344086,130,46,176,3.5568181818181817
2023-24,RegularSeason,1627827,190,Dorian Finney-Smith,1610612751,BKN,68,1935,215,511,0.421,117,336,0.348,33,46,0.717,109,208,317,107,56,38,59,150,580,730,1.81,0.95,2023,24,8.529411764705882,1.8135593220338984,296,13,309,1.0258899676375404
2023-24,RegularSeason,1641715,191,Cam Whitmore,1610612745,HOU,47,880,212,467,0.454,79,220,0.359,76,112,0.679,44,136,180,33,30,17,46,64,579,502,0.72,0.65,2023,24,12.319148936170214,0.717391304347826,255,36,291,0.6185567010309279
2023-24,RegularSeason,1626166,192,Cameron Payne,1610612755,PHI,78,1304,208,481,0.432,104,267,0.39,58,67,0.866,21,96,117,205,42,11,66,126,578,605,3.11,0.64,2023,24,7.410256410256411,3.106060606060606,273,9,282,0.4148936170212766
2023-24,RegularSeason,1629022,193,Lonnie Walker IV,1610612751,BKN,58,1011,208,492,0.423,104,271,0.384,45,59,0.763,13,114,127,74,32,20,51,71,565,469,1.45,0.63,2023,24,9.741379310344827,1.4509803921568627,284,14,298,0.4261744966442953
2023-24,RegularSeason,1630173,193,Precious Achiuwa,1610612752,NYK,74,1624,235,469,0.501,26,97,0.268,69,112,0.616,191,296,487,97,46,68,83,143,565,903,1.17,0.55,2023,24,7.635135135135135,1.1686746987951808,234,43,277,1.7581227436823104
2023-24,RegularSeason,201143,195,Al Horford,1610612738,BOS,65,1740,214,419,0.511,108,258,0.419,26,30,0.867,82,331,413,168,38,62,48,93,562,986,3.5,0.79,2023,24,8.646153846153846,3.5,205,4,209,1.9760765550239234
2023-24,RegularSeason,1630540,195,Miles McBride,1610612752,NYK,68,1328,205,454,0.452,109,266,0.41,43,50,0.86,31,69,100,114,50,7,30,108,562,547,3.8,1.67,2023,24,8.264705882352942,3.8,249,7,256,0.390625
2023-24,RegularSeason,1641717,197,Cason Wallace,1610612760,OKC,82,1692,217,442,0.491,98,234,0.419,29,37,0.784,52,135,187,120,76,37,45,129,561,703,2.67,1.69,2023,24,6.841463414634147,2.6666666666666665,225,8,233,0.8025751072961373
2023-24,RegularSeason,1630168,197,Onyeka Okongwu,1610612737,ATL,55,1405,223,365,0.611,23,69,0.333,92,116,0.793,145,231,376,74,26,60,45,162,561,886,1.64,0.58,2023,24,10.2,1.6444444444444444,142,24,166,2.2650602409638556
2023-24,RegularSeason,1630625,199,Dalano Banton,1610612757,POR,54,1047,202,500,0.404,59,199,0.296,94,120,0.783,41,137,178,127,33,20,77,64,557,514,1.65,0.43,2023,24,10.314814814814815,1.6493506493506493,298,26,324,0.5493827160493827
2023-24,RegularSeason,1641709,200,Ausar Thompson,1610612765,DET,63,1583,232,480,0.483,21,113,0.186,71,119,0.597,129,273,402,120,68,59,84,175,556,825,1.43,0.81,2023,24,8.825396825396826,1.4285714285714286,248,48,296,1.3581081081081081
2023-24,RegularSeason,1627751,201,Jakob Poeltl,1610612761,TOR,50,1319,248,378,0.656,0,0,0.0,59,107,0.551,146,283,429,127,35,76,77,149,555,967,1.65,0.46,2023,24,11.1,1.6493506493506493,130,48,178,2.4101123595505616
2023-24,RegularSeason,1630598,202,Aaron Wiggins,1610612760,OKC,78,1228,212,377,0.562,62,126,0.492,56,71,0.789,60,126,186,86,56,19,56,91,542,653,1.54,1.0,2023,24,6.948717948717949,1.5357142857142858,165,15,180,1.0333333333333334
2023-24,RegularSeason,1631218,203,Trayce Jackson-Davis,1610612744,GSW,68,1130,233,332,0.702,0,1,0.0,74,132,0.561,135,206,341,82,29,76,49,108,540,862,1.67,0.59,2023,24,7.9411764705882355,1.6734693877551021,99,58,157,2.171974522292994
2023-24,RegularSeason,101108,204,Chris Paul,1610612744,GSW,58,1531,206,467,0.441,78,210,0.371,43,52,0.827,18,207,225,393,70,6,76,108,533,881,5.17,0.92,2023,24,9.189655172413794,5.171052631578948,261,9,270,0.8333333333333334
2023-24,RegularSeason,1630541,204,Moses Moody,1610612744,GSW,66,1156,194,420,0.462,72,200,0.36,73,93,0.785,65,131,196,57,42,24,44,90,533,562,1.29,0.95,2023,24,8.075757575757576,1.2954545454545454,226,20,246,0.7967479674796748
2023-24,RegularSeason,1641731,206,Bilal Coulibaly,1610612764,WAS,63,1715,188,432,0.435,64,185,0.346,92,131,0.702,56,200,256,110,57,48,87,137,532,633,1.26,0.66,2023,24,8.444444444444445,1.264367816091954,244,39,283,0.9045936395759717
2023-24,RegularSeason,1631212,206,Peyton Watson,1610612743,DEN,80,1488,208,447,0.465,45,152,0.296,71,106,0.67,56,202,258,86,42,88,58,143,532,674,1.48,0.72,2023,24,6.65,1.4827586206896552,239,35,274,0.9416058394160584
2023-24,RegularSeason,1630702,208,Jaden Hardy,1610612742,DAL,73,989,195,479,0.407,81,224,0.362,59,76,0.776,20,111,131,109,22,4,62,80,530,433,1.76,0.35,2023,24,7.260273972602739,1.7580645161290323,284,17,301,0.43521594684385384
2023-24,RegularSeason,1641739,209,Toumani Camara,1610612757,POR,70,1739,197,438,0.45,58,172,0.337,75,99,0.758,139,204,343,87,66,33,84,174,527,707,1.04,0.79,2023,24,7.5285714285714285,1.0357142857142858,241,24,265,1.2943396226415094
2023-24,RegularSeason,1630163,210,LaMelo Ball,1610612766,CHA,22,711,183,423,0.433,70,197,0.355,90,104,0.865,29,84,113,176,40,4,83,79,526,522,2.12,0.48,2023,24,23.90909090909091,2.1204819277108435,240,14,254,0.4448818897637795
2023-24,RegularSeason,1641722,211,Jordan Hawkins,1610612740,NOP,67,1161,174,456,0.382,109,298,0.366,67,80,0.838,29,119,148,70,19,7,40,72,524,433,1.75,0.47,2023,24,7.82089552238806,1.75,282,13,295,0.5016949152542373
2023-24,RegularSeason,1631246,212,Vince Williams Jr.,1610612763,MEM,52,1437,169,379,0.446,79,209,0.378,104,130,0.8,59,231,290,175,47,34,92,135,521,739,1.9,0.51,2023,24,10.01923076923077,1.9021739130434783,210,26,236,1.228813559322034
2023-24,RegularSeason,1631117,213,Walker Kessler,1610612762,UTA,64,1493,229,350,0.654,4,19,0.211,56,93,0.602,165,316,481,60,30,154,66,132,518,1019,0.91,0.46,2023,24,8.09375,0.9090909090909091,121,37,158,3.0443037974683542
2023-24,RegularSeason,1629659,214,Talen Horton-Tucker,1610612762,UTA,51,1009,184,465,0.396,60,182,0.33,88,109,0.807,21,100,121,177,45,19,65,94,516,511,2.72,0.69,2023,24,10.117647058823529,2.723076923076923,281,21,302,0.40066225165562913
2023-24,RegularSeason,203967,215,Dario Saric,1610612744,GSW,64,1098,181,388,0.466,74,197,0.376,79,93,0.849,73,210,283,144,31,10,78,112,515,684,1.85,0.4,2023,24,8.046875,1.8461538461538463,207,14,221,1.2805429864253393
2023-24,RegularSeason,1628988,216,Aaron Holiday,1610612745,HOU,78,1269,186,417,0.446,84,217,0.387,58,63,0.921,23,100,123,140,42,6,53,125,514,536,2.64,0.79,2023,24,6.589743589743589,2.641509433962264,231,5,236,0.5211864406779662
2023-24,RegularSeason,1641711,217,Gradey Dick,1610612761,TOR,60,1268,189,445,0.425,88,241,0.365,44,51,0.863,27,105,132,68,34,2,50,87,510,433,1.36,0.68,2023,24,8.5,1.36,256,7,263,0.5019011406844106
2023-24,RegularSeason,1631101,217,Shaedon Sharpe,1610612757,POR,32,1059,176,434,0.406,60,180,0.333,98,119,0.824,42,118,160,94,28,12,72,88,510,453,1.31,0.39,2023,24,15.9375,1.3055555555555556,258,21,279,0.5734767025089605
2023-24,RegularSeason,201145,219,Jeff Green,1610612745,HOU,78,1307,167,366,0.456,53,160,0.331,122,149,0.819,46,132,178,70,16,31,46,100,509,532,1.52,0.35,2023,24,6.5256410256410255,1.5217391304347827,199,27,226,0.7876106194690266
2023-24,RegularSeason,203937,220,Kyle Anderson,1610612750,MIN,79,1782,199,433,0.46,11,48,0.229,97,137,0.708,60,213,273,331,71,47,91,128,506,863,3.64,0.78,2023,24,6.405063291139241,3.6373626373626373,234,40,274,0.9963503649635036
2023-24,RegularSeason,1630577,221,Julian Champagnie,1610612759,SAS,74,1468,164,402,0.408,101,277,0.365,75,92,0.815,42,164,206,103,48,42,57,77,504,591,1.81,0.84,2023,24,6.8108108108108105,1.8070175438596492,238,17,255,0.807843137254902
2023-24,RegularSeason,1630191,222,Isaiah Stewart,1610612765,DET,46,1423,186,382,0.487,67,175,0.383,64,85,0.753,74,231,305,73,17,38,66,99,503,653,1.11,0.26,2023,24,10.934782608695652,1.106060606060606,196,21,217,1.4055299539170507
2023-24,RegularSeason,202330,223,Gordon Hayward,1610612760,OKC,51,1245,187,403,0.464,37,90,0.411,89,120,0.742,38,143,181,158,40,13,66,67,500,579,2.39,0.61,2023,24,9.803921568627452,2.393939393939394,216,31,247,0.7327935222672065
2023-24,RegularSeason,1626224,224,Cedi Osman,1610612759,SAS,72,1269,184,384,0.479,86,221,0.389,35,52,0.673,25,155,180,119,36,11,47,107,489,571,2.53,0.77,2023,24,6.791666666666667,2.5319148936170213,200,17,217,0.8294930875576036
2023-24,RegularSeason,200768,225,Kyle Lowry,1610612755,PHI,60,1690,163,377,0.432,98,250,0.392,63,75,0.84,34,160,194,253,59,21,85,146,487,703,2.98,0.69,2023,24,8.116666666666667,2.976470588235294,214,12,226,0.8584070796460177
2023-24,RegularSeason,203897,225,Zach LaVine,1610612741,CHI,25,872,170,376,0.452,59,169,0.349,88,103,0.854,8,121,129,98,21,8,52,57,487,470,1.89,0.4,2023,24,19.48,1.8846153846153846,206,15,221,0.583710407239819
2023-24,RegularSeason,201567,227,Kevin Love,1610612748,MIA,55,924,158,359,0.44,84,244,0.344,85,108,0.787,59,279,338,115,18,10,48,97,485,694,2.4,0.38,2023,24,8.818181818181818,2.3958333333333335,201,23,224,1.5089285714285714
2023-24,RegularSeason,1630241,227,Sam Merrill,1610612739,CLE,61,1069,158,393,0.402,143,354,0.404,26,28,0.929,22,98,120,108,19,4,19,72,485,480,5.68,1.0,2023,24,7.950819672131147,5.684210526315789,235,2,237,0.5063291139240507
2023-24,RegularSeason,1641726,229,Dereck Lively II,1610612742,DAL,55,1294,221,296,0.747,0,2,0.0,41,81,0.506,135,243,378,60,36,77,50,144,483,869,1.2,0.72,2023,24,8.781818181818181,1.2,75,40,115,3.2869565217391306
2023-24,RegularSeason,203110,230,Draymond Green,1610612744,GSW,55,1490,185,372,0.497,51,129,0.395,54,74,0.73,76,322,398,332,55,47,135,166,475,965,2.46,0.41,2023,24,8.636363636363637,2.4592592592592593,187,20,207,1.922705314009662
2023-24,RegularSeason,1630182,231,Josh Green,1610612742,DAL,57,1505,179,374,0.479,72,187,0.385,39,57,0.684,40,144,184,130,47,9,60,107,469,566,2.17,0.78,2023,24,8.228070175438596,2.1666666666666665,195,18,213,0.863849765258216
2023-24,RegularSeason,1630230,232,Naji Marshall,1610612740,NOP,66,1257,170,367,0.463,58,150,0.387,68,86,0.791,53,187,240,128,49,12,65,91,466,615,1.97,0.75,2023,24,7.0606060606060606,1.9692307692307693,197,18,215,1.1162790697674418
2023-24,RegularSeason,1629599,233,Amir Coffey,1610612746,LAC,70,1461,166,352,0.472,70,184,0.38,61,71,0.859,29,119,148,76,41,14,33,102,463,513,2.3,1.24,2023,24,6.614285714285714,2.303030303030303,186,10,196,0.7551020408163265
2023-24,RegularSeason,1630534,234,Ochai Agbaji,1610612761,TOR,78,1642,178,433,0.411,62,211,0.294,37,56,0.661,74,142,216,83,47,44,64,117,455,507,1.3,0.73,2023,24,5.833333333333333,1.296875,255,19,274,0.7883211678832117
2023-24,RegularSeason,201976,235,Patrick Beverley,1610612749,MIL,73,1463,158,379,0.417,61,181,0.337,74,90,0.822,49,190,239,212,43,31,65,128,451,674,3.26,0.66,2023,24,6.178082191780822,3.2615384615384615,221,16,237,1.0084388185654007
2023-24,RegularSeason,1630164,236,James Wiseman,1610612765,DET,63,1091,187,305,0.613,0,2,0.0,72,102,0.706,110,226,336,54,12,39,66,141,446,673,0.82,0.18,2023,24,7.079365079365079,0.8181818181818182,118,30,148,2.27027027027027
2023-24,RegularSeason,1630570,237,Trendon Watford,1610612751,BKN,63,857,164,311,0.527,27,68,0.397,77,97,0.794,52,142,194,81,23,19,63,106,432,519,1.29,0.36,2023,24,6.857142857142857,1.2857142857142858,147,20,167,1.1616766467065869
2023-24,RegularSeason,1628379,238,Luke Kennard,1610612763,MEM,39,999,141,315,0.448,107,238,0.45,40,45,0.889,11,102,113,136,20,2,54,39,429,467,2.52,0.37,2023,24,11.0,2.5185185185185186,174,5,179,0.6312849162011173
2023-24,RegularSeason,1630172,238,Patrick Williams,1610612741,CHI,43,1174,159,359,0.443,59,148,0.399,52,66,0.788,46,120,166,66,40,33,57,87,429,463,1.16,0.7,2023,24,9.976744186046512,1.1578947368421053,200,14,214,0.7757009345794392
2023-24,RegularSeason,203957,240,Dante Exum,1610612742,DAL,55,1088,161,302,0.533,53,108,0.491,53,68,0.779,25,124,149,157,22,5,49,85,428,556,3.2,0.45,2023,24,7.781818181818182,3.204081632653061,141,15,156,0.9551282051282052
2023-24,RegularSeason,1626192,240,Pat Connaughton,1610612749,MIL,76,1676,151,347,0.435,82,238,0.345,44,58,0.759,51,188,239,161,40,19,49,99,428,628,3.29,0.82,2023,24,5.631578947368421,3.2857142857142856,196,14,210,1.138095238095238
2023-24,RegularSeason,1631223,242,David Roddy,1610612756,PHX,65,1177,165,409,0.403,48,164,0.293,47,68,0.691,53,158,211,80,27,11,57,72,425,432,1.4,0.47,2023,24,6.538461538461538,1.4035087719298245,244,21,265,0.7962264150943397
2023-24,RegularSeason,1626196,242,Josh Richardson,1610612748,MIA,43,1103,154,347,0.444,66,190,0.347,51,54,0.944,18,103,121,105,24,14,36,76,425,457,2.92,0.67,2023,24,9.883720930232558,2.9166666666666665,193,3,196,0.6173469387755102
2023-24,RegularSeason,203995,244,Vasilije Micic,1610612766,CHA,60,1176,159,370,0.43,43,154,0.279,61,75,0.813,14,74,88,262,31,7,99,68,422,486,2.65,0.31,2023,24,7.033333333333333,2.6464646464646466,211,14,225,0.39111111111111113
2023-24,RegularSeason,1629001,245,De'Anthony Melton,1610612755,PHI,38,1023,139,360,0.386,77,214,0.36,66,79,0.835,28,113,141,114,60,16,39,84,421,479,2.92,1.54,2023,24,11.078947368421053,2.923076923076923,221,13,234,0.6025641025641025
2023-24,RegularSeason,1630533,246,Ziaire Williams,1610612763,MEM,51,1038,150,378,0.397,58,189,0.307,62,75,0.827,35,145,180,75,36,9,66,85,420,413,1.14,0.55,2023,24,8.235294117647058,1.1363636363636365,228,13,241,0.7468879668049793
2023-24,RegularSeason,1626168,247,Trey Lyles,1610612758,SAC,58,1158,143,321,0.445,84,219,0.384,49,70,0.7,61,196,257,72,17,19,38,86,419,547,1.9,0.45,2023,24,7.224137931034483,1.894736842105263,178,21,199,1.2914572864321607
2023-24,RegularSeason,1630549,248,Day'Ron Sharpe,1610612751,BKN,61,921,168,294,0.571,4,15,0.267,75,123,0.61,161,228,389,85,24,44,70,131,415,713,1.21,0.34,2023,24,6.80327868852459,1.2142857142857142,126,48,174,2.235632183908046
2023-24,RegularSeason,1629312,249,Haywood Highsmith,1610612748,MIA,66,1366,153,329,0.465,76,192,0.396,23,36,0.639,65,145,210,70,53,30,34,117,405,545,2.06,1.56,2023,24,6.136363636363637,2.0588235294117645,176,13,189,1.1111111111111112
2023-24,RegularSeason,1630631,250,Jose Alvarado,1610612740,NOP,56,1028,142,345,0.412,78,207,0.377,35,52,0.673,25,103,128,117,59,15,40,89,397,456,2.92,1.48,2023,24,7.089285714285714,2.925,203,17,220,0.5818181818181818
2023-24,RegularSeason,1628371,251,Jonathan Isaac,1610612753,ORL,58,915,146,286,0.51,42,112,0.375,59,82,0.72,73,187,260,30,43,70,27,64,393,606,1.11,1.59,2023,24,6.775862068965517,1.1111111111111112,140,23,163,1.5950920245398772
2023-24,RegularSeason,1630543,252,Isaiah Jackson,1610612754,IND,60,771,155,233,0.665,0,4,0.0,73,102,0.716,94,144,238,50,34,61,39,137,383,620,1.28,0.87,2023,24,6.383333333333334,1.2820512820512822,78,29,107,2.2242990654205608
2023-24,RegularSeason,1630544,253,Tre Mann,1610612766,CHA,41,987,145,316,0.459,47,126,0.373,45,59,0.763,20,129,149,165,51,3,65,48,382,500,2.54,0.79,2023,24,9.317073170731707,2.5384615384615383,171,14,185,0.8054054054054054
2023-24,RegularSeason,1630201,254,Malachi Flynn,1610612765,DET,69,877,136,325,0.418,56,169,0.331,52,71,0.732,21,93,114,130,38,8,63,66,380,399,2.06,0.6,2023,24,5.507246376811594,2.0634920634920637,189,19,208,0.5480769230769231
2023-24,RegularSeason,1630558,255,Davion Mitchell,1610612758,SAC,72,1101,146,323,0.452,57,158,0.361,30,42,0.714,19,76,95,134,17,3,43,85,379,396,3.12,0.4,2023,24,5.263888888888889,3.116279069767442,177,12,189,0.5026455026455027
2023-24,RegularSeason,1629234,255,Drew Eubanks,1610612756,PHX,75,1169,152,253,0.601,3,3,1.0,72,93,0.774,103,219,322,63,27,61,61,115,379,669,1.03,0.44,2023,24,5.053333333333334,1.0327868852459017,101,21,122,2.639344262295082
2023-24,RegularSeason,1631222,255,Jake LaRavia,1610612763,MEM,35,806,118,303,0.389,53,156,0.34,90,109,0.826,51,77,128,58,29,12,45,69,379,357,1.29,0.64,2023,24,10.82857142857143,1.288888888888889,185,19,204,0.6274509803921569
2023-24,RegularSeason,1628464,258,Daniel Theis,1610612746,LAC,60,1015,156,293,0.532,26,71,0.366,38,50,0.76,85,159,244,61,21,51,42,127,376,562,1.45,0.5,2023,24,6.266666666666667,1.4523809523809523,137,12,149,1.6375838926174497
2023-24,RegularSeason,1631200,258,Kris Murray,1610612757,POR,62,1348,145,366,0.396,49,183,0.268,37,56,0.661,85,139,224,80,53,21,55,92,376,459,1.46,0.96,2023,24,6.064516129032258,1.4545454545454546,221,19,240,0.9333333333333333
2023-24,RegularSeason,203914,260,Gary Harris,1610612753,ORL,54,1297,131,297,0.441,76,205,0.371,34,45,0.756,24,67,91,87,49,14,31,91,372,405,2.81,1.58,2023,24,6.888888888888889,2.806451612903226,166,11,177,0.5141242937853108
2023-24,RegularSeason,1628372,261,Dennis Smith Jr.,1610612751,BKN,56,1059,147,338,0.435,32,109,0.294,43,58,0.741,50,114,164,203,68,12,68,121,369,542,2.98,1.0,2023,24,6.589285714285714,2.985294117647059,191,15,206,0.7961165048543689
2023-24,RegularSeason,1630692,262,Jordan Goodwin,1610612763,MEM,57,1056,141,382,0.369,42,141,0.298,44,59,0.746,88,165,253,155,48,18,56,76,368,530,2.77,0.86,2023,24,6.456140350877193,2.767857142857143,241,15,256,0.98828125
2023-24,RegularSeason,1629670,263,Jordan Nwora,1610612761,TOR,52,711,138,299,0.462,44,131,0.336,44,53,0.83,28,121,149,62,26,13,53,48,364,391,1.17,0.49,2023,24,7.0,1.169811320754717,161,9,170,0.8764705882352941
2023-24,RegularSeason,1629656,264,Quentin Grimes,1610612765,DET,51,1025,122,328,0.372,81,240,0.338,34,45,0.756,15,85,100,66,35,7,28,75,359,322,2.36,1.25,2023,24,7.03921568627451,2.357142857142857,206,11,217,0.4608294930875576
2023-24,RegularSeason,1628975,265,Jevon Carter,1610612741,CHI,72,1004,138,365,0.378,77,234,0.329,4,7,0.571,11,49,60,94,37,16,36,71,357,298,2.61,1.03,2023,24,4.958333333333333,2.611111111111111,227,3,230,0.2608695652173913
2023-24,RegularSeason,1627739,265,Kris Dunn,1610612762,UTA,66,1249,147,313,0.47,41,111,0.369,22,32,0.688,50,139,189,254,68,28,79,135,357,641,3.21,0.86,2023,24,5.409090909090909,3.2151898734177213,166,10,176,1.0738636363636365
2023-24,RegularSeason,1630700,267,Dyson Daniels,1610612740,NOP,61,1359,139,311,0.447,42,135,0.311,34,53,0.642,62,174,236,164,85,25,59,101,354,614,2.78,1.44,2023,24,5.80327868852459,2.7796610169491527,172,19,191,1.2356020942408377
2023-24,RegularSeason,1629680,267,Matisse Thybulle,1610612757,POR,65,1487,126,317,0.397,80,231,0.346,22,29,0.759,30,106,136,90,113,49,40,93,354,504,2.25,2.83,2023,24,5.446153846153846,2.25,191,7,198,0.6868686868686869
2023-24,RegularSeason,1631107,269,Nikola Jovic,1610612748,MIA,46,896,127,281,0.452,65,163,0.399,33,47,0.702,25,167,192,90,25,14,42,82,352,463,2.14,0.59,2023,24,7.6521739130434785,2.142857142857143,154,14,168,1.1428571428571428
2023-24,RegularSeason,203926,270,Doug McDermott,1610612754,IND,64,904,123,284,0.433,94,229,0.41,11,19,0.579,10,49,59,70,16,2,28,64,351,301,2.5,0.57,2023,24,5.484375,2.5,161,8,169,0.34911242603550297
2023-24,RegularSeason,1626204,271,Larry Nance Jr.,1610612740,NOP,61,1216,138,241,0.573,27,65,0.415,47,61,0.77,94,213,307,113,61,19,49,98,350,684,2.31,1.25,2023,24,5.737704918032787,2.306122448979592,103,14,117,2.623931623931624
2023-24,RegularSeason,1626174,272,Christian Wood,1610612747,LAL,50,872,123,264,0.466,35,114,0.307,66,94,0.702,39,215,254,49,16,33,50,72,347,480,0.98,0.32,2023,24,6.94,0.98,141,28,169,1.5029585798816567
2023-24,RegularSeason,1628365,273,Markelle Fultz,1610612753,ORL,43,910,154,326,0.472,4,18,0.222,23,33,0.697,56,82,138,120,42,15,50,65,335,418,2.4,0.84,2023,24,7.790697674418604,2.4,172,10,182,0.7582417582417582
2023-24,RegularSeason,1626172,274,Kevon Looney,1610612744,GSW,74,1194,139,233,0.597,0,1,0.0,56,83,0.675,143,276,419,133,28,29,50,155,334,772,2.66,0.56,2023,24,4.513513513513513,2.66,94,27,121,3.4628099173553717
2023-24,RegularSeason,1628436,274,Luke Kornet,1610612738,BOS,63,983,142,203,0.7,1,1,1.0,49,54,0.907,118,143,261,67,23,61,21,77,334,659,3.19,1.09,2023,24,5.301587301587301,3.1904761904761907,61,5,66,3.9545454545454546
2023-24,RegularSeason,1629002,276,Chimezie Metu,1610612765,DET,51,859,123,244,0.504,28,94,0.298,58,64,0.906,41,153,194,46,43,16,52,71,332,452,0.89,0.83,2023,24,6.509803921568627,0.8846153846153846,121,6,127,1.5275590551181102
2023-24,RegularSeason,1629013,277,Landry Shamet,1610612764,WAS,46,727,118,274,0.431,53,157,0.338,38,46,0.826,16,46,62,54,25,10,30,76,327,284,1.8,0.83,2023,24,7.108695652173913,1.8,156,8,164,0.3780487804878049
2023-24,RegularSeason,1629726,278,Garrison Mathews,1610612737,ATL,66,992,103,226,0.456,85,193,0.44,34,42,0.81,17,75,92,37,20,8,19,115,325,332,1.95,1.05,2023,24,4.924242424242424,1.9473684210526316,123,8,131,0.7022900763358778
2023-24,RegularSeason,1629026,278,Kenrich Williams,1610612760,OKC,69,1029,131,280,0.468,56,141,0.397,7,14,0.5,61,148,209,93,38,9,32,101,325,486,2.91,1.19,2023,24,4.7101449275362315,2.90625,149,7,156,1.3397435897435896
2023-24,RegularSeason,1628449,280,Chris Boucher,1610612761,TOR,50,705,110,217,0.507,31,94,0.33,71,92,0.772,62,145,207,23,14,24,28,68,322,434,0.82,0.5,2023,24,6.44,0.8214285714285714,107,21,128,1.6171875
2023-24,RegularSeason,201587,281,Nicolas Batum,1610612755,PHI,60,1530,116,256,0.453,73,185,0.395,15,21,0.714,70,178,248,128,48,38,40,109,320,596,3.2,1.2,2023,24,5.333333333333333,3.2,140,6,146,1.6986301369863013
2023-24,RegularSeason,1641710,282,Anthony Black,1610612753,ORL,69,1164,115,247,0.466,37,94,0.394,49,80,0.613,33,106,139,91,35,21,56,110,316,383,1.63,0.63,2023,24,4.579710144927536,1.625,132,31,163,0.852760736196319
2023-24,RegularSeason,202694,282,Marcus Morris Sr.,1610612739,CLE,49,817,116,264,0.439,48,119,0.403,36,44,0.818,23,111,134,36,15,13,30,74,316,328,1.2,0.5,2023,24,6.448979591836735,1.2,148,8,156,0.8589743589743589
2023-24,RegularSeason,203109,284,Jae Crowder,1610612749,MIL,50,1156,114,270,0.422,58,166,0.349,26,36,0.722,31,130,161,66,38,9,23,74,312,397,2.87,1.65,2023,24,6.24,2.869565217391304,156,10,166,0.9698795180722891
2023-24,RegularSeason,1629048,285,Goga Bitadze,1610612753,ORL,62,957,126,209,0.603,2,14,0.143,57,87,0.655,109,177,286,79,32,72,44,107,311,623,1.79,0.73,2023,24,5.016129032258065,1.7954545454545454,83,30,113,2.5309734513274336
2023-24,RegularSeason,1631165,286,Keon Ellis,1610612758,SAC,57,979,107,232,0.461,70,168,0.417,26,35,0.743,32,92,124,85,51,29,37,112,310,428,2.3,1.38,2023,24,5.43859649122807,2.2972972972972974,125,9,134,0.9253731343283582
2023-24,RegularSeason,1629637,287,Jaxson Hayes,1610612747,LAL,70,877,126,175,0.72,0,8,0.0,51,82,0.622,69,142,211,33,34,29,43,123,303,487,0.77,0.79,2023,24,4.328571428571428,0.7674418604651163,49,31,80,2.6375
2023-24,RegularSeason,1628470,287,Torrey Craig,1610612741,CHI,53,1049,108,251,0.43,60,153,0.392,27,36,0.75,69,148,217,58,30,21,32,110,303,445,1.81,0.94,2023,24,5.716981132075472,1.8125,143,9,152,1.4276315789473684
2023-24,RegularSeason,1631121,289,Bryce McGowens,1610612766,CHA,59,882,101,230,0.439,34,102,0.333,66,85,0.776,17,85,102,51,21,10,30,74,302,308,1.7,0.7,2023,24,5.11864406779661,1.7,129,19,148,0.6891891891891891
2023-24,RegularSeason,1641733,289,Nick Smith Jr.,1610612766,CHA,51,729,113,289,0.391,63,146,0.432,13,15,0.867,18,54,72,59,10,7,39,55,302,233,1.51,0.26,2023,24,5.921568627450981,1.5128205128205128,176,2,178,0.4044943820224719
2023-24,RegularSeason,204060,291,Joe Ingles,1610612753,ORL,68,1169,99,227,0.436,70,161,0.435,28,34,0.824,18,124,142,203,43,5,67,88,296,488,3.03,0.64,2023,24,4.352941176470588,3.029850746268657,128,6,134,1.0597014925373134
2023-24,RegularSeason,1641707,292,Taylor Hendricks,1610612762,UTA,40,856,108,240,0.45,53,140,0.379,23,29,0.793,46,139,185,32,28,30,27,77,292,402,1.19,1.04,2023,24,7.3,1.1851851851851851,132,6,138,1.3405797101449275
2023-24,RegularSeason,1629731,293,Dean Wade,1610612739,CLE,54,1108,96,232,0.414,79,202,0.391,20,26,0.769,37,181,218,43,40,25,20,93,291,455,2.15,2.0,2023,24,5.388888888888889,2.15,136,6,142,1.5352112676056338
2023-24,RegularSeason,202722,294,Dāvis Bertāns,1610612766,CHA,43,674,92,234,0.393,76,200,0.38,30,33,0.909,9,52,61,35,26,12,18,56,290,261,1.94,1.44,2023,24,6.744186046511628,1.9444444444444444,142,3,145,0.4206896551724138
2023-24,RegularSeason,1630165,295,Killian Hayes,1610612765,DET,42,1008,117,283,0.413,22,74,0.297,33,50,0.66,11,108,119,205,36,20,51,75,289,435,4.02,0.71,2023,24,6.880952380952381,4.019607843137255,166,17,183,0.6502732240437158
2023-24,RegularSeason,203935,295,Marcus Smart,1610612763,MEM,20,605,102,237,0.43,42,134,0.313,43,56,0.768,6,47,53,86,41,5,62,53,289,264,1.39,0.66,2023,24,14.45,1.3870967741935485,135,13,148,0.3581081081081081
2023-24,RegularSeason,1641854,297,Craig Porter Jr.,1610612739,CLE,51,649,116,228,0.509,12,34,0.353,41,56,0.732,21,88,109,118,21,15,45,40,285,376,2.62,0.47,2023,24,5.588235294117647,2.6222222222222222,112,15,127,0.8582677165354331
2023-24,RegularSeason,1631108,298,Max Christie,1610612747,LAL,67,944,103,241,0.427,42,118,0.356,36,46,0.783,15,127,142,60,20,17,35,57,284,340,1.71,0.57,2023,24,4.2388059701492535,1.7142857142857142,138,10,148,0.9594594594594594
2023-24,RegularSeason,1630214,298,Xavier Tillman,1610612738,BOS,54,975,121,279,0.434,20,81,0.247,22,50,0.44,70,141,211,77,51,44,34,75,284,447,2.27,1.5,2023,24,5.2592592592592595,2.264705882352941,158,28,186,1.1344086021505377
2023-24,RegularSeason,1628981,300,Bruno Fernando,1610612737,ATL,45,682,109,187,0.583,0,4,0.0,64,96,0.667,59,134,193,46,25,28,44,107,282,420,1.04,0.57,2023,24,6.266666666666667,1.0454545454545454,78,32,110,1.7545454545454546
2023-24,RegularSeason,201568,301,Danilo Gallinari,1610612749,MIL,49,629,83,190,0.437,30,93,0.323,84,98,0.857,20,88,108,55,14,6,23,50,280,319,2.39,0.61,2023,24,5.714285714285714,2.391304347826087,107,14,121,0.8925619834710744
2023-24,RegularSeason,1629006,302,Josh Okogie,1610612756,PHX,60,960,86,206,0.417,29,94,0.309,76,102,0.745,74,80,154,64,48,24,36,68,277,385,1.78,1.33,2023,24,4.616666666666666,1.7777777777777777,120,26,146,1.0547945205479452
2023-24,RegularSeason,1631119,303,Jaylin Williams,1610612760,OKC,69,897,95,228,0.417,53,144,0.368,33,41,0.805,36,198,234,110,28,27,34,98,276,500,3.23,0.82,2023,24,4.0,3.235294117647059,133,8,141,1.6595744680851063
2023-24,RegularSeason,1629111,304,Jock Landale,1610612745,HOU,56,764,106,206,0.515,10,40,0.25,52,65,0.8,88,84,172,65,20,33,31,74,274,420,2.1,0.65,2023,24,4.892857142857143,2.096774193548387,100,13,113,1.5221238938053097
2023-24,RegularSeason,1630205,305,Lamar Stevens,1610612763,MEM,38,559,108,240,0.45,14,46,0.304,42,54,0.778,36,91,127,28,23,22,24,45,272,304,1.17,0.96,2023,24,7.157894736842105,1.1666666666666667,132,12,144,0.8819444444444444
2023-24,RegularSeason,1630590,306,Scotty Pippen Jr.,1610612763,MEM,21,527,100,203,0.493,30,72,0.417,41,55,0.745,22,45,67,98,36,10,56,60,271,309,1.75,0.64,2023,24,12.904761904761905,1.75,103,14,117,0.5726495726495726
2023-24,RegularSeason,1631104,307,Blake Wesley,1610612759,SAS,61,876,102,215,0.474,12,55,0.218,52,78,0.667,18,76,94,166,29,9,55,89,268,372,3.02,0.53,2023,24,4.39344262295082,3.018181818181818,113,26,139,0.6762589928057554
2023-24,RegularSeason,1630256,308,Jae'Sean Tate,1610612745,HOU,65,1031,108,229,0.472,23,77,0.299,26,39,0.667,61,136,197,64,42,15,37,137,265,412,1.73,1.14,2023,24,4.076923076923077,1.7297297297297298,121,13,134,1.4701492537313432
2023-24,RegularSeason,1629629,309,Cam Reddish,1610612747,LAL,48,984,91,234,0.389,37,110,0.336,41,54,0.759,27,72,99,48,47,14,31,64,260,281,1.55,1.52,2023,24,5.416666666666667,1.5483870967741935,143,13,156,0.6346153846153846
2023-24,RegularSeason,1630538,310,Bones Hyland,1610612746,LAC,37,540,97,251,0.386,44,135,0.326,18,23,0.783,5,50,55,93,26,4,44,51,256,231,2.11,0.59,2023,24,6.918918918918919,2.1136363636363638,154,5,159,0.34591194968553457
2023-24,RegularSeason,1631216,311,Caleb Houstan,1610612753,ORL,59,815,80,206,0.388,72,193,0.373,21,26,0.808,28,56,84,29,15,4,16,61,253,238,1.81,0.94,2023,24,4.288135593220339,1.8125,126,5,131,0.6412213740458015
2023-24,RegularSeason,1628964,311,Mo Bamba,1610612755,PHI,57,740,97,198,0.49,25,64,0.391,34,50,0.68,77,161,238,41,22,60,39,101,253,458,1.05,0.56,2023,24,4.43859649122807,1.0512820512820513,101,16,117,2.034188034188034
2023-24,RegularSeason,1631260,313,AJ Green,1610612749,MIL,56,614,83,196,0.423,69,169,0.408,17,19,0.895,9,55,64,30,9,4,12,49,252,232,2.5,0.75,2023,24,4.5,2.5,113,2,115,0.5565217391304348
2023-24,RegularSeason,1641767,313,Ben Sheppard,1610612754,IND,57,814,90,229,0.393,49,156,0.314,23,26,0.885,15,74,89,53,33,2,15,88,252,272,3.53,2.2,2023,24,4.421052631578948,3.533333333333333,139,3,142,0.6267605633802817
2023-24,RegularSeason,1630215,315,Jared Butler,1610612764,WAS,40,566,98,201,0.488,24,78,0.308,31,36,0.861,9,49,58,126,29,8,50,58,251,314,2.52,0.58,2023,24,6.275,2.52,103,5,108,0.5370370370370371
2023-24,RegularSeason,1628972,316,Troy Brown Jr.,1610612765,DET,59,827,84,226,0.372,47,141,0.333,32,37,0.865,25,119,144,60,24,3,30,42,247,301,2.0,0.8,2023,24,4.186440677966102,2.0,142,5,147,0.9795918367346939
2023-24,RegularSeason,203486,317,Mason Plumlee,1610612746,LAC,46,674,87,153,0.569,0,6,0.0,70,99,0.707,60,174,234,55,14,17,36,68,244,433,1.53,0.39,2023,24,5.304347826086956,1.5277777777777777,66,29,95,2.463157894736842
2023-24,RegularSeason,1631109,318,Mark Williams,1610612766,CHA,19,508,98,151,0.649,0,0,0.0,46,64,0.719,76,108,184,22,16,20,17,50,242,396,1.29,0.94,2023,24,12.736842105263158,1.2941176470588236,53,18,71,2.591549295774648
2023-24,RegularSeason,1641729,319,Brice Sensabaugh,1610612762,UTA,32,584,85,218,0.39,34,115,0.296,37,41,0.902,16,86,102,55,13,6,47,43,241,233,1.17,0.28,2023,24,7.53125,1.1702127659574468,133,4,137,0.7445255474452555
2023-24,RegularSeason,1627780,320,Gary Payton II,1610612744,GSW,44,680,103,183,0.563,20,55,0.364,14,23,0.609,46,67,113,48,39,18,27,77,240,342,1.78,1.44,2023,24,5.454545454545454,1.7777777777777777,80,9,89,1.2696629213483146
2023-24,RegularSeason,1629723,321,John Konchar,1610612763,MEM,55,1174,88,208,0.423,38,120,0.317,21,25,0.84,72,185,257,110,51,51,46,76,235,534,2.39,1.11,2023,24,4.2727272727272725,2.391304347826087,120,4,124,2.0725806451612905
2023-24,RegularSeason,203200,322,Justin Holiday,1610612743,DEN,58,862,88,194,0.454,55,136,0.404,3,4,0.75,9,62,71,67,36,9,14,69,234,296,4.79,2.57,2023,24,4.0344827586206895,4.785714285714286,106,1,107,0.6635514018691588
2023-24,RegularSeason,1630537,323,Chris Duarte,1610612758,SAC,59,720,80,210,0.381,44,127,0.346,26,33,0.788,26,80,106,44,28,8,26,80,230,253,1.69,1.08,2023,24,3.8983050847457625,1.6923076923076923,130,7,137,0.7737226277372263
2023-24,RegularSeason,1631124,324,Julian Strawther,1610612743,DEN,50,545,82,222,0.369,41,138,0.297,22,31,0.71,5,56,61,47,17,7,23,54,227,187,2.04,0.74,2023,24,4.54,2.0434782608695654,140,9,149,0.40939597315436244
2023-24,RegularSeason,1629630,325,Ja Morant,1610612763,MEM,9,318,80,170,0.471,14,51,0.275,52,64,0.813,6,44,50,73,7,5,27,19,226,232,2.7,0.26,2023,24,25.11111111111111,2.7037037037037037,90,12,102,0.49019607843137253
2023-24,RegularSeason,203552,325,Seth Curry,1610612766,CHA,44,615,80,204,0.392,38,108,0.352,28,31,0.903,18,50,68,44,22,6,21,39,226,218,2.1,1.05,2023,24,5.136363636363637,2.0952380952380953,124,3,127,0.5354330708661418
2023-24,RegularSeason,1628426,327,Sasha Vezenkov,1610612758,SAC,42,511,84,191,0.44,45,120,0.375,12,15,0.8,30,66,96,19,20,7,12,42,225,245,1.58,1.67,2023,24,5.357142857142857,1.5833333333333333,107,3,110,0.8727272727272727
2023-24,RegularSeason,1630231,328,KJ Martin,1610612755,PHI,60,747,97,181,0.536,8,28,0.286,22,41,0.537,41,90,131,51,22,12,32,100,224,305,1.59,0.69,2023,24,3.7333333333333334,1.59375,84,19,103,1.2718446601941749
2023-24,RegularSeason,1629626,329,Bol Bol,1610612756,PHX,43,469,93,151,0.616,22,52,0.423,15,19,0.789,32,105,137,17,10,25,19,42,223,331,0.9,0.53,2023,24,5.186046511627907,0.8947368421052632,58,4,62,2.2096774193548385
2023-24,RegularSeason,1628995,329,Kevin Knox II,1610612765,DET,31,560,86,186,0.462,31,94,0.33,20,22,0.909,18,57,75,23,13,7,22,50,223,217,1.04,0.59,2023,24,7.193548387096774,1.0454545454545454,100,2,102,0.7352941176470589
2023-24,RegularSeason,1630209,331,Omer Yurtseven,1610612762,UTA,48,545,99,184,0.538,5,24,0.208,19,28,0.679,72,136,208,29,8,18,37,52,222,354,0.78,0.22,2023,24,4.625,0.7837837837837838,85,9,94,2.2127659574468086
2023-24,RegularSeason,203095,332,Evan Fournier,1610612765,DET,32,580,79,221,0.357,33,130,0.254,29,36,0.806,5,53,58,48,29,7,21,48,220,192,2.29,1.38,2023,24,6.875,2.2857142857142856,142,7,149,0.38926174496644295
2023-24,RegularSeason,1628418,333,Thomas Bryant,1610612748,MIA,38,441,86,149,0.577,4,22,0.182,41,47,0.872,40,101,141,23,10,16,21,46,217,317,1.09,0.48,2023,24,5.7105263157894735,1.0952380952380953,63,6,69,2.0434782608695654
2023-24,RegularSeason,1629003,334,Shake Milton,1610612752,NYK,48,581,79,195,0.405,18,64,0.281,40,49,0.816,14,61,75,60,19,6,31,54,216,220,1.94,0.61,2023,24,4.5,1.935483870967742,116,9,125,0.6
2023-24,RegularSeason,1631106,335,Tari Eason,1610612745,HOU,22,480,88,189,0.466,18,50,0.36,21,33,0.636,46,107,153,27,31,19,20,51,215,312,1.35,1.55,2023,24,9.772727272727273,1.35,101,12,113,1.3539823008849559
2023-24,RegularSeason,1630592,336,Jalen Wilson,1610612751,BKN,43,665,76,179,0.425,24,74,0.324,38,46,0.826,47,84,131,45,11,4,19,48,214,275,2.37,0.58,2023,24,4.976744186046512,2.3684210526315788,103,8,111,1.1801801801801801
2023-24,RegularSeason,1628998,337,Cody Martin,1610612766,CHA,28,753,82,215,0.381,27,86,0.314,20,33,0.606,19,90,109,104,32,18,44,48,211,284,2.36,0.73,2023,24,7.535714285714286,2.3636363636363638,133,13,146,0.7465753424657534
2023-24,RegularSeason,1630699,337,MarJon Beauchamp,1610612749,MIL,48,608,81,166,0.488,30,75,0.4,19,28,0.679,22,77,99,31,13,7,27,54,211,240,1.15,0.48,2023,24,4.395833333333333,1.1481481481481481,85,9,94,1.053191489361702
2023-24,RegularSeason,1626153,339,Delon Wright,1610612748,MIA,47,742,74,188,0.394,25,68,0.368,37,45,0.822,19,67,86,119,54,11,14,32,210,344,8.5,3.86,2023,24,4.468085106382978,8.5,114,8,122,0.7049180327868853
2023-24,RegularSeason,203939,340,Dwight Powell,1610612742,DAL,63,836,72,106,0.679,1,3,0.333,63,89,0.708,97,117,214,84,26,20,32,113,208,460,2.63,0.81,2023,24,3.3015873015873014,2.625,34,26,60,3.566666666666667
2023-24,RegularSeason,1630647,341,Eugene Omoruyi,1610612764,WAS,43,393,81,167,0.485,13,46,0.283,32,49,0.653,35,50,85,35,27,5,21,62,207,235,1.67,1.29,2023,24,4.813953488372093,1.6666666666666667,86,17,103,0.8252427184466019
2023-24,RegularSeason,1629052,342,Oshae Brissett,1610612738,BOS,55,630,68,153,0.444,15,55,0.273,50,83,0.602,61,99,160,44,19,8,20,54,201,294,2.2,0.95,2023,24,3.6545454545454548,2.2,85,33,118,1.3559322033898304
2023-24,RegularSeason,1630550,343,JT Thor,1610612766,CHA,63,781,80,183,0.437,28,81,0.346,11,20,0.55,43,103,146,29,11,27,15,60,199,285,1.93,0.73,2023,24,3.1587301587301586,1.9333333333333333,103,9,112,1.3035714285714286
2023-24,RegularSeason,1626158,343,Richaun Holmes,1610612764,WAS,40,554,82,147,0.558,1,3,0.333,34,47,0.723,71,111,182,25,11,19,24,74,199,334,1.04,0.46,2023,24,4.975,1.0416666666666667,65,13,78,2.3333333333333335
2023-24,RegularSeason,1628966,345,Keita Bates-Diop,1610612751,BKN,53,665,72,166,0.434,21,69,0.304,32,42,0.762,31,79,110,38,25,22,15,35,197,273,2.53,1.67,2023,24,3.7169811320754715,2.533333333333333,94,10,104,1.0576923076923077
2023-24,RegularSeason,1629162,346,Jordan McLaughlin,1610612750,MIN,56,626,70,145,0.483,42,89,0.472,13,18,0.722,18,54,72,110,35,7,19,31,195,320,5.79,1.84,2023,24,3.482142857142857,5.7894736842105265,75,5,80,0.9
2023-24,RegularSeason,201565,347,Derrick Rose,1610612763,MEM,24,399,76,165,0.461,15,41,0.366,24,27,0.889,7,38,45,78,8,2,31,21,191,201,2.52,0.26,2023,24,7.958333333333333,2.5161290322580645,89,3,92,0.4891304347826087
2023-24,RegularSeason,1628467,347,Maxi Kleber,1610612742,DAL,43,871,63,146,0.432,32,92,0.348,33,47,0.702,30,113,143,68,17,30,28,79,191,324,2.43,0.61,2023,24,4.441860465116279,2.4285714285714284,83,14,97,1.4742268041237114
2023-24,RegularSeason,1630572,349,Sandro Mamukelashvili,1610612759,SAS,46,451,73,155,0.471,19,64,0.297,25,34,0.735,45,102,147,49,7,12,19,35,190,295,2.58,0.37,2023,24,4.130434782608695,2.5789473684210527,82,9,91,1.6153846153846154
2023-24,RegularSeason,1630264,350,Anthony Gill,1610612764,WAS,50,466,75,160,0.469,10,41,0.244,29,36,0.806,37,57,94,34,13,11,23,48,189,226,1.48,0.56,2023,24,3.78,1.4782608695652173,85,7,92,1.0217391304347827
2023-24,RegularSeason,1630192,351,Zeke Nnaji,1610612743,DEN,58,576,69,149,0.463,6,23,0.261,42,62,0.677,61,65,126,32,15,38,27,81,186,270,1.19,0.56,2023,24,3.206896551724138,1.1851851851851851,80,20,100,1.26
2023-24,RegularSeason,201580,352,JaVale McGee,1610612758,SAC,46,339,79,132,0.598,1,7,0.143,26,45,0.578,42,84,126,17,14,20,34,46,185,256,0.5,0.41,2023,24,4.021739130434782,0.5,53,19,72,1.75
2023-24,RegularSeason,1631207,353,Dalen Terry,1610612741,CHI,59,681,69,157,0.439,17,74,0.23,25,43,0.581,29,84,113,81,27,18,32,81,180,281,2.53,0.84,2023,24,3.0508474576271185,2.53125,88,18,106,1.0660377358490567
2023-24,RegularSeason,1629677,354,Luka Samanic,1610612762,UTA,43,404,60,158,0.38,13,64,0.203,44,56,0.786,22,80,102,19,5,7,28,32,177,172,0.68,0.18,2023,24,4.116279069767442,0.6785714285714286,98,12,110,0.9272727272727272
2023-24,RegularSeason,202687,355,Bismack Biyombo,1610612760,OKC,40,791,74,131,0.565,0,0,0.0,26,54,0.481,62,147,209,53,11,37,42,89,174,357,1.26,0.26,2023,24,4.35,1.2619047619047619,57,28,85,2.458823529411765
2023-24,RegularSeason,1631367,356,Jacob Gilyard,1610612751,BKN,41,698,60,150,0.4,51,126,0.405,2,2,1.0,9,37,46,137,33,5,30,39,173,274,4.57,1.1,2023,24,4.219512195121951,4.566666666666666,90,0,90,0.5111111111111111
2023-24,RegularSeason,1629011,356,Mitchell Robinson,1610612752,NYK,31,768,73,127,0.575,0,0,0.0,27,66,0.409,142,121,263,18,37,35,25,55,173,408,0.72,1.48,2023,24,5.580645161290323,0.72,54,39,93,2.827956989247312
2023-24,RegularSeason,1641741,356,Ricky Council IV,1610612755,PHI,32,289,54,112,0.482,12,32,0.375,53,71,0.746,14,32,46,16,8,1,5,17,173,163,3.2,1.6,2023,24,5.40625,3.2,58,18,76,0.6052631578947368
2023-24,RegularSeason,1641998,359,Trey Jemison,1610612763,MEM,25,574,75,136,0.551,0,0,0.0,21,25,0.84,64,70,134,27,12,28,34,69,171,273,0.79,0.35,2023,24,6.84,0.7941176470588235,61,4,65,2.0615384615384613
2023-24,RegularSeason,1629667,360,Jalen McDaniels,1610612761,TOR,50,538,65,189,0.344,12,71,0.169,27,37,0.73,18,61,79,37,19,6,30,52,169,146,1.23,0.63,2023,24,3.38,1.2333333333333334,124,10,134,0.5895522388059702
2023-24,RegularSeason,1631116,361,Patrick Baldwin Jr.,1610612764,WAS,38,494,59,155,0.381,31,97,0.32,19,28,0.679,17,106,123,29,18,15,19,56,168,229,1.53,0.95,2023,24,4.421052631578948,1.5263157894736843,96,9,105,1.1714285714285715
2023-24,RegularSeason,1630527,362,Brandon Boston Jr.,1610612746,LAC,32,345,65,161,0.404,14,52,0.269,23,33,0.697,19,33,52,13,11,8,24,40,167,121,0.54,0.46,2023,24,5.21875,0.5416666666666666,96,10,106,0.49056603773584906
2023-24,RegularSeason,1631311,363,Lester Quinones,1610612744,GSW,37,394,56,141,0.397,32,88,0.364,20,29,0.69,21,51,72,36,6,2,17,44,164,169,2.12,0.35,2023,24,4.4324324324324325,2.1176470588235294,85,9,94,0.7659574468085106
2023-24,RegularSeason,1628420,363,Monte Morris,1610612750,MIN,33,476,62,153,0.405,27,70,0.386,13,19,0.684,7,50,57,69,19,9,7,14,164,214,9.86,2.71,2023,24,4.96969696969697,9.857142857142858,91,6,97,0.5876288659793815
2023-24,RegularSeason,1630531,365,Jaden Springer,1610612738,BOS,49,507,59,148,0.399,10,48,0.208,35,42,0.833,33,45,78,44,36,15,34,66,163,206,1.29,1.06,2023,24,3.326530612244898,1.2941176470588236,89,7,96,0.8125
2023-24,RegularSeason,1629004,366,Svi Mykhailiuk,1610612738,BOS,41,413,57,137,0.416,42,108,0.389,6,9,0.667,11,40,51,35,11,1,12,19,162,165,2.92,0.92,2023,24,3.951219512195122,2.9166666666666665,80,3,83,0.6144578313253012
2023-24,RegularSeason,202684,367,Tristan Thompson,1610612739,CLE,49,549,73,120,0.608,0,1,0.0,15,52,0.288,73,101,174,51,12,14,29,59,161,299,1.76,0.41,2023,24,3.2857142857142856,1.7586206896551724,47,37,84,2.0714285714285716
2023-24,RegularSeason,203488,368,Mike Muscala,1610612760,OKC,53,600,56,156,0.359,28,96,0.292,17,25,0.68,39,86,125,36,9,13,22,52,157,210,1.64,0.41,2023,24,2.9622641509433962,1.6363636363636365,100,8,108,1.1574074074074074
2023-24,RegularSeason,1641712,369,Rayan Rupert,1610612757,POR,39,633,54,161,0.335,28,78,0.359,19,25,0.76,24,68,92,62,12,3,31,56,155,180,2.0,0.39,2023,24,3.9743589743589745,2.0,107,6,113,0.8141592920353983
2023-24,RegularSeason,1630219,369,Skylar Mays,1610612747,LAL,38,433,63,159,0.396,16,54,0.296,13,17,0.765,10,33,43,85,21,4,20,26,155,188,4.25,1.05,2023,24,4.078947368421052,4.25,96,4,100,0.43
2023-24,RegularSeason,1629674,371,Neemias Queta,1610612738,BOS,28,333,67,104,0.644,0,0,0.0,20,28,0.714,53,69,122,20,13,21,13,50,154,272,1.54,1.0,2023,24,5.5,1.5384615384615385,37,8,45,2.7111111111111112
2023-24,RegularSeason,1631241,372,Javon Freeman-Liberty,1610612761,TOR,22,403,55,124,0.444,10,42,0.238,33,36,0.917,16,54,70,40,10,4,25,28,153,180,1.6,0.4,2023,24,6.954545454545454,1.6,69,3,72,0.9722222222222222
2023-24,RegularSeason,1631098,373,Johnny Davis,1610612764,WAS,50,614,62,154,0.403,14,40,0.35,14,24,0.583,18,54,72,32,18,10,13,57,152,169,2.46,1.39,2023,24,3.04,2.4615384615384617,92,10,102,0.7058823529411765
2023-24,RegularSeason,1630346,373,Matt Ryan,1610612740,NOP,28,390,49,113,0.434,41,91,0.451,13,14,0.929,6,34,40,18,6,1,19,32,152,133,0.95,0.32,2023,24,5.428571428571429,0.9473684210526315,64,1,65,0.6153846153846154
2023-24,RegularSeason,1629642,373,Nassir Little,1610612756,PHX,45,458,57,124,0.46,21,70,0.3,17,20,0.85,14,61,75,21,10,10,14,39,152,184,1.5,0.71,2023,24,3.3777777777777778,1.5,67,3,70,1.0714285714285714
2023-24,RegularSeason,1629020,376,Jarred Vanderbilt,1610612747,LAL,29,581,59,114,0.518,8,27,0.296,24,36,0.667,41,97,138,36,36,5,28,43,150,270,1.29,1.29,2023,24,5.172413793103448,1.2857142857142858,55,12,67,2.0597014925373136
2023-24,RegularSeason,1630197,377,Aleksej Pokusevski,1610612766,CHA,28,405,49,121,0.405,18,55,0.327,30,41,0.732,17,72,89,35,15,13,19,22,146,196,1.84,0.79,2023,24,5.214285714285714,1.8421052631578947,72,11,83,1.072289156626506
2023-24,RegularSeason,1627863,378,Danuel House Jr.,1610612755,PHI,34,509,47,105,0.448,15,50,0.3,35,46,0.761,16,42,58,28,15,5,19,45,144,162,1.47,0.79,2023,24,4.235294117647059,1.4736842105263157,58,11,69,0.8405797101449275
2023-24,RegularSeason,1631230,378,Dominick Barlow,1610612759,SAS,33,420,56,113,0.496,3,9,0.333,29,42,0.69,45,68,113,36,12,14,9,47,144,240,4.0,1.33,2023,24,4.363636363636363,4.0,57,13,70,1.6142857142857143
2023-24,RegularSeason,1630548,378,Johnny Juzang,1610612762,UTA,20,372,51,110,0.464,32,77,0.416,10,14,0.714,7,29,36,23,4,2,13,29,144,133,1.77,0.31,2023,24,7.2,1.7692307692307692,59,4,63,0.5714285714285714
2023-24,RegularSeason,201599,381,DeAndre Jordan,1610612743,DEN,36,396,58,93,0.624,0,0,0.0,26,53,0.491,54,103,157,26,6,16,23,56,142,262,1.13,0.26,2023,24,3.9444444444444446,1.1304347826086956,35,27,62,2.532258064516129
2023-24,RegularSeason,202397,382,Ish Smith,1610612766,CHA,43,741,66,158,0.418,4,8,0.5,3,4,0.75,11,65,76,145,17,4,47,49,139,241,3.08,0.36,2023,24,3.2325581395348837,3.0851063829787235,92,1,93,0.8172043010752689
2023-24,RegularSeason,1630322,383,Lindy Waters III,1610612760,OKC,38,280,49,104,0.471,37,85,0.435,2,2,1.0,7,33,40,24,5,7,7,23,137,151,3.43,0.71,2023,24,3.6052631578947367,3.4285714285714284,55,0,55,0.7272727272727273
2023-24,RegularSeason,201152,383,Thaddeus Young,1610612756,PHX,33,440,65,108,0.602,1,7,0.143,6,15,0.4,46,57,103,57,23,5,15,49,137,258,3.8,1.53,2023,24,4.151515151515151,3.8,43,9,52,1.9807692307692308
2023-24,RegularSeason,1630639,385,AJ Lawson,1610612742,DAL,42,311,54,121,0.446,13,50,0.26,15,23,0.652,14,36,50,20,10,3,14,22,136,130,1.43,0.71,2023,24,3.238095238095238,1.4285714285714286,67,8,75,0.6666666666666666
2023-24,RegularSeason,1630249,386,Vit Krejci,1610612737,ATL,22,541,51,104,0.49,28,68,0.412,5,6,0.833,11,41,52,50,13,6,20,48,135,182,2.5,0.65,2023,24,6.136363636363637,2.5,53,1,54,0.9629629629629629
2023-24,RegularSeason,1641730,387,Noah Clowney,1610612751,BKN,23,370,50,93,0.538,12,33,0.364,21,30,0.7,26,55,81,18,8,16,15,25,133,189,1.2,0.53,2023,24,5.782608695652174,1.2,43,9,52,1.5576923076923077
2023-24,RegularSeason,1631172,387,Ousmane Dieng,1610612760,OKC,33,365,49,116,0.422,21,70,0.3,14,16,0.875,10,41,51,37,8,5,19,22,133,146,1.95,0.42,2023,24,4.03030303030303,1.9473684210526316,67,2,69,0.7391304347826086
2023-24,RegularSeason,201988,389,Patty Mills,1610612748,MIA,32,415,46,131,0.351,24,87,0.276,11,11,1.0,9,26,35,34,20,1,16,32,127,116,2.13,1.25,2023,24,3.96875,2.125,85,0,85,0.4117647058823529
2023-24,RegularSeason,203496,389,Robert Covington,1610612755,PHI,29,488,43,98,0.439,19,56,0.339,22,26,0.846,31,66,97,24,39,18,11,56,127,235,2.18,3.54,2023,24,4.379310344827586,2.1818181818181817,55,4,59,1.6440677966101696
2023-24,RegularSeason,1630649,389,Stanley Umude,1610612765,DET,24,307,37,84,0.44,24,53,0.453,29,32,0.906,8,43,51,11,8,7,14,40,127,140,0.79,0.57,2023,24,5.291666666666667,0.7857142857142857,47,3,50,1.02
2023-24,RegularSeason,1641748,392,Andre Jackson Jr.,1610612749,MIL,57,572,50,100,0.5,17,46,0.37,8,11,0.727,43,70,113,50,16,6,28,92,125,229,1.79,0.57,2023,24,2.192982456140351,1.7857142857142858,50,3,53,2.1320754716981134
2023-24,RegularSeason,1641765,393,Olivier-Maxence Prosper,1610612742,DAL,40,336,40,104,0.385,13,45,0.289,28,41,0.683,25,54,79,22,7,4,8,20,121,148,2.75,0.88,2023,24,3.025,2.75,64,13,77,1.025974025974026
2023-24,RegularSeason,203458,394,Alex Len,1610612758,SAC,48,444,50,81,0.617,0,3,0.0,20,34,0.588,46,82,128,50,11,33,27,66,120,270,1.85,0.41,2023,24,2.5,1.8518518518518519,31,14,45,2.8444444444444446
2023-24,RegularSeason,1641716,394,Jarace Walker,1610612754,IND,33,340,45,110,0.409,22,55,0.4,8,9,0.889,12,51,63,40,15,11,17,29,120,166,2.35,0.88,2023,24,3.6363636363636362,2.3529411764705883,65,1,66,0.9545454545454546
2023-24,RegularSeason,1629139,396,Yuta Watanabe,1610612763,MEM,34,464,41,116,0.353,25,85,0.294,10,17,0.588,11,43,54,15,12,7,19,39,117,104,0.79,0.63,2023,24,3.4411764705882355,0.7894736842105263,75,7,82,0.6585365853658537
2023-24,RegularSeason,1630526,397,Jeremiah Robinson-Earl,1610612740,NOP,39,334,45,95,0.474,13,39,0.333,12,16,0.75,23,53,76,21,10,4,16,24,115,156,1.31,0.63,2023,24,2.948717948717949,1.3125,50,4,54,1.4074074074074074
2023-24,RegularSeason,1629007,397,Jontay Porter,1610612761,TOR,26,360,40,104,0.385,20,60,0.333,15,18,0.833,26,56,82,60,20,20,21,35,115,209,2.86,0.95,2023,24,4.423076923076923,2.857142857142857,64,3,67,1.2238805970149254
2023-24,RegularSeason,1628984,399,Devonte' Graham,1610612759,SAS,23,313,38,108,0.352,25,83,0.301,13,16,0.813,5,31,36,49,9,2,17,14,114,120,2.88,0.53,2023,24,4.956521739130435,2.8823529411764706,70,3,73,0.4931506849315068
2023-24,RegularSeason,1630587,399,Isaiah Livers,1610612765,DET,23,469,40,116,0.345,22,77,0.286,12,18,0.667,15,33,48,25,13,5,16,43,114,107,1.56,0.81,2023,24,4.956521739130435,1.5625,76,6,82,0.5853658536585366
2023-24,RegularSeason,1629750,401,Javonte Green,1610612741,CHI,9,230,45,75,0.6,10,27,0.37,10,13,0.769,20,47,67,5,10,8,7,19,110,160,0.71,1.43,2023,24,12.222222222222221,0.7142857142857143,30,3,33,2.0303030303030303
2023-24,RegularSeason,202083,401,Wesley Matthews,1610612737,ATL,36,413,34,97,0.351,24,69,0.348,18,24,0.75,9,44,53,23,16,11,8,43,110,136,2.88,2.0,2023,24,3.0555555555555554,2.875,63,6,69,0.7681159420289855
2023-24,RegularSeason,1629643,403,Chuma Okeke,1610612753,ORL,47,432,40,112,0.357,23,82,0.28,4,7,0.571,18,62,80,20,9,7,16,19,107,132,1.25,0.56,2023,24,2.276595744680851,1.25,72,3,75,1.0666666666666667
2023-24,RegularSeason,1627745,403,Damian Jones,1610612739,CLE,39,270,43,72,0.597,3,14,0.214,18,21,0.857,20,42,62,15,7,13,13,27,107,159,1.15,0.54,2023,24,2.7435897435897436,1.1538461538461537,29,3,32,1.9375
2023-24,RegularSeason,1641787,405,Tosan Evbuomwan,1610612765,DET,17,367,36,71,0.507,12,32,0.375,17,25,0.68,18,42,60,16,6,5,9,23,101,136,1.78,0.67,2023,24,5.9411764705882355,1.7777777777777777,35,8,43,1.3953488372093024
2023-24,RegularSeason,1630568,406,Luka Garza,1610612750,MIN,25,122,36,75,0.48,9,32,0.281,18,25,0.72,19,12,31,4,4,1,6,24,99,87,0.67,0.67,2023,24,3.96,0.6666666666666666,39,7,46,0.6739130434782609
2023-24,RegularSeason,1631115,406,Orlando Robinson,1610612748,MIA,36,304,36,72,0.5,8,15,0.533,19,25,0.76,28,56,84,34,7,8,18,35,99,172,1.89,0.39,2023,24,2.75,1.8888888888888888,36,6,42,2.0
2023-24,RegularSeason,1631288,408,Jamal Cain,1610612748,MIA,26,259,34,79,0.43,11,31,0.355,18,23,0.783,15,22,37,10,10,5,8,22,97,101,1.25,1.25,2023,24,3.730769230769231,1.25,45,5,50,0.74
2023-24,RegularSeason,1631254,409,Kenneth Lofton Jr.,1610612762,UTA,21,198,36,78,0.462,7,24,0.292,17,26,0.654,12,26,38,33,6,5,14,24,96,113,2.36,0.43,2023,24,4.571428571428571,2.357142857142857,42,9,51,0.7450980392156863
2023-24,RegularSeason,203493,409,Reggie Bullock Jr.,1610612745,HOU,44,417,34,82,0.415,27,67,0.403,1,1,1.0,6,67,73,15,12,5,10,29,96,143,1.5,1.2,2023,24,2.1818181818181817,1.5,48,0,48,1.5208333333333333
2023-24,RegularSeason,1630556,411,Kessler Edwards,1610612758,SAC,54,275,34,82,0.415,20,52,0.385,5,9,0.556,9,33,42,15,10,4,4,26,93,108,3.75,2.5,2023,24,1.7222222222222223,3.75,48,4,52,0.8076923076923077
2023-24,RegularSeason,1627732,412,Ben Simmons,1610612751,BKN,15,359,43,74,0.581,0,0,0.0,6,15,0.4,31,88,119,86,12,9,27,36,92,251,3.19,0.44,2023,24,6.133333333333334,3.185185185185185,31,9,40,2.975
2023-24,RegularSeason,1630579,412,Jericho Sims,1610612752,NYK,45,585,38,55,0.691,0,0,0.0,16,24,0.667,56,91,147,25,8,19,16,45,92,250,1.56,0.5,2023,24,2.0444444444444443,1.5625,17,8,25,5.88
2023-24,RegularSeason,1641763,414,Julian Phillips,1610612741,CHI,40,323,32,77,0.416,12,38,0.316,13,19,0.684,12,24,36,13,7,7,10,40,89,91,1.3,0.7,2023,24,2.225,1.3,45,6,51,0.7058823529411765
2023-24,RegularSeason,1630551,414,Justin Champagnie,1610612764,WAS,15,235,32,78,0.41,13,45,0.289,12,15,0.8,19,34,53,19,10,9,10,14,89,121,1.9,1.0,2023,24,5.933333333333334,1.9,46,3,49,1.0816326530612246
2023-24,RegularSeason,1630184,414,Kira Lewis Jr.,1610612762,UTA,28,264,34,92,0.37,4,33,0.121,17,20,0.85,9,17,26,37,9,2,14,13,89,88,2.64,0.64,2023,24,3.1785714285714284,2.642857142857143,58,3,61,0.4262295081967213
2023-24,RegularSeason,1641738,414,Kobe Brown,1610612746,LAC,44,394,37,90,0.411,14,48,0.292,1,2,0.5,20,42,62,25,12,6,9,49,89,131,2.78,1.33,2023,24,2.022727272727273,2.7777777777777777,53,1,54,1.1481481481481481
2023-24,RegularSeason,1627788,418,Furkan Korkmaz,1610612755,PHI,35,300,30,76,0.395,14,40,0.35,14,20,0.7,4,26,30,25,14,3,10,17,88,98,2.5,1.4,2023,24,2.5142857142857142,2.5,46,6,52,0.5769230769230769
2023-24,RegularSeason,202066,418,Garrett Temple,1610612761,TOR,27,289,29,78,0.372,12,40,0.3,18,22,0.818,18,27,45,28,12,3,14,28,88,109,2.0,0.86,2023,24,3.259259259259259,2.0,49,4,53,0.8490566037735849
2023-24,RegularSeason,1631221,420,Collin Gillespie,1610612743,DEN,24,225,32,69,0.464,15,38,0.395,8,12,0.667,1,20,21,27,13,0,14,24,87,93,1.93,0.93,2023,24,3.625,1.9285714285714286,37,4,41,0.5121951219512195
2023-24,RegularSeason,1641774,421,Tristan Vukcevic,1610612764,WAS,10,153,29,67,0.433,10,36,0.278,17,22,0.773,6,30,36,13,5,7,10,28,85,93,1.3,0.5,2023,24,8.5,1.3,38,5,43,0.8372093023255814
2023-24,RegularSeason,1631197,422,Jared Rhoden,1610612765,DET,17,245,33,66,0.5,12,31,0.387,5,8,0.625,3,30,33,14,3,13,7,28,83,103,2.0,0.43,2023,24,4.882352941176471,2.0,33,3,36,0.9166666666666666
2023-24,RegularSeason,1630235,422,Trent Forrest,1610612737,ATL,38,414,34,90,0.378,2,10,0.2,13,17,0.765,11,40,51,92,11,3,20,25,83,160,4.6,0.55,2023,24,2.1842105263157894,4.6,56,4,60,0.85
2023-24,RegularSeason,1630611,424,Gui Santos,1610612744,GSW,23,192,28,55,0.509,10,27,0.37,16,17,0.941,17,32,49,14,4,2,7,23,82,116,2.0,0.57,2023,24,3.5652173913043477,2.0,27,1,28,1.75
2023-24,RegularSeason,1629669,425,Jaylen Nowell,1610612765,DET,13,214,34,78,0.436,6,29,0.207,7,9,0.778,6,18,24,19,4,2,7,15,81,77,2.71,0.57,2023,24,6.230769230769231,2.7142857142857144,44,2,46,0.5217391304347826
2023-24,RegularSeason,1641723,425,Kobe Bufkin,1610612737,ATL,17,196,34,92,0.37,9,40,0.225,4,8,0.5,6,27,33,27,7,5,10,20,81,81,2.7,0.7,2023,24,4.764705882352941,2.7,58,4,62,0.532258064516129
2023-24,RegularSeason,1630204,427,Ashton Hagans,1610612757,POR,19,316,29,71,0.408,8,25,0.32,14,17,0.824,14,31,45,54,11,9,30,40,80,124,1.8,0.37,2023,24,4.2105263157894735,1.8,42,3,45,1.0
2023-24,RegularSeason,1641931,427,Onuralp Bitim,1610612741,CHI,23,268,32,84,0.381,12,44,0.273,4,5,0.8,6,26,32,13,3,2,10,24,80,67,1.3,0.3,2023,24,3.4782608695652173,1.3,52,1,53,0.6037735849056604
2023-24,RegularSeason,203469,429,Cody Zeller,1610612740,NOP,43,320,26,62,0.419,1,3,0.333,23,38,0.605,48,64,112,39,9,5,16,45,76,174,2.44,0.56,2023,24,1.7674418604651163,2.4375,36,15,51,2.196078431372549
2023-24,RegularSeason,1629650,430,Moses Brown,1610612757,POR,22,200,33,65,0.508,0,0,0.0,9,31,0.29,37,49,86,7,5,7,11,27,75,115,0.64,0.46,2023,24,3.409090909090909,0.6363636363636364,32,22,54,1.5925925925925926
2023-24,RegularSeason,1631262,431,Jules Bernard,1610612764,WAS,19,149,29,64,0.453,11,29,0.379,5,9,0.556,10,16,26,16,3,1,8,14,74,73,2.0,0.38,2023,24,3.8947368421052633,2.0,35,4,39,0.6666666666666666
2023-24,RegularSeason,1630240,432,Saben Lee,1610612756,PHX,24,185,20,55,0.364,2,16,0.125,29,39,0.744,9,22,31,30,7,3,8,13,71,89,3.75,0.88,2023,24,2.9583333333333335,3.75,35,10,45,0.6888888888888889
2023-24,RegularSeason,1641778,433,Leaky Black,1610612766,CHA,26,284,25,52,0.481,9,20,0.45,10,15,0.667,9,39,48,24,8,11,6,19,69,122,4.0,1.33,2023,24,2.6538461538461537,4.0,27,5,32,1.5
2023-24,RegularSeason,1629634,434,Brandon Clarke,1610612763,MEM,6,134,33,59,0.559,1,6,0.167,1,7,0.143,13,19,32,9,5,6,3,8,68,85,3.0,1.67,2023,24,11.333333333333334,3.0,26,6,32,1.0
2023-24,RegularSeason,202693,435,Markieff Morris,1610612742,DAL,26,216,23,68,0.338,15,42,0.357,5,6,0.833,4,35,39,16,5,3,12,12,66,71,1.33,0.42,2023,24,2.5384615384615383,1.3333333333333333,45,1,46,0.8478260869565217
2023-24,RegularSeason,1641732,436,Colby Jones,1610612758,SAC,30,192,28,71,0.394,2,22,0.091,6,11,0.545,17,23,40,20,7,5,10,29,64,78,2.0,0.7,2023,24,2.1333333333333333,2.0,43,5,48,0.8333333333333334
2023-24,RegularSeason,1629646,437,Charles Bassey,1610612759,SAS,19,205,29,40,0.725,0,1,0.0,5,6,0.833,23,53,76,21,8,17,15,31,63,158,1.4,0.53,2023,24,3.3157894736842106,1.4,11,1,12,6.333333333333333
2023-24,RegularSeason,202709,437,Cory Joseph,1610612744,GSW,26,296,23,64,0.359,13,42,0.31,4,7,0.571,6,24,30,42,4,3,12,25,63,86,3.5,0.33,2023,24,2.423076923076923,3.5,41,3,44,0.6818181818181818
2023-24,RegularSeason,1631466,437,Nate Williams,1610612745,HOU,22,129,27,50,0.54,2,5,0.4,7,13,0.538,12,11,23,7,4,1,4,10,63,65,1.75,1.0,2023,24,2.8636363636363638,1.75,23,6,29,0.7931034482758621
2023-24,RegularSeason,1631303,440,Justin Minaya,1610612757,POR,34,381,22,74,0.297,12,49,0.245,5,9,0.556,30,26,56,21,9,10,9,35,61,92,2.33,1.0,2023,24,1.7941176470588236,2.3333333333333335,52,4,56,1.0
2023-24,RegularSeason,1630177,441,Theo Maledon,1610612756,PHX,17,213,20,70,0.286,5,30,0.167,14,15,0.933,4,20,24,28,7,0,18,21,59,49,1.56,0.39,2023,24,3.4705882352941178,1.5555555555555556,50,1,51,0.47058823529411764
2023-24,RegularSeason,1628385,442,Harry Giles III,1610612747,LAL,23,100,23,50,0.46,3,14,0.214,7,13,0.538,12,18,30,6,2,3,6,15,56,58,1.0,0.33,2023,24,2.4347826086956523,1.0,27,6,33,0.9090909090909091
2023-24,RegularSeason,1630314,443,Brandon Williams,1610612742,DAL,17,113,20,54,0.37,3,15,0.2,11,17,0.647,4,9,13,17,1,1,7,4,54,39,2.43,0.14,2023,24,3.176470588235294,2.4285714285714284,34,6,40,0.325
2023-24,RegularSeason,1630695,444,Micah Potter,1610612762,UTA,16,186,19,40,0.475,9,21,0.429,6,8,0.75,10,33,43,6,4,6,5,14,53,84,1.2,0.8,2023,24,3.3125,1.2,21,2,23,1.8695652173913044
2023-24,RegularSeason,1630288,445,Jeff Dowtin Jr.,1610612755,PHI,12,142,20,36,0.556,9,19,0.474,3,4,0.75,3,17,20,27,7,1,5,1,52,85,5.4,1.4,2023,24,4.333333333333333,5.4,16,1,17,1.1764705882352942
2023-24,RegularSeason,200782,445,P.J. Tucker,1610612746,LAC,31,486,18,50,0.36,13,35,0.371,3,3,1.0,28,57,85,16,16,7,8,54,52,136,2.0,2.0,2023,24,1.6774193548387097,2.0,32,0,32,2.65625
2023-24,RegularSeason,1631173,445,Terquavion Smith,1610612755,PHI,16,85,18,46,0.391,13,35,0.371,3,5,0.6,0,4,4,12,8,0,7,8,52,39,1.71,1.14,2023,24,3.25,1.7142857142857142,28,2,30,0.13333333333333333
2023-24,RegularSeason,1630547,448,James Bouknight,1610612766,CHA,14,81,18,41,0.439,13,30,0.433,1,2,0.5,1,8,9,6,1,1,2,3,50,41,3.0,0.5,2023,24,3.5714285714285716,3.0,23,1,24,0.375
2023-24,RegularSeason,1631169,448,Josh Minott,1610612750,MIN,32,91,17,36,0.472,4,10,0.4,12,14,0.857,4,13,17,8,5,5,2,10,50,62,4.0,2.5,2023,24,1.5625,4.0,19,2,21,0.8095238095238095
2023-24,RegularSeason,1631100,450,AJ Griffin,1610612737,ATL,20,171,18,62,0.29,10,39,0.256,2,2,1.0,2,16,18,5,1,2,8,6,48,22,0.63,0.13,2023,24,2.4,0.625,44,0,44,0.4090909090909091
2023-24,RegularSeason,1629647,450,Darius Bazley,1610612762,UTA,9,152,18,30,0.6,2,8,0.25,10,12,0.833,8,20,28,7,6,7,8,3,48,74,0.88,0.75,2023,24,5.333333333333333,0.875,12,2,14,2.0
2023-24,RegularSeason,1641970,450,Maozinha Pereira,1610612763,MEM,7,122,18,35,0.514,5,13,0.385,7,10,0.7,11,26,37,2,6,4,5,10,48,72,0.4,1.2,2023,24,6.857142857142857,0.4,17,3,20,1.85
2023-24,RegularSeason,1630186,453,Jahmi'us Ramsey,1610612761,TOR,7,121,18,41,0.439,6,22,0.273,5,6,0.833,4,18,22,8,7,0,7,10,47,53,1.14,1.0,2023,24,6.714285714285714,1.1428571428571428,23,1,24,0.9166666666666666
2023-24,RegularSeason,1630678,454,Terry Taylor,1610612741,CHI,31,188,20,39,0.513,2,9,0.222,4,5,0.8,17,20,37,10,5,2,7,17,46,73,1.43,0.71,2023,24,1.4838709677419355,1.4285714285714286,19,1,20,1.85
2023-24,RegularSeason,1626246,455,Boban Marjanovic,1610612745,HOU,14,71,18,34,0.529,0,2,0.0,9,14,0.643,7,25,32,6,1,2,5,5,45,60,1.2,0.2,2023,24,3.2142857142857144,1.2,16,5,21,1.5238095238095237
2023-24,RegularSeason,1631321,455,Sidy Cissoko,1610612759,SAS,12,141,16,33,0.485,1,12,0.083,12,15,0.8,8,14,22,10,7,3,3,18,45,64,3.33,2.33,2023,24,3.75,3.3333333333333335,17,3,20,1.1
2023-24,RegularSeason,1631157,457,Ryan Rollins,1610612749,MIL,13,78,14,27,0.519,3,4,0.75,13,17,0.765,2,11,13,14,10,3,8,8,44,59,1.75,1.25,2023,24,3.3846153846153846,1.75,13,4,17,0.7647058823529411
2023-24,RegularSeason,1630610,458,DeJon Jarreau,1610612763,MEM,9,150,17,50,0.34,4,13,0.308,5,11,0.455,8,36,44,26,6,2,9,14,43,73,2.89,0.67,2023,24,4.777777777777778,2.888888888888889,33,6,39,1.1282051282051282
2023-24,RegularSeason,1629685,458,Dylan Windler,1610612737,ATL,17,108,15,30,0.5,13,27,0.481,0,0,0.0,3,13,16,10,2,0,2,6,43,54,5.0,1.0,2023,24,2.5294117647058822,5.0,15,0,15,1.0666666666666667
2023-24,RegularSeason,1629717,460,Armoni Brooks,1610612751,BKN,10,104,15,46,0.326,11,32,0.344,1,2,0.5,7,11,18,5,1,1,3,3,42,32,1.67,0.33,2023,24,4.2,1.6666666666666667,31,1,32,0.5625
2023-24,RegularSeason,1631306,460,Cole Swider,1610612748,MIA,18,87,15,38,0.395,10,30,0.333,2,2,1.0,1,6,7,5,1,1,8,4,42,25,0.63,0.13,2023,24,2.3333333333333335,0.625,23,0,23,0.30434782608695654
2023-24,RegularSeason,1629618,460,Jalen Pickett,1610612743,DEN,27,122,15,35,0.429,9,25,0.36,3,4,0.75,1,13,14,21,4,0,9,13,42,51,2.33,0.44,2023,24,1.5555555555555556,2.3333333333333335,20,1,21,0.6666666666666666
2023-24,RegularSeason,1630285,460,Zavier Simpson,1610612763,MEM,7,161,17,54,0.315,5,17,0.294,3,4,0.75,4,16,20,25,7,3,10,11,42,49,2.5,0.7,2023,24,6.0,2.5,37,1,38,0.5263157894736842
2023-24,RegularSeason,1641734,464,Emoni Bates,1610612739,CLE,15,133,15,49,0.306,10,33,0.303,1,4,0.25,1,13,14,10,1,2,8,5,41,23,1.25,0.13,2023,24,2.7333333333333334,1.25,34,3,37,0.3783783783783784
2023-24,RegularSeason,1629057,464,Robert Williams III,1610612757,POR,6,119,17,26,0.654,0,0,0.0,7,9,0.778,11,27,38,5,7,7,7,17,41,80,0.71,1.0,2023,24,6.833333333333333,0.7142857142857143,9,2,11,3.4545454545454546
2023-24,RegularSeason,203933,464,T.J. Warren,1610612750,MIN,11,125,18,41,0.439,2,13,0.154,3,4,0.75,5,17,22,9,4,1,4,11,41,49,2.25,1.0,2023,24,3.727272727272727,2.25,23,1,24,0.9166666666666666
2023-24,RegularSeason,1630243,467,Trevelin Queen,1610612753,ORL,14,165,14,38,0.368,3,17,0.176,9,12,0.75,3,17,20,18,7,5,7,15,40,56,2.57,1.0,2023,24,2.857142857142857,2.5714285714285716,24,3,27,0.7407407407407407
2023-24,RegularSeason,1630696,468,Dru Smith,1610612748,MIA,9,131,15,33,0.455,7,17,0.412,2,2,1.0,6,8,14,14,9,3,5,12,39,56,2.8,1.8,2023,24,4.333333333333333,2.8,18,0,18,0.7777777777777778
2023-24,RegularSeason,203925,468,Joe Harris,1610612765,DET,16,170,14,39,0.359,10,30,0.333,1,2,0.5,3,10,13,10,3,2,4,19,39,37,2.5,0.75,2023,24,2.4375,2.5,25,1,26,0.5
2023-24,RegularSeason,203490,468,Otto Porter Jr.,1610612761,TOR,15,174,14,33,0.424,8,23,0.348,3,3,1.0,6,23,29,8,5,5,2,19,39,65,4.0,2.5,2023,24,2.6,4.0,19,0,19,1.5263157894736843
2023-24,RegularSeason,1629716,471,Marques Bolden,1610612766,CHA,11,121,17,25,0.68,0,1,0.0,3,4,0.75,10,24,34,4,3,7,3,10,37,73,1.33,1.0,2023,24,3.3636363636363638,1.3333333333333333,8,1,9,3.7777777777777777
2023-24,RegularSeason,1641766,472,Adama Sanogo,1610612741,CHI,9,66,14,27,0.519,0,0,0.0,8,12,0.667,19,17,36,0,1,0,5,5,36,51,0.0,0.2,2023,24,4.0,0.0,13,4,17,2.1176470588235294
2023-24,RegularSeason,1628962,473,Udoka Azubuike,1610612756,PHX,16,113,16,23,0.696,0,0,0.0,3,13,0.231,11,21,32,3,1,6,4,17,35,56,0.75,0.25,2023,24,2.1875,0.75,7,10,17,1.8823529411764706
2023-24,RegularSeason,1631205,474,Buddy Boeheim,1610612765,DET,10,84,9,29,0.31,8,25,0.32,8,10,0.8,3,7,10,3,0,1,0,5,34,26,0.0,0.0,2023,24,3.4,inf,20,2,22,0.45454545454545453
2023-24,RegularSeason,1629216,474,Gabe Vincent,1610612747,LAL,11,218,15,49,0.306,3,28,0.107,1,2,0.5,4,5,9,21,9,0,5,19,34,33,4.2,1.8,2023,24,3.090909090909091,4.2,34,1,35,0.2571428571428571
2023-24,RegularSeason,1630641,474,Ibou Badji,1610612757,POR,22,226,14,22,0.636,0,0,0.0,6,12,0.5,20,31,51,13,3,20,15,46,34,92,0.87,0.2,2023,24,1.5454545454545454,0.8666666666666667,8,6,14,3.642857142857143
2023-24,RegularSeason,1641720,474,Jalen Hood-Schifino,1610612747,LAL,21,109,10,45,0.222,2,15,0.133,12,20,0.6,2,11,13,8,3,2,9,13,34,8,0.89,0.33,2023,24,1.619047619047619,0.8888888888888888,35,8,43,0.3023255813953488
2023-24,RegularSeason,1630846,474,Olivier Sarr,1610612760,OKC,15,98,11,19,0.579,2,6,0.333,10,15,0.667,10,26,36,2,0,7,3,18,34,63,0.67,0.0,2023,24,2.2666666666666666,0.6666666666666666,8,5,13,2.769230769230769
2023-24,RegularSeason,201959,474,Taj Gibson,1610612765,DET,20,204,15,37,0.405,2,10,0.2,2,2,1.0,12,25,37,11,3,7,5,31,34,65,2.2,0.6,2023,24,1.7,2.2,22,0,22,1.6818181818181819
2023-24,RegularSeason,1630207,480,Nate Hinton,1610612745,HOU,15,75,11,26,0.423,7,14,0.5,4,5,0.8,7,15,22,10,3,2,3,11,33,51,3.33,1.0,2023,24,2.2,3.3333333333333335,15,1,16,1.375
2023-24,RegularSeason,1641877,480,Nathan Mensah,1610612766,CHA,25,307,12,28,0.429,0,0,0.0,9,12,0.75,29,36,65,9,6,14,14,64,33,94,0.64,0.43,2023,24,1.32,0.6428571428571429,16,3,19,3.4210526315789473
2023-24,RegularSeason,1629875,480,Xavier Moon,1610612746,LAC,14,119,15,46,0.326,2,17,0.118,1,2,0.5,8,10,18,21,3,3,5,8,33,41,4.2,0.6,2023,24,2.357142857142857,4.2,31,1,32,0.5625
2023-24,RegularSeason,1630562,483,Matt Hurt,1610612763,MEM,8,113,12,34,0.353,5,20,0.25,3,3,1.0,9,7,16,4,3,3,2,8,32,34,2.0,1.5,2023,24,4.0,2.0,22,0,22,0.7272727272727273
2023-24,RegularSeason,203648,483,Thanasis Antetokounmpo,1610612749,MIL,34,155,16,30,0.533,0,1,0.0,0,2,0.0,7,6,13,17,7,4,14,24,32,43,1.21,0.5,2023,24,0.9411764705882353,1.2142857142857142,14,2,16,0.8125
2023-24,RegularSeason,1629010,485,Jerome Robinson,1610612744,GSW,22,81,11,33,0.333,2,17,0.118,7,11,0.636,1,5,6,5,1,3,2,5,31,18,2.5,0.5,2023,24,1.4090909090909092,2.5,22,4,26,0.23076923076923078
2023-24,RegularSeason,1630553,485,Keon Johnson,1610612751,BKN,5,61,8,21,0.381,4,10,0.4,11,12,0.917,3,4,7,3,3,1,5,5,31,26,0.6,0.6,2023,24,6.2,0.6,13,1,14,0.5
2023-24,RegularSeason,1641724,487,Jett Howard,1610612753,ORL,18,67,10,30,0.333,7,25,0.28,2,4,0.5,1,6,7,6,2,2,3,4,29,21,2.0,0.67,2023,24,1.6111111111111112,2.0,20,2,22,0.3181818181818182
2023-24,RegularSeason,1631159,487,Leonard Miller,1610612750,MIN,17,52,13,20,0.65,2,5,0.4,1,2,0.5,5,15,20,8,2,1,1,5,29,51,8.0,2.0,2023,24,1.7058823529411764,8.0,7,1,8,2.5
2023-24,RegularSeason,1631217,487,Moussa Diabate,1610612746,LAC,11,64,10,19,0.526,0,0,0.0,9,14,0.643,15,9,24,4,5,1,2,4,29,47,2.0,2.5,2023,24,2.6363636363636362,2.0,9,5,14,1.7142857142857142
2023-24,RegularSeason,1630227,490,Daishen Nix,1610612750,MIN,15,50,9,24,0.375,6,17,0.353,3,6,0.5,1,2,3,6,5,0,5,2,27,18,1.2,1.0,2023,24,1.8,1.2,15,3,18,0.16666666666666666
2023-24,RegularSeason,1629678,491,Admiral Schofield,1610612753,ORL,23,84,10,26,0.385,6,16,0.375,0,2,0.0,3,14,17,7,1,0,5,9,26,28,1.4,0.2,2023,24,1.1304347826086956,1.4,16,2,18,0.9444444444444444
2023-24,RegularSeason,1641753,491,Chris Livingston,1610612749,MIL,21,91,11,22,0.5,1,5,0.2,3,4,0.75,3,18,21,5,2,0,5,15,26,37,1.0,0.4,2023,24,1.2380952380952381,1.0,11,1,12,1.75
2023-24,RegularSeason,1630561,491,David Duke Jr.,1610612759,SAS,4,51,10,18,0.556,3,6,0.5,3,3,1.0,2,8,10,5,2,0,3,4,26,32,1.67,0.67,2023,24,6.5,1.6666666666666667,8,0,8,1.25
2023-24,RegularSeason,1631338,491,Mouhamadou Gueye,1610612761,TOR,11,120,11,38,0.289,0,3,0.0,4,9,0.444,12,11,23,5,3,18,12,15,26,31,0.42,0.25,2023,24,2.3636363636363638,0.4166666666666667,27,5,32,0.71875
2023-24,RegularSeason,1631131,491,Oscar Tshiebwe,1610612754,IND,8,42,10,20,0.5,0,0,0.0,6,8,0.75,8,8,16,2,2,1,0,3,26,35,0.0,0.0,2023,24,3.25,inf,10,2,12,1.3333333333333333
2023-24,RegularSeason,1630658,496,Colin Castleton,1610612747,LAL,16,59,9,16,0.563,0,0,0.0,6,6,1.0,6,6,12,3,2,0,3,11,24,31,1.0,0.67,2023,24,1.5,1.0,7,0,7,1.7142857142857142
2023-24,RegularSeason,1631243,496,Mouhamed Gueye,1610612737,ATL,6,73,8,23,0.348,3,9,0.333,5,6,0.833,10,12,22,4,5,4,1,13,24,42,4.0,5.0,2023,24,4.0,4.0,15,1,16,1.375
2023-24,RegularSeason,1641735,498,Amari Bailey,1610612766,CHA,10,65,8,24,0.333,1,8,0.125,6,7,0.857,6,3,9,7,3,0,4,2,23,21,1.75,0.75,2023,24,2.3,1.75,16,1,17,0.5294117647058824
2023-24,RegularSeason,1630600,498,Isaiah Mobley,1610612739,CLE,10,72,10,24,0.417,3,10,0.3,0,1,0.0,3,7,10,6,2,0,2,6,23,24,3.0,1.0,2023,24,2.3,3.0,14,1,15,0.6666666666666666
2023-24,RegularSeason,1630688,498,Ish Wainright,1610612756,PHX,11,62,7,24,0.292,7,20,0.35,2,2,1.0,3,11,14,1,4,1,2,8,23,24,0.5,2.0,2023,24,2.090909090909091,0.5,17,0,17,0.8235294117647058
2023-24,RegularSeason,1630643,498,Jay Huff,1610612743,DEN,20,49,9,15,0.6,3,9,0.333,2,2,1.0,2,9,11,2,2,3,1,9,23,34,2.0,2.0,2023,24,1.15,2.0,6,0,6,1.8333333333333333
2023-24,RegularSeason,1630564,498,RaiQuan Gray,1610612759,SAS,3,39,10,17,0.588,3,7,0.429,0,0,0.0,2,5,7,6,1,1,1,0,23,30,6.0,1.0,2023,24,7.666666666666667,6.0,7,0,7,1.0
2023-24,RegularSeason,1630296,503,Braxton Key,1610612743,DEN,20,60,7,17,0.412,2,5,0.4,6,8,0.75,3,15,18,9,2,1,1,5,22,39,9.0,2.0,2023,24,1.1,9.0,10,2,12,1.5
2023-24,RegularSeason,1641926,503,Dexter Dennis,1610612742,DAL,4,30,10,19,0.526,1,8,0.125,1,3,0.333,1,8,9,4,0,1,3,1,22,22,1.33,0.0,2023,24,5.5,1.3333333333333333,9,2,11,0.8181818181818182
2023-24,RegularSeason,1631123,505,Jamaree Bouyea,1610612759,SAS,9,95,10,28,0.357,1,9,0.111,0,0,0.0,3,16,19,11,1,0,9,10,21,25,1.22,0.11,2023,24,2.3333333333333335,1.2222222222222223,18,0,18,1.0555555555555556
2023-24,RegularSeason,1631112,505,Kendall Brown,1610612754,IND,15,63,8,15,0.533,0,2,0.0,5,8,0.625,3,2,5,5,0,0,2,9,21,19,2.5,0.0,2023,24,1.4,2.5,7,3,10,0.5
2023-24,RegularSeason,1641816,507,Hunter Tyson,1610612743,DEN,18,48,8,20,0.4,4,14,0.286,0,0,0.0,1,8,9,2,1,0,2,10,20,18,1.0,0.5,2023,24,1.1111111111111112,1.0,12,0,12,0.75
2023-24,RegularSeason,1631257,507,Jermaine Samuels Jr.,1610612745,HOU,14,60,9,14,0.643,0,2,0.0,2,2,1.0,3,10,13,3,1,2,0,5,20,34,0.0,0.0,2023,24,1.4285714285714286,inf,5,0,5,2.6
2023-24,RegularSeason,1628424,507,Kobi Simmons,1610612761,TOR,4,67,9,21,0.429,2,8,0.25,0,0,0.0,1,6,7,12,6,2,1,5,20,34,12.0,6.0,2023,24,5.0,12.0,12,0,12,0.5833333333333334
2023-24,RegularSeason,1642013,510,Malik Williams,1610612761,TOR,7,107,9,34,0.265,1,5,0.2,0,2,0.0,15,23,38,2,3,4,3,15,19,36,0.67,1.0,2023,24,2.7142857142857144,0.6666666666666666,25,2,27,1.4074074074074074
2023-24,RegularSeason,201577,511,Robin Lopez,1610612749,MIL,16,65,7,19,0.368,2,8,0.25,2,2,1.0,3,2,5,4,1,3,2,7,18,17,2.0,0.5,2023,24,1.125,2.0,12,0,12,0.4166666666666667
2023-24,RegularSeason,1631386,511,Taze Moore,1610612757,POR,4,40,8,19,0.421,1,7,0.143,1,2,0.5,4,4,8,5,2,0,3,4,18,18,1.67,0.67,2023,24,4.5,1.6666666666666667,11,1,12,0.6666666666666666
2023-24,RegularSeason,1631111,511,Wendell Moore Jr.,1610612750,MIN,25,75,9,18,0.5,0,6,0.0,0,0,0.0,0,12,12,6,5,1,4,5,18,29,1.5,1.25,2023,24,0.72,1.5,9,0,9,1.3333333333333333
2023-24,RegularSeason,1629117,514,Wenyen Gabriel,1610612763,MEM,5,81,8,22,0.364,1,6,0.167,0,5,0.0,7,18,25,3,2,2,8,10,17,22,0.38,0.25,2023,24,3.4,0.375,14,5,19,1.3157894736842106
2023-24,RegularSeason,1631120,515,JD Davison,1610612738,BOS,8,39,5,12,0.417,3,7,0.429,3,4,0.75,2,8,10,10,1,1,2,4,16,28,5.0,0.5,2023,24,2.0,5.0,7,1,8,1.25
2023-24,RegularSeason,1641788,516,Alex Fudge,1610612742,DAL,6,40,6,15,0.4,1,5,0.2,2,2,1.0,4,1,5,0,3,0,2,2,15,12,0.0,1.5,2023,24,2.5,0.0,9,0,9,0.5555555555555556
2023-24,RegularSeason,1630535,516,Greg Brown III,1610612742,DAL,6,40,5,11,0.455,1,3,0.333,4,9,0.444,3,6,9,4,0,4,4,5,15,17,1.0,0.0,2023,24,2.5,1.0,6,5,11,0.8181818181818182
2023-24,RegularSeason,1641775,516,Jordan Walsh,1610612738,BOS,9,83,6,15,0.4,2,9,0.222,1,2,0.5,5,15,20,5,5,1,3,11,15,33,1.67,1.67,2023,24,1.6666666666666667,1.6666666666666667,9,1,10,2.0
2023-24,RegularSeason,1641793,519,D'Moi Hodge,1610612747,LAL,7,41,5,15,0.333,3,12,0.25,1,2,0.5,0,0,0,5,1,1,1,4,14,9,5.0,1.0,2023,24,2.0,5.0,10,1,11,0.0
2023-24,RegularSeason,1629610,519,DaQuan Jeffries,1610612752,NYK,17,46,6,17,0.353,2,10,0.2,0,2,0.0,0,5,5,5,0,1,3,2,14,9,1.67,0.0,2023,24,0.8235294117647058,1.6666666666666667,11,2,13,0.38461538461538464
2023-24,RegularSeason,1631220,519,Dereon Seabron,1610612740,NOP,6,55,4,13,0.308,1,2,0.5,5,6,0.833,1,6,7,5,2,1,0,4,14,19,0.0,0.0,2023,24,2.3333333333333335,inf,9,1,10,0.7
2023-24,RegularSeason,1641754,519,Seth Lundy,1610612737,ATL,9,52,4,17,0.235,3,13,0.231,3,4,0.75,1,6,7,0,0,0,1,6,14,6,0.0,0.0,2023,24,1.5555555555555556,0.0,13,1,14,0.5
2023-24,RegularSeason,1631102,519,TyTy Washington Jr.,1610612749,MIL,11,56,6,20,0.3,2,6,0.333,0,0,0.0,1,4,5,5,3,0,2,1,14,11,2.5,1.5,2023,24,1.2727272727272727,2.5,14,0,14,0.35714285714285715
2023-24,RegularSeason,1631210,524,Jacob Toppin,1610612752,NYK,9,38,5,9,0.556,1,4,0.25,2,2,1.0,3,4,7,3,0,1,1,3,13,19,3.0,0.0,2023,24,1.4444444444444444,3.0,4,0,4,1.75
2023-24,RegularSeason,1641757,524,Jordan Miller,1610612746,LAC,8,28,5,9,0.556,1,2,0.5,2,2,1.0,3,2,5,0,0,0,1,2,13,13,0.0,0.0,2023,24,1.625,0.0,4,0,4,1.25
2023-24,RegularSeason,1641851,524,Timmy Allen,1610612763,MEM,5,125,6,23,0.261,0,7,0.0,1,2,0.5,4,13,17,5,4,0,2,18,13,19,2.5,2.0,2023,24,2.6,2.5,17,1,18,0.9444444444444444
2023-24,RegularSeason,1630554,527,Jason Preston,1610612762,UTA,7,71,6,19,0.316,0,3,0.0,0,0,0.0,6,11,17,16,2,1,2,3,12,33,8.0,1.0,2023,24,1.7142857142857142,8.0,13,0,13,1.3076923076923077
2023-24,RegularSeason,1630259,527,Jordan Ford,1610612758,SAC,6,22,4,7,0.571,2,3,0.667,2,2,1.0,0,2,2,2,0,0,1,0,12,12,2.0,0.0,2023,24,2.0,2.0,3,0,3,0.6666666666666666
2023-24,RegularSeason,1629603,527,Mamadi Diakite,1610612752,NYK,6,24,4,6,0.667,0,1,0.0,4,6,0.667,1,3,4,2,1,1,1,2,12,15,2.0,1.0,2023,24,2.0,2.0,2,2,4,1.0
2023-24,RegularSeason,1630618,530,DJ Carton,1610612761,TOR,4,36,3,8,0.375,1,4,0.25,4,5,0.8,2,2,4,3,1,0,1,3,11,12,3.0,1.0,2023,24,2.75,3.0,5,1,6,0.6666666666666666
2023-24,RegularSeason,1641809,530,Drew Peterson,1610612738,BOS,3,23,4,6,0.667,3,5,0.6,0,0,0.0,0,1,1,1,2,0,1,1,11,12,1.0,2.0,2023,24,3.6666666666666665,1.0,2,0,2,0.5
2023-24,RegularSeason,1630929,530,Henri Drell,1610612741,CHI,4,30,4,10,0.4,2,6,0.333,1,2,0.5,1,3,4,4,2,1,2,6,11,13,2.0,1.0,2023,24,2.75,2.0,6,1,7,0.5714285714285714
2023-24,RegularSeason,1641749,530,Keyontae Johnson,1610612760,OKC,9,66,5,16,0.313,1,3,0.333,0,0,0.0,4,6,10,4,1,0,4,5,11,11,1.0,0.25,2023,24,1.2222222222222223,1.0,11,0,11,0.9090909090909091
2023-24,RegularSeason,1641721,530,Maxwell Lewis,1610612747,LAL,34,103,4,21,0.19,1,9,0.111,2,3,0.667,2,2,4,6,2,1,10,5,11,-4,0.6,0.2,2023,24,0.3235294117647059,0.6,17,1,18,0.2222222222222222
2023-24,RegularSeason,1628391,535,D.J. Wilson,1610612755,PHI,2,15,4,6,0.667,2,2,1.0,0,0,0.0,1,1,2,2,0,2,0,1,10,14,0.0,0.0,2023,24,5.0,inf,2,0,2,1.0
2023-24,RegularSeason,1630181,535,R.J. Hampton,1610612748,MIA,8,76,4,14,0.286,1,8,0.125,1,2,0.5,2,4,6,8,0,0,3,8,10,10,2.67,0.0,2023,24,1.25,2.6666666666666665,10,1,11,0.5454545454545454
2023-24,RegularSeason,202738,537,Isaiah Thomas,1610612756,PHX,6,19,3,10,0.3,2,4,0.5,0,0,0.0,0,0,0,3,0,0,0,0,8,4,0.0,0.0,2023,24,1.3333333333333333,inf,7,0,7,0.0
2023-24,RegularSeason,1641771,537,Jalen Slawson,1610612758,SAC,12,37,4,6,0.667,0,2,0.0,0,0,0.0,1,6,7,2,1,1,2,8,8,15,1.0,0.5,2023,24,0.6666666666666666,1.0,2,0,2,3.5
2023-24,RegularSeason,201949,537,James Johnson,1610612754,IND,9,47,3,10,0.3,0,2,0.0,2,2,1.0,1,3,4,8,5,1,5,9,8,14,1.6,1.0,2023,24,0.8888888888888888,1.6,7,0,7,0.5714285714285714
2023-24,RegularSeason,1629308,540,Juan Toscano-Anderson,1610612758,SAC,11,53,3,12,0.25,1,4,0.25,0,0,0.0,4,10,14,4,1,1,2,11,7,16,2.0,0.5,2023,24,0.6363636363636364,2.0,9,0,9,1.5555555555555556
2023-24,RegularSeason,1630222,540,Mason Jones,1610612758,SAC,5,28,2,8,0.25,2,7,0.286,1,2,0.5,1,4,5,5,1,0,2,3,7,9,2.5,0.5,2023,24,1.4,2.5,6,1,7,0.7142857142857143
2023-24,RegularSeason,1629718,542,Charlie Brown Jr.,1610612752,NYK,8,37,2,10,0.2,2,7,0.286,0,0,0.0,1,1,2,0,0,2,2,5,6,0,0.0,0.0,2023,24,0.75,0.0,8,0,8,0.25
2023-24,RegularSeason,1631298,542,Jack White,1610612763,MEM,4,64,2,16,0.125,2,10,0.2,0,0,0.0,4,8,12,1,4,1,2,3,6,8,0.5,2.0,2023,24,1.5,0.5,14,0,14,0.8571428571428571
2023-24,RegularSeason,1629623,542,Lindell Wigginton,1610612749,MIL,3,8,2,5,0.4,0,2,0.0,2,2,1.0,0,0,0,0,0,0,1,1,6,2,0.0,0.0,2023,24,2.0,0.0,3,0,3,0.0
2023-24,RegularSeason,1631214,545,Alondes Williams,1610612748,MIA,7,16,2,8,0.25,0,4,0.0,1,1,1.0,0,1,1,0,0,1,2,2,5,-1,0.0,0.0,2023,24,0.7142857142857143,0.0,6,0,6,0.16666666666666666
2023-24,RegularSeason,1628373,545,Frank Ntilikina,1610612766,CHA,5,43,1,9,0.111,1,8,0.125,2,2,1.0,1,5,6,4,0,0,1,4,5,6,4.0,0.0,2023,24,1.0,4.0,8,0,8,0.75
2023-24,RegularSeason,1630604,547,E.J. Liddell,1610612740,NOP,8,23,1,6,0.167,0,5,0.0,2,2,1.0,0,5,5,1,2,2,2,2,4,7,0.5,1.0,2023,24,0.5,0.5,5,0,5,1.0
2023-24,RegularSeason,1631167,547,Izaiah Brockington,1610612740,NOP,1,3,2,5,0.4,0,1,0.0,0,0,0.0,1,1,2,0,0,0,0,0,4,3,0.0,0.0,2023,24,4.0,,3,0,3,0.6666666666666666
2023-24,RegularSeason,1630284,547,Kevon Harris,1610612753,ORL,2,6,2,3,0.667,0,0,0.0,0,0,0.0,0,2,2,1,0,0,1,3,4,5,1.0,0.0,2023,24,2.0,1.0,1,0,1,2.0
2023-24,RegularSeason,1630311,547,Pat Spencer,1610612744,GSW,6,26,2,4,0.5,0,2,0.0,0,0,0.0,2,2,4,5,0,0,1,1,4,10,5.0,0.0,2023,24,0.6666666666666666,5.0,2,0,2,2.0
2023-24,RegularSeason,1629660,547,Ty Jerome,1610612739,CLE,2,15,2,4,0.5,0,1,0.0,0,0,0.0,1,0,1,3,0,0,1,2,4,5,3.0,0.0,2023,24,2.0,3.0,2,0,2,0.5
2023-24,RegularSeason,1641745,552,Adam Flagler,1610612760,OKC,2,14,1,7,0.143,1,6,0.167,0,0,0.0,0,0,0,4,0,0,0,0,3,1,0.0,0.0,2023,24,1.5,inf,6,0,6,0.0
2023-24,RegularSeason,1641727,552,Dariq Whitehead,1610612751,BKN,2,24,1,5,0.2,0,3,0.0,1,2,0.5,0,4,4,3,0,1,0,0,3,6,0.0,0.0,2023,24,1.5,inf,4,1,5,0.8
2023-24,RegularSeason,1630196,552,Filip Petrusev,1610612758,SAC,3,9,1,2,0.5,0,0,0.0,1,2,0.5,0,1,1,0,0,0,0,1,3,2,0.0,0.0,2023,24,1.0,,1,1,2,0.5
2023-24,RegularSeason,1631250,552,Pete Nance,1610612739,CLE,8,27,1,6,0.167,1,1,1.0,0,2,0.0,0,3,3,0,1,0,1,2,3,-1,0.0,1.0,2023,24,0.375,0.0,5,2,7,0.42857142857142855
2023-24,RegularSeason,1630586,552,Usman Garuba,1610612744,GSW,6,18,1,6,0.167,0,1,0.0,1,2,0.5,3,4,7,1,1,3,2,2,3,7,0.5,0.5,2023,24,0.5,0.5,5,1,6,1.1666666666666667
2023-24,RegularSeason,1628977,557,Hamidou Diallo,1610612764,WAS,2,5,1,2,0.5,0,0,0.0,0,0,0.0,2,0,2,1,2,0,1,1,2,5,1.0,2.0,2023,24,1.0,1.0,1,0,1,2.0
2023-24,RegularSeason,1631209,557,Isaiah Wong,1610612754,IND,1,4,1,3,0.333,0,1,0.0,0,0,0.0,0,0,0,0,0,0,0,0,2,0,0.0,0.0,2023,24,2.0,,2,0,2,0.0
2023-24,RegularSeason,1630563,557,Joshua Primo,1610612746,LAC,2,10,1,3,0.333,0,1,0.0,0,0,0.0,1,0,1,0,0,1,4,0,2,-2,0.0,0.0,2023,24,1.0,0.0,2,0,2,0.5
2023-24,RegularSeason,1641806,557,Markquis Nowell,1610612761,TOR,1,4,0,1,0.0,0,0,0.0,2,2,1.0,2,0,2,2,1,0,0,0,2,6,0.0,0.0,2023,24,2.0,inf,1,0,1,2.0
2023-24,RegularSeason,1631245,557,Quenton Jackson,1610612754,IND,3,11,0,1,0.0,0,0,0.0,2,2,1.0,0,4,4,2,1,0,0,1,2,8,0.0,0.0,2023,24,0.6666666666666666,inf,1,0,1,4.0
2023-24,RegularSeason,1627885,557,Shaquille Harrison,1610612763,MEM,3,6,1,2,0.5,0,0,0.0,0,0,0.0,0,2,2,0,0,1,0,0,2,4,0.0,0.0,2023,24,0.6666666666666666,,1,0,1,2.0
2023-24,RegularSeason,1641847,563,Andrew Funk,1610612741,CHI,5,13,0,4,0.0,0,3,0.0,0,0,0.0,0,0,0,0,1,1,0,0,0,-2,0.0,0.0,2023,24,0.0,,4,0,4,0.0
2023-24,RegularSeason,201980,563,Danny Green,1610612755,PHI,2,18,0,2,0.0,0,1,0.0,0,0,0.0,0,2,2,1,1,0,0,1,0,2,0.0,0.0,2023,24,0.0,inf,2,0,2,1.0
2023-24,RegularSeason,1631376,563,Dmytro Skapintsev,1610612752,NYK,2,2,0,1,0.0,0,0,0.0,0,0,0.0,0,0,0,0,0,0,0,0,0,-1,0.0,0.0,2023,24,0.0,,1,0,1,0.0
2023-24,RegularSeason,1630622,563,Jalen Crutcher,1610612740,NOP,1,3,0,1,0.0,0,0,0.0,0,0,0.0,0,0,0,0,0,0,0,0,0,-1,0.0,0.0,2023,24,0.0,,1,0,1,0.0
2023-24,RegularSeason,1630606,563,Javonte Smart,1610612755,PHI,1,1,0,0,0.0,0,0,0.0,0,0,0.0,0,0,0,0,0,0,0,0,0,0,0.0,0.0,2023,24,0.0,,0,0,0,
2023-24,RegularSeason,1628382,563,Justin Jackson,1610612750,MIN,2,1,0,0,0.0,0,0,0.0,0,0,0.0,0,0,0,0,0,0,0,0,0,0,0.0,0.0,2023,24,0.0,,0,0,0,
2023-24,RegularSeason,1629232,563,Kaiser Gates,1610612740,NOP,1,7,0,4,0.0,0,2,0.0,0,0,0.0,0,1,1,0,0,0,0,0,0,-3,0.0,0.0,2023,24,0.0,,4,0,4,0.25
2023-24,RegularSeason,1630608,563,Malcolm Cazalon,1610612765,DET,1,3,0,0,0.0,0,0,0.0,0,0,0.0,0,0,0,0,0,0,0,0,0,0,0.0,0.0,2023,24,0.0,,0,0,0,
2023-24,RegularSeason,1631199,563,Ron Harper Jr.,1610612761,TOR,1,4,0,0,0.0,0,0,0.0,0,0,0.0,0,0,0,1,0,0,0,2,0,1,0.0,0.0,2023,24,0.0,inf,0,0,0,
2023-24,RegularSeason,1627853,563,Ryan Arcidiacono,1610612752,NYK,20,45,0,6,0.0,0,6,0.0,0,0,0.0,0,8,8,4,2,0,2,5,0,6,2.0,1.0,2023,24,0.0,2.0,6,0,6,1.3333333333333333
2023-24,Playoffs,1629029,1,Luka Doncic,1610612742,DAL,22,899,225,504,0.446,68,211,0.322,117,153,0.765,16,192,208,178,41,8,90,56,635,665,1.98,0.46,2023,24,28.863636363636363,1.9777777777777779,279,36,315,0.6603174603174603
2023-24,Playoffs,202681,2,Kyrie Irving,1610612742,DAL,22,879,186,398,0.467,53,136,0.39,62,73,0.849,22,59,81,113,23,7,51,62,487,437,2.22,0.45,2023,24,22.136363636363637,2.215686274509804,212,11,223,0.3632286995515695
2023-24,Playoffs,1628369,3,Jayson Tatum,1610612738,BOS,19,768,159,372,0.427,39,138,0.283,118,137,0.861,17,167,184,119,20,13,50,54,475,529,2.38,0.4,2023,24,25.0,2.38,213,19,232,0.7931034482758621
2023-24,Playoffs,1627759,4,Jaylen Brown,1610612738,BOS,19,707,175,339,0.516,36,110,0.327,68,103,0.66,22,91,113,62,23,12,51,51,454,414,1.22,0.45,2023,24,23.894736842105264,1.2156862745098038,164,35,199,0.5678391959798995
2023-24,Playoffs,1630162,5,Anthony Edwards,1610612750,MIN,16,649,156,324,0.481,46,115,0.4,83,102,0.814,18,94,112,104,24,9,52,37,441,451,2.0,0.46,2023,24,27.5625,2.0,168,19,187,0.5989304812834224
2023-24,Playoffs,1628973,6,Jalen Brunson,1610612752,NYK,13,518,151,340,0.444,26,84,0.31,93,120,0.775,8,35,43,97,10,2,35,26,421,322,2.77,0.29,2023,24,32.38461538461539,2.7714285714285714,189,27,216,0.19907407407407407
2023-24,Playoffs,1627783,7,Pascal Siakam,1610612754,IND,17,602,157,290,0.541,14,47,0.298,39,63,0.619,42,86,128,64,13,7,19,48,367,403,3.37,0.68,2023,24,21.58823529411765,3.3684210526315788,133,24,157,0.8152866242038217
2023-24,Playoffs,203999,8,Nikola Jokic,1610612743,DEN,12,482,133,244,0.545,14,53,0.264,64,71,0.901,43,118,161,104,17,8,40,32,344,476,2.6,0.42,2023,24,28.666666666666668,2.6,111,7,118,1.3644067796610169
2023-24,Playoffs,1628401,9,Derrick White,1610612738,BOS,19,676,109,241,0.452,65,161,0.404,35,38,0.921,19,62,81,77,18,23,16,44,318,366,4.81,1.13,2023,24,16.736842105263158,4.8125,132,3,135,0.6
2023-24,Playoffs,1626157,10,Karl-Anthony Towns,1610612750,MIN,16,522,108,232,0.466,30,83,0.361,59,69,0.855,35,109,144,42,12,3,27,55,305,345,1.56,0.44,2023,24,19.0625,1.5555555555555556,124,10,134,1.0746268656716418
2023-24,Playoffs,1628983,11,Shai Gilgeous-Alexander,1610612760,OKC,10,399,111,224,0.496,16,37,0.432,64,81,0.79,8,64,72,64,13,17,22,31,302,316,2.91,0.59,2023,24,30.2,2.909090909090909,113,17,130,0.5538461538461539
2023-24,Playoffs,1628378,12,Donovan Mitchell,1610612739,CLE,10,382,107,225,0.476,29,82,0.354,53,65,0.815,6,48,54,47,13,3,28,29,296,255,1.68,0.46,2023,24,29.6,1.6785714285714286,118,12,130,0.4153846153846154
2023-24,Playoffs,1626167,13,Myles Turner,1610612754,IND,17,550,106,205,0.517,39,86,0.453,38,50,0.76,26,87,113,36,8,25,33,44,289,327,1.09,0.24,2023,24,17.0,1.0909090909090908,99,12,111,1.018018018018018
2023-24,Playoffs,1629023,14,P.J. Washington,1610612742,DAL,22,785,100,234,0.427,47,135,0.348,39,55,0.709,33,112,145,31,16,17,32,67,286,313,0.97,0.5,2023,24,13.0,0.96875,134,16,150,0.9666666666666667
2023-24,Playoffs,1630169,15,Tyrese Haliburton,1610612754,IND,15,522,105,215,0.488,53,140,0.379,17,20,0.85,12,60,72,123,19,10,31,14,280,360,3.97,0.61,2023,24,18.666666666666668,3.967741935483871,110,3,113,0.6371681415929203
2023-24,Playoffs,1629614,16,Andrew Nembhard,1610612754,IND,17,554,102,182,0.56,29,60,0.483,20,26,0.769,14,42,56,94,6,4,23,56,253,304,4.09,0.26,2023,24,14.882352941176471,4.086956521739131,80,6,86,0.6511627906976745
2023-24,Playoffs,201950,17,Jrue Holiday,1610612738,BOS,19,720,97,193,0.503,35,87,0.402,21,22,0.955,37,79,116,83,21,12,29,40,250,356,2.86,0.72,2023,24,13.157894736842104,2.8620689655172415,96,1,97,1.1958762886597938
2023-24,Playoffs,1627750,18,Jamal Murray,1610612743,DEN,12,462,100,249,0.402,23,73,0.315,24,26,0.923,9,43,52,67,10,6,31,28,247,200,2.16,0.32,2023,24,20.583333333333332,2.161290322580645,149,2,151,0.3443708609271523
2023-24,Playoffs,1628978,19,Donte DiVincenzo,1610612752,NYK,13,466,80,191,0.419,45,106,0.425,26,30,0.867,13,39,52,34,16,12,16,29,231,214,2.13,1.0,2023,24,17.76923076923077,2.125,111,4,115,0.45217391304347826
2023-24,Playoffs,1627884,20,Derrick Jones Jr.,1610612742,DAL,22,647,77,160,0.481,24,65,0.369,22,30,0.733,33,43,76,27,11,21,18,54,200,226,1.5,0.61,2023,24,9.090909090909092,1.5,83,8,91,0.8351648351648352
2023-24,Playoffs,204456,20,T.J. McConnell,1610612754,IND,17,348,90,185,0.486,7,26,0.269,13,15,0.867,11,41,52,86,15,2,21,26,200,237,4.09,0.71,2023,24,11.764705882352942,4.095238095238095,95,2,97,0.5360824742268041
2023-24,Playoffs,203954,22,Joel Embiid,1610612755,PHI,6,248,59,133,0.444,13,39,0.333,67,78,0.859,19,46,65,34,7,9,25,20,198,203,1.36,0.28,2023,24,33.0,1.36,74,11,85,0.7647058823529411
2023-24,Playoffs,1629655,23,Daniel Gafford,1610612742,DAL,22,445,78,123,0.634,0,0,0.0,41,65,0.631,42,80,122,15,6,33,19,38,197,285,0.79,0.32,2023,24,8.954545454545455,0.7894736842105263,45,24,69,1.7681159420289856
2023-24,Playoffs,1630183,24,Jaden McDaniels,1610612750,MIN,16,537,72,140,0.514,24,56,0.429,27,35,0.771,28,33,61,18,14,18,17,54,195,213,1.06,0.82,2023,24,12.1875,1.0588235294117647,68,8,76,0.8026315789473685
2023-24,Playoffs,1630596,25,Evan Mobley,1610612739,CLE,12,422,81,146,0.555,5,18,0.278,25,36,0.694,30,81,111,28,10,26,22,34,192,269,1.27,0.46,2023,24,16.0,1.2727272727272727,65,11,76,1.4605263157894737
2023-24,Playoffs,1628404,26,Josh Hart,1610612752,NYK,13,548,66,150,0.44,22,59,0.373,35,48,0.729,37,113,150,59,13,10,34,41,189,290,1.74,0.38,2023,24,14.538461538461538,1.7352941176470589,84,13,97,1.5463917525773196
2023-24,Playoffs,1629008,26,Michael Porter Jr.,1610612743,DEN,12,443,68,146,0.466,33,81,0.407,20,26,0.769,8,74,82,13,11,10,18,27,189,203,0.72,0.61,2023,24,15.75,0.7222222222222222,78,6,84,0.9761904761904762
2023-24,Playoffs,1631094,26,Paolo Banchero,1610612753,ORL,7,262,68,149,0.456,16,40,0.4,37,49,0.755,14,46,60,28,8,4,32,14,189,164,0.88,0.25,2023,24,27.0,0.875,81,12,93,0.6451612903225806
2023-24,Playoffs,1629636,29,Darius Garland,1610612739,CLE,12,432,73,171,0.427,25,71,0.352,17,21,0.81,1,42,43,69,13,2,27,33,188,186,2.56,0.48,2023,24,15.666666666666666,2.5555555555555554,98,4,102,0.4215686274509804
2023-24,Playoffs,1631114,30,Jalen Williams,1610612760,OKC,10,377,75,160,0.469,15,39,0.385,22,27,0.815,13,55,68,54,17,5,19,21,187,222,2.84,0.9,2023,24,18.7,2.8421052631578947,85,5,90,0.7555555555555555
2023-24,Playoffs,1630167,31,Obi Toppin,1610612754,IND,17,343,73,135,0.541,20,56,0.357,19,25,0.76,10,65,75,29,6,6,14,21,185,219,2.07,0.43,2023,24,10.882352941176471,2.0714285714285716,62,6,68,1.1029411764705883
2023-24,Playoffs,203497,32,Rudy Gobert,1610612750,MIN,15,512,64,104,0.615,0,0,0.0,53,79,0.671,40,107,147,24,14,15,23,55,181,292,1.04,0.61,2023,24,12.066666666666666,1.0434782608695652,40,26,66,2.227272727272727
2023-24,Playoffs,1630178,33,Tyrese Maxey,1610612755,PHI,6,267,66,138,0.478,22,55,0.4,25,28,0.893,1,30,31,41,5,2,13,16,179,170,3.15,0.39,2023,24,29.833333333333332,3.1538461538461537,72,3,75,0.41333333333333333
2023-24,Playoffs,1630174,34,Aaron Nesmith,1610612754,IND,17,559,61,141,0.433,22,79,0.278,34,37,0.919,19,65,84,37,11,9,23,66,178,213,1.61,0.48,2023,24,10.470588235294118,1.608695652173913,80,3,83,1.0120481927710843
2023-24,Playoffs,1629675,35,Naz Reid,1610612750,MIN,16,361,65,142,0.458,25,69,0.362,22,31,0.71,9,50,59,16,8,12,14,32,177,172,1.14,0.57,2023,24,11.0625,1.1428571428571428,77,9,86,0.686046511627907
2023-24,Playoffs,201143,36,Al Horford,1610612738,BOS,19,575,66,138,0.478,35,95,0.368,7,11,0.636,35,98,133,40,15,16,12,28,174,290,3.33,1.25,2023,24,9.157894736842104,3.3333333333333335,72,4,76,1.75
2023-24,Playoffs,201144,36,Mike Conley,1610612750,MIN,15,474,62,145,0.428,30,76,0.395,20,28,0.714,10,48,58,86,21,3,20,38,174,231,4.3,1.05,2023,24,11.6,4.3,83,8,91,0.6373626373626373
2023-24,Playoffs,203932,38,Aaron Gordon,1610612743,DEN,12,445,69,118,0.585,11,27,0.407,23,28,0.821,36,51,87,53,10,7,18,28,172,257,2.94,0.56,2023,24,14.333333333333334,2.9444444444444446,49,5,54,1.6111111111111112
2023-24,Playoffs,1641726,39,Dereck Lively II,1610612742,DAL,21,462,64,95,0.674,1,1,1.0,36,61,0.59,57,99,156,27,9,20,21,48,165,300,1.29,0.43,2023,24,7.857142857142857,1.2857142857142858,31,25,56,2.7857142857142856
2023-24,Playoffs,1631096,40,Chet Holmgren,1610612760,OKC,10,345,59,119,0.496,13,50,0.26,25,33,0.758,14,58,72,21,7,25,19,26,156,194,1.1,0.37,2023,24,15.6,1.105263157894737,60,8,68,1.0588235294117647
2023-24,Playoffs,203114,41,Khris Middleton,1610612749,MIL,6,230,55,114,0.482,11,31,0.355,27,30,0.9,12,43,55,28,3,1,14,25,148,159,2.0,0.21,2023,24,24.666666666666668,2.0,59,3,62,0.8870967741935484
2023-24,Playoffs,1630540,42,Miles McBride,1610612752,NYK,13,347,54,124,0.435,25,68,0.368,10,12,0.833,7,22,29,25,7,2,11,30,143,123,2.27,0.64,2023,24,11.0,2.272727272727273,70,2,72,0.4027777777777778
2023-24,Playoffs,203076,43,Anthony Davis,1610612747,LAL,5,208,59,93,0.634,0,5,0.0,21,26,0.808,15,63,78,20,2,8,11,19,139,197,1.82,0.18,2023,24,27.8,1.8181818181818181,34,5,39,2.0
2023-24,Playoffs,2544,43,LeBron James,1610612747,LAL,5,204,56,99,0.566,10,26,0.385,17,23,0.739,4,30,34,44,12,5,19,11,139,166,2.32,0.63,2023,24,27.8,2.3157894736842106,43,6,49,0.6938775510204082
2023-24,Playoffs,1628384,45,OG Anunoby,1610612752,NYK,9,324,56,111,0.505,16,39,0.41,8,13,0.615,7,47,54,10,8,9,10,15,136,147,1.0,0.8,2023,24,15.11111111111111,1.0,55,5,60,0.9
2023-24,Playoffs,1630532,46,Franz Wagner,1610612753,ORL,7,259,42,103,0.408,9,34,0.265,39,44,0.886,10,38,48,31,5,9,9,20,132,150,3.44,0.56,2023,24,18.857142857142858,3.4444444444444446,61,5,66,0.7272727272727273
2023-24,Playoffs,201935,47,James Harden,1610612746,LAC,6,242,40,89,0.449,18,47,0.383,29,32,0.906,3,24,27,48,6,6,14,13,127,148,3.43,0.43,2023,24,21.166666666666668,3.4285714285714284,49,3,52,0.5192307692307693
2023-24,Playoffs,203081,48,Damian Lillard,1610612749,MIL,4,156,34,81,0.42,20,48,0.417,37,38,0.974,2,11,13,20,4,0,9,8,125,105,2.22,0.44,2023,24,31.25,2.2222222222222223,47,1,48,0.2708333333333333
2023-24,Playoffs,1630202,49,Payton Pritchard,1610612738,BOS,19,355,44,105,0.419,23,60,0.383,11,12,0.917,14,23,37,40,4,0,14,22,122,127,2.86,0.29,2023,24,6.421052631578948,2.857142857142857,61,1,62,0.5967741935483871
2023-24,Playoffs,202331,50,Paul George,1610612746,LAC,6,222,39,95,0.411,18,49,0.367,21,25,0.84,3,38,41,29,7,3,14,22,117,123,2.07,0.5,2023,24,19.5,2.0714285714285716,56,4,60,0.6833333333333333
2023-24,Playoffs,1629638,51,Nickeil Alexander-Walker,1610612750,MIN,16,378,41,112,0.366,24,81,0.296,10,10,1.0,5,23,28,37,10,7,15,24,116,112,2.47,0.67,2023,24,7.25,2.466666666666667,71,0,71,0.39436619718309857
2023-24,Playoffs,1629622,52,Max Strus,1610612739,CLE,12,434,42,103,0.408,25,72,0.347,5,5,1.0,8,56,64,35,9,0,15,41,114,146,2.33,0.6,2023,24,9.5,2.3333333333333335,61,0,61,1.0491803278688525
2023-24,Playoffs,1628389,53,Bam Adebayo,1610612748,MIA,5,193,48,97,0.495,2,10,0.2,15,21,0.714,11,36,47,19,2,0,8,15,113,118,2.38,0.25,2023,24,22.6,2.375,49,6,55,0.8545454545454545
2023-24,Playoffs,1627747,54,Caris LeVert,1610612739,CLE,11,278,44,102,0.431,6,33,0.182,17,26,0.654,8,32,40,25,9,6,14,14,111,110,1.79,0.64,2023,24,10.090909090909092,1.7857142857142858,58,9,67,0.5970149253731343
2023-24,Playoffs,1626164,55,Devin Booker,1610612756,PHX,4,166,32,65,0.492,7,20,0.35,39,41,0.951,1,12,13,24,7,1,11,18,110,109,2.18,0.64,2023,24,27.5,2.1818181818181817,33,2,35,0.37142857142857144
2023-24,Playoffs,1628392,55,Isaiah Hartenstein,1610612752,NYK,13,388,45,76,0.592,1,2,0.5,19,22,0.864,49,53,102,46,4,12,19,41,110,221,2.42,0.21,2023,24,8.461538461538462,2.4210526315789473,31,3,34,3.0
2023-24,Playoffs,1630182,57,Josh Green,1610612742,DAL,22,399,36,85,0.424,23,59,0.39,14,19,0.737,21,35,56,23,17,3,7,29,109,147,3.29,2.43,2023,24,4.954545454545454,3.2857142857142856,49,5,54,1.037037037037037
2023-24,Playoffs,201142,58,Kevin Durant,1610612756,PHX,4,168,37,67,0.552,5,12,0.417,28,34,0.824,1,25,26,13,2,6,10,8,107,108,1.3,0.2,2023,24,26.75,1.3,30,6,36,0.7222222222222222
2023-24,Playoffs,1629652,58,Luguentz Dort,1610612760,OKC,10,350,33,91,0.363,25,64,0.391,16,19,0.842,19,27,46,20,13,2,11,42,107,116,1.82,1.18,2023,24,10.7,1.8181818181818181,58,3,61,0.7540983606557377
2023-24,Playoffs,201572,60,Brook Lopez,1610612749,MIL,6,200,44,75,0.587,10,23,0.435,8,15,0.533,11,15,26,11,0,8,9,10,106,104,1.22,0.0,2023,24,17.666666666666668,1.2222222222222223,31,7,38,0.6842105263157895
2023-24,Playoffs,1630591,61,Jalen Suggs,1610612753,ORL,7,232,33,82,0.402,14,48,0.292,23,30,0.767,11,25,36,23,9,3,20,18,103,98,1.15,0.45,2023,24,14.714285714285714,1.15,49,7,56,0.6428571428571429
2023-24,Playoffs,1630573,61,Sam Hauser,1610612738,BOS,19,283,36,84,0.429,27,71,0.38,4,4,1.0,8,33,41,11,5,3,3,20,103,112,3.67,1.67,2023,24,5.421052631578948,3.6666666666666665,48,0,48,0.8541666666666666
2023-24,Playoffs,1626171,63,Bobby Portis,1610612749,MIL,6,187,44,91,0.484,3,12,0.25,8,13,0.615,16,52,68,6,3,1,9,13,99,116,0.67,0.33,2023,24,16.5,0.6666666666666666,47,5,52,1.3076923076923077
2023-24,Playoffs,1627826,64,Ivica Zubac,1610612746,LAC,6,192,42,70,0.6,0,0,0.0,13,20,0.65,18,38,56,6,5,3,8,21,97,124,0.75,0.63,2023,24,16.166666666666668,0.75,28,7,35,1.6
2023-24,Playoffs,203484,64,Kentavious Caldwell-Pope,1610612743,DEN,12,420,34,86,0.395,18,55,0.327,11,11,1.0,5,30,35,31,17,5,10,37,97,123,3.1,1.7,2023,24,8.083333333333334,3.1,52,0,52,0.6730769230769231
2023-24,Playoffs,202692,66,Alec Burks,1610612752,NYK,6,121,25,50,0.5,12,28,0.429,27,32,0.844,4,16,20,6,1,1,0,6,89,87,0.0,0.0,2023,24,14.833333333333334,inf,25,5,30,0.6666666666666666
2023-24,Playoffs,1641767,67,Ben Sheppard,1610612754,IND,17,335,31,71,0.437,19,50,0.38,7,9,0.778,10,41,51,17,8,1,11,32,88,112,1.54,0.73,2023,24,5.176470588235294,1.5454545454545454,40,2,42,1.2142857142857142
2023-24,Playoffs,1630581,68,Josh Giddey,1610612760,OKC,10,181,34,75,0.453,12,34,0.353,7,8,0.875,7,29,36,21,2,4,12,9,87,96,1.75,0.17,2023,24,8.7,1.75,41,1,42,0.8571428571428571
2023-24,Playoffs,204001,69,Kristaps Porzingis,1610612738,BOS,7,165,28,60,0.467,10,29,0.345,20,22,0.909,4,27,31,8,5,11,5,15,86,102,1.6,1.0,2023,24,12.285714285714286,1.6,32,2,34,0.9117647058823529
2023-24,Playoffs,1630559,70,Austin Reaves,1610612747,LAL,5,174,30,63,0.476,7,26,0.269,17,19,0.895,5,14,19,18,7,3,4,8,84,92,4.5,1.75,2023,24,16.8,4.5,33,2,35,0.5428571428571428
2023-24,Playoffs,1629639,70,Tyler Herro,1610612748,MIA,5,185,30,78,0.385,15,43,0.349,9,10,0.9,0,18,18,27,2,0,14,10,84,68,1.93,0.14,2023,24,16.8,1.9285714285714286,48,1,49,0.3673469387755102
2023-24,Playoffs,1630702,72,Jaden Hardy,1610612742,DAL,19,129,29,68,0.426,11,27,0.407,11,15,0.733,2,13,15,17,3,0,7,13,80,65,2.43,0.43,2023,24,4.2105263157894735,2.4285714285714284,39,4,43,0.3488372093023256
2023-24,Playoffs,1626162,73,Kelly Oubre Jr.,1610612755,PHI,6,224,31,64,0.484,9,23,0.391,8,11,0.727,9,15,24,10,11,7,8,24,79,87,1.25,1.38,2023,24,13.166666666666666,1.25,33,3,36,0.6666666666666666
2023-24,Playoffs,1626181,74,Norman Powell,1610612746,LAC,6,179,26,61,0.426,13,29,0.448,12,15,0.8,3,14,17,2,3,0,7,20,77,54,0.29,0.43,2023,24,12.833333333333334,0.2857142857142857,35,3,38,0.4473684210526316
2023-24,Playoffs,203468,75,CJ McCollum,1610612740,NOP,4,148,31,74,0.419,7,29,0.241,2,2,1.0,2,17,19,19,7,3,16,14,71,60,1.19,0.44,2023,24,17.75,1.1875,43,0,43,0.4418604651162791
2023-24,Playoffs,1626156,75,D'Angelo Russell,1610612747,LAL,5,185,28,73,0.384,14,44,0.318,1,2,0.5,1,13,14,21,4,1,9,6,71,56,2.33,0.44,2023,24,14.2,2.3333333333333335,45,1,46,0.30434782608695654
2023-24,Playoffs,1628386,77,Jarrett Allen,1610612739,CLE,4,127,25,37,0.676,0,0,0.0,18,26,0.692,15,40,55,5,5,4,5,8,68,112,1.0,1.0,2023,24,17.0,1.0,12,8,20,2.75
2023-24,Playoffs,203078,78,Bradley Beal,1610612756,PHX,4,154,26,59,0.441,10,23,0.435,4,5,0.8,6,5,11,18,3,1,13,15,66,52,1.39,0.23,2023,24,16.5,1.3846153846153846,33,1,34,0.3235294117647059
2023-24,Playoffs,1630171,78,Isaac Okoro,1610612739,CLE,12,263,25,70,0.357,9,35,0.257,7,9,0.778,5,16,21,13,11,4,11,30,66,57,1.18,1.0,2023,24,5.5,1.1818181818181819,45,2,47,0.44680851063829785
2023-24,Playoffs,1630198,80,Isaiah Joe,1610612760,OKC,10,173,24,54,0.444,16,39,0.41,0,0,0.0,4,18,22,10,5,0,5,10,64,66,2.0,1.0,2023,24,6.4,2.0,30,0,30,0.7333333333333333
2023-24,Playoffs,203937,80,Kyle Anderson,1610612750,MIN,15,231,26,57,0.456,2,8,0.25,10,12,0.833,18,22,40,38,10,5,10,26,64,114,3.8,1.0,2023,24,4.266666666666667,3.8,31,2,33,1.2121212121212122
2023-24,Playoffs,1630598,82,Aaron Wiggins,1610612760,OKC,10,157,23,47,0.489,6,20,0.3,10,11,0.909,9,23,32,10,6,3,9,8,62,79,1.11,0.67,2023,24,6.2,1.1111111111111112,24,1,25,1.28
2023-24,Playoffs,1631128,83,Christian Braun,1610612743,DEN,12,204,23,54,0.426,4,18,0.222,11,16,0.688,9,23,32,9,2,5,1,18,61,72,9.0,2.0,2023,24,5.083333333333333,9.0,31,5,36,0.8888888888888888
2023-24,Playoffs,203501,83,Tim Hardaway Jr.,1610612742,DAL,14,178,22,58,0.379,13,37,0.351,4,8,0.5,2,23,25,5,5,1,2,10,61,55,2.5,2.5,2023,24,4.357142857142857,2.5,36,4,40,0.625
2023-24,Playoffs,1628997,85,Caleb Martin,1610612748,MIA,5,176,21,45,0.467,11,25,0.44,5,5,1.0,5,13,18,7,3,0,3,14,58,59,2.33,1.0,2023,24,11.6,2.3333333333333335,24,0,24,0.75
2023-24,Playoffs,202685,85,Jonas Valanciunas,1610612740,NOP,4,89,22,42,0.524,0,1,0.0,14,17,0.824,18,26,44,5,2,0,10,9,58,76,0.5,0.2,2023,24,14.5,0.5,20,3,23,1.9130434782608696
2023-24,Playoffs,1627742,87,Brandon Ingram,1610612740,NOP,4,145,19,55,0.345,2,8,0.25,17,19,0.895,1,17,18,13,4,5,9,8,57,50,1.44,0.44,2023,24,14.25,1.4444444444444444,36,2,38,0.47368421052631576
2023-24,Playoffs,1630543,87,Isaiah Jackson,1610612754,IND,15,154,23,43,0.535,0,0,0.0,11,18,0.611,21,27,48,7,3,13,4,24,57,97,1.75,0.75,2023,24,3.8,1.75,20,7,27,1.7777777777777777
2023-24,Playoffs,1629611,89,Terance Mann,1610612746,LAC,6,187,19,46,0.413,10,22,0.455,8,8,1.0,17,13,30,11,0,0,5,19,56,65,2.2,0.0,2023,24,9.333333333333334,2.2,27,0,27,1.1111111111111112
2023-24,Playoffs,202694,90,Marcus Morris Sr.,1610612739,CLE,9,138,22,48,0.458,9,23,0.391,2,3,0.667,2,23,25,3,4,0,3,8,55,57,1.0,1.33,2023,24,6.111111111111111,1.0,26,1,27,0.9259259259259259
2023-24,Playoffs,202699,91,Tobias Harris,1610612755,PHI,6,218,22,51,0.431,6,18,0.333,4,4,1.0,9,34,43,9,1,3,3,11,54,78,3.0,0.33,2023,24,9.0,3.0,29,0,29,1.4827586206896552
2023-24,Playoffs,1627736,92,Malik Beasley,1610612749,MIL,6,131,21,41,0.512,11,25,0.44,0,0,0.0,1,14,15,4,4,0,3,9,53,53,1.33,1.33,2023,24,8.833333333333334,1.3333333333333333,20,0,20,0.75
2023-24,Playoffs,1628976,92,Wendell Carter Jr.,1610612753,ORL,7,185,19,47,0.404,7,25,0.28,8,11,0.727,9,35,44,9,5,4,5,20,53,79,1.8,1.0,2023,24,7.571428571428571,1.8,28,3,31,1.4193548387096775
2023-24,Playoffs,1630529,94,Herbert Jones,1610612740,NOP,4,141,16,41,0.39,8,24,0.333,12,12,1.0,6,14,20,10,5,1,11,15,52,52,0.91,0.46,2023,24,13.0,0.9090909090909091,25,0,25,0.8
2023-24,Playoffs,1631170,95,Jaime Jaquez Jr.,1610612748,MIA,4,123,21,52,0.404,3,13,0.231,6,7,0.857,2,11,13,12,3,2,7,6,51,42,1.71,0.43,2023,24,12.75,1.7142857142857142,31,1,32,0.40625
2023-24,Playoffs,201976,96,Patrick Beverley,1610612749,MIL,6,210,16,39,0.41,4,11,0.364,13,15,0.867,4,16,20,33,6,4,6,16,49,81,5.5,1.0,2023,24,8.166666666666666,5.5,23,2,25,0.8
2023-24,Playoffs,1628467,97,Maxi Kleber,1610612742,DAL,13,219,16,39,0.41,12,28,0.429,4,6,0.667,4,21,25,13,3,4,5,20,48,63,2.6,0.6,2023,24,3.6923076923076925,2.6,23,2,25,1.0
2023-24,Playoffs,1631107,98,Nikola Jovic,1610612748,MIA,5,128,16,36,0.444,9,22,0.409,6,7,0.857,2,31,33,11,5,3,6,9,47,72,1.83,0.83,2023,24,9.4,1.8333333333333333,20,1,21,1.5714285714285714
2023-24,Playoffs,1630173,98,Precious Achiuwa,1610612752,NYK,9,184,21,43,0.488,0,3,0.0,5,13,0.385,22,16,38,5,4,12,4,20,47,72,1.25,1.0,2023,24,5.222222222222222,1.25,22,8,30,1.2666666666666666
2023-24,Playoffs,1630530,100,Trey Murphy III,1610612740,NOP,4,168,18,48,0.375,10,30,0.333,0,0,0.0,3,23,26,9,5,6,8,12,46,54,1.13,0.63,2023,24,11.5,1.125,30,0,30,0.8666666666666667
2023-24,Playoffs,1628365,101,Markelle Fultz,1610612753,ORL,7,106,20,34,0.588,0,1,0.0,5,9,0.556,7,7,14,8,3,0,8,12,45,44,1.0,0.38,2023,24,6.428571428571429,1.0,14,4,18,0.7777777777777778
2023-24,Playoffs,1631119,102,Jaylin Williams,1610612760,OKC,10,127,16,33,0.485,9,22,0.409,3,4,0.75,4,28,32,15,4,3,3,11,44,77,5.0,1.33,2023,24,4.4,5.0,17,1,18,1.7777777777777777
2023-24,Playoffs,1628371,102,Jonathan Isaac,1610612753,ORL,7,147,16,39,0.41,10,27,0.37,2,2,1.0,10,24,34,3,5,9,4,7,44,68,0.75,1.25,2023,24,6.285714285714286,0.75,23,0,23,1.4782608695652173
2023-24,Playoffs,1629021,102,Moritz Wagner,1610612753,ORL,7,105,16,36,0.444,2,9,0.222,10,17,0.588,11,20,31,2,6,3,8,21,44,51,0.25,0.75,2023,24,6.285714285714286,0.25,20,7,27,1.1481481481481481
2023-24,Playoffs,203957,105,Dante Exum,1610612742,DAL,21,144,16,44,0.364,7,20,0.35,4,6,0.667,3,14,17,12,3,1,5,9,43,41,2.4,0.6,2023,24,2.0476190476190474,2.4,28,2,30,0.5666666666666667
2023-24,Playoffs,1641717,106,Cason Wallace,1610612760,OKC,10,198,16,41,0.39,9,28,0.321,1,2,0.5,7,6,13,10,9,2,4,14,42,46,2.5,2.25,2023,24,4.2,2.5,25,1,26,0.5
2023-24,Playoffs,200768,106,Kyle Lowry,1610612755,PHI,6,175,11,32,0.344,8,24,0.333,12,15,0.8,6,15,21,24,6,4,4,23,42,69,6.0,1.5,2023,24,7.0,6.0,21,3,24,0.875
2023-24,Playoffs,202704,106,Reggie Jackson,1610612743,DEN,12,117,16,48,0.333,8,23,0.348,2,2,1.0,2,13,15,12,2,1,8,12,42,32,1.5,0.25,2023,24,3.5,1.5,32,0,32,0.46875
2023-24,Playoffs,1628436,109,Luke Kornet,1610612738,BOS,13,133,14,21,0.667,0,0,0.0,11,13,0.846,19,22,41,7,1,5,6,11,39,78,1.17,0.17,2023,24,3.0,1.1666666666666667,7,2,9,4.555555555555555
2023-24,Playoffs,1629060,109,Rui Hachimura,1610612747,LAL,5,153,15,38,0.395,5,14,0.357,4,8,0.5,6,13,19,4,0,0,2,8,39,33,2.0,0.0,2023,24,7.8,2.0,23,4,27,0.7037037037037037
2023-24,Playoffs,201587,111,Nicolas Batum,1610612755,PHI,6,170,12,29,0.414,9,22,0.409,5,8,0.625,9,26,35,8,1,5,5,13,38,62,1.6,0.2,2023,24,6.333333333333333,1.6,17,3,20,1.75
2023-24,Playoffs,201566,111,Russell Westbrook,1610612746,LAC,6,114,13,50,0.26,4,17,0.235,8,13,0.615,6,19,25,10,7,3,10,11,38,31,1.0,0.7,2023,24,6.333333333333333,1.0,37,5,42,0.5952380952380952
2023-24,Playoffs,1627752,113,Taurean Prince,1610612747,LAL,5,111,12,29,0.414,5,17,0.294,8,8,1.0,1,11,12,3,1,2,1,9,37,37,3.0,1.0,2023,24,7.4,3.0,17,0,17,0.7058823529411765
2023-24,Playoffs,1630175,114,Cole Anthony,1610612753,ORL,7,103,13,41,0.317,2,13,0.154,8,9,0.889,2,13,15,9,4,1,5,16,36,31,1.8,0.8,2023,24,5.142857142857143,1.8,28,1,29,0.5172413793103449
2023-24,Playoffs,1630230,114,Naji Marshall,1610612740,NOP,4,84,12,28,0.429,6,15,0.4,6,6,1.0,3,8,11,5,2,2,2,9,36,38,2.5,1.0,2023,24,9.0,2.5,16,0,16,0.6875
2023-24,Playoffs,203200,116,Justin Holiday,1610612743,DEN,12,150,11,35,0.314,11,29,0.379,2,4,0.5,1,19,20,4,6,0,3,16,35,36,1.33,2.0,2023,24,2.9166666666666665,1.3333333333333333,24,2,26,0.7692307692307693
2023-24,Playoffs,1630241,117,Sam Merrill,1610612739,CLE,10,125,10,29,0.345,10,27,0.37,3,3,1.0,2,10,12,9,0,0,0,9,33,35,0.0,0.0,2023,24,3.3,inf,19,0,19,0.631578947368421
2023-24,Playoffs,1626153,118,Delon Wright,1610612748,MIA,4,107,12,20,0.6,6,10,0.6,2,2,1.0,2,10,12,7,4,1,0,5,32,48,0.0,0.0,2023,24,8.0,inf,8,0,8,1.5
2023-24,Playoffs,201569,118,Eric Gordon,1610612756,PHX,4,118,9,28,0.321,7,17,0.412,7,8,0.875,1,6,7,5,5,2,4,5,32,27,1.25,1.25,2023,24,8.0,1.25,19,1,20,0.35
2023-24,Playoffs,203994,120,Jusuf Nurkic,1610612756,PHX,4,104,13,26,0.5,0,2,0.0,5,11,0.455,13,20,33,11,6,6,6,15,31,62,1.83,1.0,2023,24,7.75,1.8333333333333333,13,6,19,1.736842105263158
2023-24,Playoffs,1630568,121,Luka Garza,1610612750,MIN,7,26,10,12,0.833,2,3,0.667,7,8,0.875,2,4,6,1,0,0,0,0,29,33,0.0,0.0,2023,24,4.142857142857143,inf,2,1,3,2.0
2023-24,Playoffs,1626166,122,Cameron Payne,1610612755,PHI,5,61,10,25,0.4,8,18,0.444,0,0,0.0,0,6,6,7,1,4,3,10,28,28,2.33,0.33,2023,24,5.6,2.3333333333333335,15,0,15,0.4
2023-24,Playoffs,1627777,122,Georges Niang,1610612739,CLE,10,121,9,41,0.22,3,23,0.13,7,8,0.875,3,9,12,4,4,2,7,18,28,10,0.57,0.57,2023,24,2.8,0.5714285714285714,32,1,33,0.36363636363636365
2023-24,Playoffs,1626192,124,Pat Connaughton,1610612749,MIL,6,124,11,25,0.44,3,11,0.273,2,2,1.0,3,20,23,13,6,1,3,6,27,53,4.33,2.0,2023,24,4.5,4.333333333333333,14,0,14,1.6428571428571428
2023-24,Playoffs,203914,125,Gary Harris,1610612753,ORL,6,159,8,28,0.286,7,22,0.318,2,2,1.0,5,7,12,4,7,3,2,18,25,29,2.0,3.5,2023,24,4.166666666666667,2.0,20,0,20,0.6
2023-24,Playoffs,1626204,125,Larry Nance Jr.,1610612740,NOP,4,84,10,17,0.588,1,4,0.25,4,6,0.667,15,18,33,7,2,0,7,9,25,51,1.0,0.29,2023,24,6.25,1.0,7,2,9,3.6666666666666665
2023-24,Playoffs,202711,127,Bojan Bogdanovic,1610612752,NYK,4,51,7,24,0.292,6,15,0.4,4,7,0.571,1,11,12,4,0,1,1,3,24,20,4.0,0.0,2023,24,6.0,4.0,17,3,20,0.6
2023-24,Playoffs,1629312,127,Haywood Highsmith,1610612748,MIA,5,126,10,28,0.357,3,16,0.188,1,1,1.0,2,12,14,8,1,1,4,14,24,26,2.0,0.25,2023,24,4.8,2.0,18,0,18,0.7777777777777778
2023-24,Playoffs,202695,127,Kawhi Leonard,1610612746,LAC,2,59,11,24,0.458,0,5,0.0,2,3,0.667,3,13,16,4,4,1,4,3,24,31,1.0,1.0,2023,24,12.0,1.0,13,1,14,1.1428571428571428
2023-24,Playoffs,1627741,130,Buddy Hield,1610612755,PHI,4,51,7,17,0.412,6,13,0.462,2,2,1.0,2,3,5,2,0,1,2,4,22,18,1.0,0.0,2023,24,5.5,1.0,10,0,10,0.5
2023-24,Playoffs,1628420,131,Monte Morris,1610612750,MIN,9,67,9,30,0.3,1,14,0.071,2,2,1.0,1,5,6,9,2,1,0,6,21,18,0.0,0.0,2023,24,2.3333333333333335,inf,21,0,21,0.2857142857142857
2023-24,Playoffs,1626220,132,Royce O'Neale,1610612756,PHX,4,104,7,22,0.318,6,18,0.333,0,0,0.0,5,14,19,4,1,0,2,11,20,27,2.0,0.5,2023,24,5.0,2.0,15,0,15,1.2666666666666666
2023-24,Playoffs,203486,133,Mason Plumlee,1610612746,LAC,6,66,7,18,0.389,0,0,0.0,5,8,0.625,7,13,20,4,3,2,2,13,19,32,2.0,1.5,2023,24,3.1666666666666665,2.0,11,3,14,1.4285714285714286
2023-24,Playoffs,201988,134,Patty Mills,1610612748,MIA,3,52,6,17,0.353,3,11,0.273,3,4,0.75,1,0,1,3,1,0,1,2,18,10,3.0,1.0,2023,24,6.0,3.0,11,1,12,0.08333333333333333
2023-24,Playoffs,1631212,134,Peyton Watson,1610612743,DEN,10,90,6,24,0.25,3,12,0.25,3,6,0.5,2,13,15,4,0,6,3,9,18,19,1.33,0.0,2023,24,1.8,1.3333333333333333,18,3,21,0.7142857142857143
2023-24,Playoffs,1631260,136,AJ Green,1610612749,MIL,6,67,6,16,0.375,2,11,0.182,3,3,1.0,0,9,9,2,0,0,1,9,17,17,2.0,0.0,2023,24,2.8333333333333335,2.0,10,0,10,0.9
2023-24,Playoffs,1629599,136,Amir Coffey,1610612746,LAC,6,112,7,22,0.318,3,11,0.273,0,0,0.0,2,8,10,2,2,1,5,6,17,12,0.4,0.4,2023,24,2.8333333333333335,0.4,15,0,15,0.6666666666666666
2023-24,Playoffs,1629234,136,Drew Eubanks,1610612756,PHX,3,37,7,12,0.583,0,0,0.0,3,3,1.0,0,4,4,0,2,1,2,6,17,17,0.0,1.0,2023,24,5.666666666666667,0.0,5,0,5,0.8
2023-24,Playoffs,1629011,136,Mitchell Robinson,1610612752,NYK,6,115,7,14,0.5,0,0,0.0,3,8,0.375,23,18,41,3,6,7,3,15,17,59,1.0,2.0,2023,24,2.8333333333333335,1.0,7,5,12,3.4166666666666665
2023-24,Playoffs,1629052,140,Oshae Brissett,1610612738,BOS,10,55,6,11,0.545,2,2,1.0,2,4,0.5,3,11,14,0,3,2,1,2,16,27,0.0,3.0,2023,24,1.6,0.0,5,2,7,2.0
2023-24,Playoffs,203915,141,Spencer Dinwiddie,1610612747,LAL,5,73,5,14,0.357,2,8,0.25,3,6,0.5,1,6,7,8,2,1,1,7,15,20,8.0,2.0,2023,24,3.0,8.0,9,3,12,0.5833333333333334
2023-24,Playoffs,202684,141,Tristan Thompson,1610612739,CLE,10,87,7,16,0.438,0,0,0.0,1,2,0.5,10,10,20,10,1,5,2,9,15,39,5.0,0.5,2023,24,1.5,5.0,9,1,10,2.0
2023-24,Playoffs,1629006,143,Josh Okogie,1610612756,PHX,4,29,5,9,0.556,1,3,0.333,3,6,0.5,0,4,4,2,2,0,2,7,14,13,1.0,1.0,2023,24,3.5,1.0,4,3,7,0.5714285714285714
2023-24,Playoffs,203926,144,Doug McDermott,1610612754,IND,10,64,5,11,0.455,3,8,0.375,0,0,0.0,2,1,3,7,0,2,1,5,13,18,7.0,0.0,2023,24,1.3,7.0,6,0,6,0.5
2023-24,Playoffs,1629130,144,Duncan Robinson,1610612748,MIA,5,60,5,16,0.313,3,13,0.231,0,0,0.0,0,5,5,6,2,0,5,6,13,10,1.2,0.4,2023,24,2.6,1.2,11,0,11,0.45454545454545453
2023-24,Playoffs,1630188,144,Jalen Smith,1610612754,IND,7,42,3,8,0.375,2,4,0.5,5,8,0.625,7,7,14,2,2,1,4,8,13,20,0.5,0.5,2023,24,1.8571428571428572,0.5,5,3,8,1.75
2023-24,Playoffs,1641748,147,Andre Jackson Jr.,1610612749,MIL,5,60,5,11,0.455,2,6,0.333,0,0,0.0,5,6,11,10,5,1,3,10,12,30,3.33,1.67,2023,24,2.4,3.3333333333333335,6,0,6,1.8333333333333333
2023-24,Playoffs,1628418,147,Thomas Bryant,1610612748,MIA,2,18,5,7,0.714,0,2,0.0,2,3,0.667,2,3,5,1,0,0,2,1,12,13,0.5,0.0,2023,24,6.0,0.5,2,1,3,1.6666666666666667
2023-24,Playoffs,1630214,147,Xavier Tillman,1610612738,BOS,8,69,5,8,0.625,1,1,1.0,1,1,1.0,4,10,14,3,3,3,3,7,12,29,1.0,1.0,2023,24,1.5,1.0,3,0,3,4.666666666666667
2023-24,Playoffs,1630639,150,AJ Lawson,1610612742,DAL,10,30,4,9,0.444,2,6,0.333,1,2,0.5,1,2,3,0,0,1,0,1,11,9,0.0,0.0,2023,24,1.1,,5,1,6,0.5
2023-24,Playoffs,1630538,150,Bones Hyland,1610612746,LAC,3,12,3,7,0.429,1,5,0.2,4,4,1.0,0,2,2,4,0,0,1,0,11,12,4.0,0.0,2023,24,3.6666666666666665,4.0,4,0,4,0.5
2023-24,Playoffs,201568,150,Danilo Gallinari,1610612749,MIL,3,37,4,8,0.5,0,2,0.0,3,4,0.75,1,8,9,2,0,0,1,0,11,16,2.0,0.0,2023,24,3.6666666666666665,2.0,4,1,5,1.8
2023-24,Playoffs,1629731,150,Dean Wade,1610612739,CLE,3,63,4,13,0.308,3,10,0.3,0,0,0.0,1,5,6,5,1,2,2,4,11,14,2.5,0.5,2023,24,3.6666666666666665,2.5,9,0,9,0.6666666666666666
2023-24,Playoffs,204060,150,Joe Ingles,1610612753,ORL,7,68,4,12,0.333,2,7,0.286,1,2,0.5,2,11,13,12,3,0,0,3,11,30,0.0,0.0,2023,24,1.5714285714285714,inf,8,1,9,1.4444444444444444
2023-24,Playoffs,200782,150,P.J. Tucker,1610612746,LAC,2,31,4,6,0.667,3,4,0.75,0,0,0.0,3,0,3,0,0,0,3,6,11,9,0.0,0.0,2023,24,5.5,0.0,2,0,2,1.5
2023-24,Playoffs,203109,156,Jae Crowder,1610612749,MIL,4,42,3,12,0.25,1,7,0.143,2,2,1.0,2,4,6,2,0,2,0,4,9,10,0.0,0.0,2023,24,2.25,inf,9,0,9,0.6666666666666666
2023-24,Playoffs,201567,156,Kevin Love,1610612748,MIA,5,32,4,9,0.444,1,4,0.25,0,0,0.0,1,13,14,4,0,0,2,2,9,20,2.0,0.0,2023,24,1.8,2.0,5,0,5,2.8
2023-24,Playoffs,1630194,156,Paul Reed,1610612755,PHI,6,43,4,9,0.444,0,0,0.0,1,2,0.5,9,7,16,2,1,3,3,7,9,22,0.67,0.33,2023,24,1.5,0.6666666666666666,5,1,6,2.6666666666666665
2023-24,Playoffs,1629610,159,DaQuan Jeffries,1610612752,NYK,4,20,3,8,0.375,2,5,0.4,0,0,0.0,1,3,4,0,1,0,0,2,8,8,0.0,0.0,2023,24,2.0,,5,0,5,0.8
2023-24,Playoffs,1641716,159,Jarace Walker,1610612754,IND,9,31,3,10,0.3,0,3,0.0,2,3,0.667,1,3,4,4,2,1,6,2,8,5,0.67,0.33,2023,24,0.8888888888888888,0.6666666666666666,7,1,8,0.5
2023-24,Playoffs,1629004,159,Svi Mykhailiuk,1610612738,BOS,8,32,3,12,0.25,2,9,0.222,0,0,0.0,1,4,5,1,1,0,2,3,8,4,0.5,0.5,2023,24,1.0,0.5,9,0,9,0.5555555555555556
2023-24,Playoffs,1629216,162,Gabe Vincent,1610612747,LAL,5,69,3,12,0.25,1,7,0.143,0,0,0.0,1,7,8,3,2,0,3,8,7,8,1.0,0.67,2023,24,1.4,1.0,9,0,9,0.8888888888888888
2023-24,Playoffs,1628960,162,Grayson Allen,1610612756,PHX,2,43,1,5,0.2,1,5,0.2,4,4,1.0,2,6,8,2,1,0,3,4,7,11,0.67,0.33,2023,24,3.5,0.6666666666666666,4,0,4,2.0
2023-24,Playoffs,1630579,162,Jericho Sims,1610612752,NYK,5,27,2,2,1.0,0,0,0.0,3,4,0.75,3,5,8,1,2,1,0,1,7,18,0.0,0.0,2023,24,1.4,inf,0,1,1,8.0
2023-24,Playoffs,1630631,162,Jose Alvarado,1610612740,NOP,4,62,3,20,0.15,1,14,0.071,0,0,0.0,0,4,4,9,5,1,4,3,7,5,2.25,1.25,2023,24,1.75,2.25,17,0,17,0.23529411764705882
2023-24,Playoffs,1631124,162,Julian Strawther,1610612743,DEN,3,16,2,6,0.333,1,4,0.25,2,4,0.5,0,2,2,0,1,0,1,3,7,3,0.0,1.0,2023,24,2.3333333333333335,0.0,4,2,6,0.3333333333333333
2023-24,Playoffs,1629642,162,Nassir Little,1610612756,PHX,4,14,3,5,0.6,1,3,0.333,0,0,0.0,0,1,1,0,0,0,0,2,7,6,0.0,0.0,2023,24,1.75,,2,0,2,0.5
2023-24,Playoffs,1631111,162,Wendell Moore Jr.,1610612750,MIN,6,18,3,7,0.429,1,4,0.25,0,0,0.0,0,2,2,2,1,0,1,3,7,7,2.0,1.0,2023,24,1.1666666666666667,2.0,4,0,4,0.5
2023-24,Playoffs,1641710,169,Anthony Black,1610612753,ORL,2,11,3,7,0.429,0,2,0.0,0,0,0.0,1,1,2,2,1,0,1,1,6,6,2.0,1.0,2023,24,3.0,2.0,4,0,4,0.5
2023-24,Playoffs,1629643,169,Chuma Okeke,1610612753,ORL,2,10,2,3,0.667,1,2,0.5,1,1,1.0,0,0,0,1,0,0,0,0,6,6,0.0,0.0,2023,24,3.0,inf,1,0,1,0.0
2023-24,Playoffs,203939,169,Dwight Powell,1610612742,DAL,13,44,1,3,0.333,0,0,0.0,4,6,0.667,3,9,12,3,1,0,3,9,6,15,1.0,0.33,2023,24,0.46153846153846156,1.0,2,2,4,3.0
2023-24,Playoffs,1631169,169,Josh Minott,1610612750,MIN,5,18,2,9,0.222,2,5,0.4,0,0,0.0,1,4,5,3,0,0,0,2,6,7,0.0,0.0,2023,24,1.2,inf,7,0,7,0.7142857142857143
2023-24,Playoffs,1630527,173,Brandon Boston Jr.,1610612746,LAC,3,10,2,4,0.5,0,0,0.0,1,2,0.5,1,1,2,1,0,0,0,2,5,5,0.0,0.0,2023,24,1.6666666666666667,inf,2,1,3,0.6666666666666666
2023-24,Playoffs,1641724,173,Jett Howard,1610612753,ORL,2,10,2,3,0.667,1,1,1.0,0,0,0.0,0,1,1,1,0,0,2,1,5,4,0.5,0.0,2023,24,2.5,0.5,1,0,1,1.0
2023-24,Playoffs,1629003,173,Shake Milton,1610612752,NYK,4,22,0,6,0.0,0,2,0.0,5,6,0.833,0,1,1,2,1,0,0,0,5,2,0.0,0.0,2023,24,1.25,inf,6,1,7,0.14285714285714285
2023-24,Playoffs,1630192,173,Zeke Nnaji,1610612743,DEN,3,14,2,3,0.667,0,0,0.0,1,2,0.5,2,0,2,0,0,1,2,1,5,4,0.0,0.0,2023,24,1.6666666666666667,0.0,1,1,2,1.0
2023-24,Playoffs,201599,177,DeAndre Jordan,1610612743,DEN,2,13,1,2,0.5,0,0,0.0,2,2,1.0,1,2,3,0,1,1,0,4,4,8,0.0,0.0,2023,24,2.0,,1,0,1,3.0
2023-24,Playoffs,1630700,177,Dyson Daniels,1610612740,NOP,3,17,2,6,0.333,0,2,0.0,0,0,0.0,0,2,2,0,2,0,1,0,4,3,0.0,2.0,2023,24,1.3333333333333333,0.0,4,0,4,0.5
2023-24,Playoffs,1630531,177,Jaden Springer,1610612738,BOS,4,22,2,3,0.667,0,0,0.0,0,0,0.0,0,3,3,1,0,1,2,1,4,6,0.5,0.0,2023,24,1.0,0.5,1,0,1,3.0
2023-24,Playoffs,1629618,177,Jalen Pickett,1610612743,DEN,3,11,2,3,0.667,0,1,0.0,0,0,0.0,0,1,1,1,0,1,0,1,4,6,0.0,0.0,2023,24,1.3333333333333333,inf,1,0,1,1.0
2023-24,Playoffs,1629162,177,Jordan McLaughlin,1610612750,MIN,6,30,2,9,0.222,0,5,0.0,0,2,0.0,0,4,4,2,0,0,2,1,4,-1,1.0,0.0,2023,24,0.6666666666666666,1.0,7,2,9,0.4444444444444444
2023-24,Playoffs,1631112,177,Kendall Brown,1610612754,IND,7,25,2,6,0.333,0,0,0.0,0,0,0.0,0,3,3,2,0,1,3,2,4,3,0.67,0.0,2023,24,0.5714285714285714,0.6666666666666666,4,0,4,0.75
2023-24,Playoffs,1629026,177,Kenrich Williams,1610612760,OKC,7,31,2,8,0.25,0,5,0.0,0,0,0.0,1,7,8,3,1,0,0,3,4,10,0.0,0.0,2023,24,0.5714285714285714,inf,6,0,6,1.3333333333333333
2023-24,Playoffs,1629674,177,Neemias Queta,1610612738,BOS,3,13,2,3,0.667,0,0,0.0,0,0,0.0,1,2,3,0,0,1,0,0,4,7,0.0,0.0,2023,24,1.3333333333333333,,1,0,1,3.0
2023-24,Playoffs,1631216,185,Caleb Houstan,1610612753,ORL,3,14,1,2,0.5,1,2,0.5,0,0,0.0,1,1,2,0,0,0,0,0,3,4,0.0,0.0,2023,24,1.0,,1,0,1,2.0
2023-24,Playoffs,1628464,185,Daniel Theis,1610612746,LAC,1,4,1,1,1.0,1,1,1.0,0,0,0.0,0,1,1,0,0,0,0,0,3,4,0.0,0.0,2023,24,3.0,,0,0,0,inf
2023-24,Playoffs,1630699,185,MarJon Beauchamp,1610612749,MIL,4,10,1,4,0.25,0,2,0.0,1,2,0.5,0,1,1,2,0,0,1,1,3,1,2.0,0.0,2023,24,0.75,2.0,3,1,4,0.25
2023-24,Playoffs,202693,185,Markieff Morris,1610612742,DAL,1,12,1,5,0.2,1,3,0.333,0,0,0.0,0,4,4,0,0,0,1,1,3,2,0.0,0.0,2023,24,3.0,0.0,4,0,4,1.0
2023-24,Playoffs,1629626,189,Bol Bol,1610612756,PHX,3,13,1,3,0.333,0,0,0.0,0,0,0.0,0,4,4,0,1,0,0,2,2,5,0.0,0.0,2023,24,0.6666666666666666,,2,0,2,2.0
2023-24,Playoffs,1641753,189,Chris Livingston,1610612749,MIL,2,6,1,1,1.0,0,0,0.0,0,3,0.0,0,0,0,0,0,0,0,0,2,-1,0.0,0.0,2023,24,1.0,,0,3,3,0.0
2023-24,Playoffs,1630526,189,Jeremiah Robinson-Earl,1610612740,NOP,1,5,1,2,0.5,0,0,0.0,0,2,0.0,1,0,1,1,0,0,0,0,2,1,0.0,0.0,2023,24,2.0,inf,1,2,3,0.3333333333333333
2023-24,Playoffs,1641775,189,Jordan Walsh,1610612738,BOS,3,11,1,3,0.333,0,1,0.0,0,0,0.0,0,2,2,0,0,0,0,0,2,2,0.0,0.0,2023,24,0.6666666666666666,,2,0,2,1.0
2023-24,Playoffs,1629603,189,Mamadi Diakite,1610612752,NYK,4,15,0,3,0.0,0,2,0.0,2,2,1.0,0,3,3,1,1,1,1,3,2,4,1.0,1.0,2023,24,0.5,1.0,3,0,3,1.0
2023-24,Playoffs,1631172,189,Ousmane Dieng,1610612760,OKC,4,7,1,2,0.5,0,1,0.0,0,0,0.0,0,0,0,0,0,0,0,0,2,1,0.0,0.0,2023,24,0.5,,1,0,1,0.0
2023-24,Playoffs,1641816,195,Hunter Tyson,1610612743,DEN,3,14,0,4,0.0,0,3,0.0,1,2,0.5,1,2,3,1,0,0,1,0,1,-1,1.0,0.0,2023,24,0.3333333333333333,1.0,4,1,5,0.6
2023-24,Playoffs,201949,195,James Johnson,1610612754,IND,1,1,0,0,0.0,0,0,0.0,1,2,0.5,0,0,0,0,0,0,1,0,1,-1,0.0,0.0,2023,24,1.0,0.0,0,1,1,0.0
2023-24,Playoffs,1629637,195,Jaxson Hayes,1610612747,LAL,4,24,0,2,0.0,0,0,0.0,1,2,0.5,3,9,12,1,0,0,2,7,1,9,0.5,0.0,2023,24,0.25,0.5,2,1,3,4.0
2023-24,Playoffs,1627745,198,Damian Jones,1610612739,CLE,2,9,0,0,0.0,0,0,0.0,0,0,0.0,1,1,2,2,0,1,2,0,0,3,1.0,0.0,2023,24,0.0,1.0,0,0,0,inf
2023-24,Playoffs,1631223,198,David Roddy,1610612756,PHX,2,3,0,0,0.0,0,0,0.0,0,0,0.0,0,0,0,0,0,0,0,0,0,0,0.0,0.0,2023,24,0.0,,0,0,0,
2023-24,Playoffs,1629001,198,De'Anthony Melton,1610612755,PHI,1,7,0,2,0.0,0,2,0.0,0,0,0.0,0,1,1,1,0,0,0,1,0,0,0.0,0.0,2023,24,0.0,inf,2,0,2,0.5
2023-24,Playoffs,1630604,198,E.J. Liddell,1610612740,NOP,1,3,0,0,0.0,0,0,0.0,0,0,0.0,0,1,1,0,0,0,0,0,0,1,0.0,0.0,2023,24,0.0,,0,0,0,inf
2023-24,Playoffs,1629048,198,Goga Bitadze,1610612753,ORL,2,10,0,2,0.0,0,0,0.0,0,0,0.0,1,2,3,2,0,0,1,0,0,2,2.0,0.0,2023,24,0.0,2.0,2,0,2,1.5
2023-24,Playoffs,202330,198,Gordon Hayward,1610612760,OKC,7,46,0,3,0.0,0,0,0.0,0,0,0.0,1,12,13,3,1,1,0,2,0,15,0.0,0.0,2023,24,0.0,inf,3,0,3,4.333333333333333
2023-24,Playoffs,202738,198,Isaiah Thomas,1610612756,PHX,1,4,0,2,0.0,0,1,0.0,0,0,0.0,0,0,0,0,0,0,1,0,0,-3,0.0,0.0,2023,24,0.0,0.0,2,0,2,0.0
2023-24,Playoffs,1641722,198,Jordan Hawkins,1610612740,NOP,3,12,0,4,0.0,0,3,0.0,0,0,0.0,0,2,2,0,0,0,0,1,0,-2,0.0,0.0,2023,24,0.0,,4,0,4,0.5
2023-24,Playoffs,1641738,198,Kobe Brown,1610612746,LAC,3,10,0,0,0.0,0,0,0.0,0,0,0.0,1,1,2,0,0,0,0,1,0,2,0.0,0.0,2023,24,0.0,,0,0,0,inf
2023-24,Playoffs,1631159,198,Leonard Miller,1610612750,MIN,3,7,0,1,0.0,0,1,0.0,0,0,0.0,1,3,4,0,0,0,0,0,0,3,0.0,0.0,2023,24,0.0,,1,0,1,4.0
2023-24,Playoffs,1630322,198,Lindy Waters III,1610612760,OKC,3,9,0,1,0.0,0,1,0.0,0,0,0.0,0,1,1,0,0,0,0,0,0,0,0.0,0.0,2023,24,0.0,,1,0,1,1.0
2023-24,Playoffs,1630346,198,Matt Ryan,1610612740,NOP,1,3,0,1,0.0,0,1,0.0,0,0,0.0,0,1,1,0,1,0,1,0,0,0,0.0,1.0,2023,24,0.0,0.0,1,0,1,1.0
2023-24,Playoffs,1641765,198,Olivier-Maxence Prosper,1610612742,DAL,3,9,0,2,0.0,0,0,0.0,0,0,0.0,0,3,3,1,0,0,0,0,0,2,0.0,0.0,2023,24,0.0,inf,2,0,2,1.5
2023-24,Playoffs,1631115,198,Orlando Robinson,1610612748,MIA,1,2,0,1,0.0,0,1,0.0,0,0,0.0,0,1,1,1,0,0,0,0,0,1,0.0,0.0,2023,24,0.0,inf,1,0,1,1.0
2023-24,Playoffs,203933,198,T.J. Warren,1610612750,MIN,3,11,0,2,0.0,0,1,0.0,0,0,0.0,2,1,3,1,0,0,0,0,0,2,0.0,0.0,2023,24,0.0,inf,2,0,2,1.5
2023-24,Playoffs,201152,198,Thaddeus Young,1610612756,PHX,1,4,0,0,0.0,0,0,0.0,0,0,0.0,0,0,0,0,0,0,0,0,0,0,0.0,0.0,2023,24,0.0,,0,0,0,
2023-24,Playoffs,203648,198,Thanasis Antetokounmpo,1610612749,MIL,2,5,0,0,0.0,0,0,0.0,0,0,0.0,0,0,0,0,1,1,0,1,0,2,0.0,0.0,2023,24,0.0,,0,0,0,
